,date,year,num_segs_new,num_segs_distinct_new,sum_seg_length_h_new,sum_seg_day_length_h_new,num_segs_with_idents_new,min_num_idents_new,max_num_idents_new,avg_num_idents_new,total_msg_count_new,total_cumul_msg_count_new,num_segs_old,num_segs_distinct_old,sum_seg_length_h_old,sum_seg_day_length_h_old,num_segs_with_idents_old,min_num_idents_old,max_num_idents_old,avg_num_idents_old,total_msg_count_old,num_segs_diff,num_segs_distinct_diff,sum_seg_length_h_diff,sum_seg_day_length_h_diff,num_segs_with_idents_diff,min_num_idents_diff,max_num_idents_diff,avg_num_idents_diff,total_msg_count_diff,avg_seg_length_h_new,avg_seg_length_h_old,avg_seg_length_h_diff,prop_segs_with_idents_new,prop_segs_with_idents_old,prop_segs_with_idents_diff
0,2017-01-01,2017,166801,166801,209688399.08333313,2592368.4,129882,0,99,0.8380405393253042,24494883,1292482385,484873,484873,208426630.49999723,2587648.716666665,130512,0,99,0.29189499105951233,1352495062,-318072,-318072,1261768.5833359063,4719.683333334979,-630,0,0,0.5461455482657919,-1328000179,1257.1171580705939,429.85819070147693,827.2589673691169,0.7786643964964238,0.2691673902238318,-630
1,2017-01-02,2017,170414,170414,210429930.99999967,2557511.9333333345,132682,0,103,0.8315807386717062,23725939,1306982472,488698,488698,209134618.43332946,2553482.2333333404,133208,0,103,0.292434182255702,1363575659,-318284,-318284,1295312.5666702092,4029.6999999941327,-526,0,0,0.5391465564160043,-1339849720,1234.8159834285896,427.9424479603548,806.8735354682348,0.7785862663865645,0.27257733815157825,-526
2,2017-01-03,2017,176294,176294,211325868.61666703,2696579.9666666654,137459,0,107,0.8412084359081982,26067465,1322633323,498741,498741,210029060.78333008,2691730.549999917,138153,0,109,0.3019362755418147,1374915730,-322447,-322447,1296807.8333369493,4849.416666748468,-694,0,-2,0.5392721603663835,-1348848265,1198.7127674036951,421.1184979444844,777.5942694592108,0.7797145677107559,0.27700349479990616,-694
3,2017-01-04,2017,179639,179639,211888505.88333303,2715950.016666664,139372,0,89,0.8338000100200957,26621557,1336642027,503148,503148,210649979.33332986,2710607.8166665803,140112,0,89,0.30204035393164524,1388942326,-323509,-323509,1238526.550003171,5342.20000008354,-740,0,0,0.5317596560884505,-1362320769,1179.5239668631702,418.66404980906185,760.8599170541083,0.7758448889161039,0.27847074816952466,-740
4,2017-01-05,2017,176772,176772,212158545.88333338,2685404.700000004,137501,0,90,0.8378872219582284,26830896,1349670668,506918,506918,210949608.96666276,2680530.449999945,138160,0,90,0.29681329130155,1403676414,-330146,-330146,1208936.9166706204,4874.250000059139,-659,0,0,0.5410739306566784,-1376845518,1200.181849406769,416.14148435577897,784.0403650509901,0.7778437761636459,0.2725490118717426,-659
5,2017-01-06,2017,173661,173661,212296678.49999982,2677392.299999999,134804,0,119,0.8353285999735112,26822129,1361307163,510949,510949,211098461.46666312,2672430.0499999058,135726,0,119,0.28909538916800454,1418982352,-337288,-337288,1198217.033336699,4962.250000093132,-922,0,0,0.5462332108055066,-1392160223,1222.4775770034712,413.1497692855121,809.3278077179591,0.7762479773812198,0.26563512209633444,-922
6,2017-01-07,2017,169599,169599,212409092.40000024,2635892.399999997,132300,0,67,0.8375815895140885,26627361,1372456437,513629,513629,211211601.4666624,2631171.5333332783,133045,0,67,0.2808895136372735,1433001527,-344030,-344030,1197490.9333378375,4720.866666718852,-745,0,0,0.556692075876815,-1406374166,1252.4194859639517,411.2143229191934,841.2051630447584,0.7800753542178904,0.25902937723531966,-745
7,2017-01-08,2017,165816,165816,212740911.55000013,2591348.95,129518,0,88,0.8376513726057805,26032704,1383956207,516940,516940,211526651.36666256,2587019.7666665968,130266,0,90,0.2727647309165454,1446240639,-351124,-351124,1214260.1833375692,4329.183333403431,-748,0,-2,0.5648866416892351,-1420207935,1282.993870012545,409.18994731818503,873.8039226943599,0.7810947073865007,0.25199442875382055,-748
8,2017-01-09,2017,172137,172137,213274756.966667,2625863.666666669,133601,0,88,0.830669757228254,25894891,1396593580,528170,528170,212074490.79999572,2621190.316666622,134318,0,88,0.27483196698032064,1459791810,-356033,-356033,1200266.166671276,4673.350000046659,-717,0,0,0.5558377902479333,-1433896919,1238.9826531580486,401.5269530643462,837.4557000937025,0.7761318019949226,0.25430827195789235,-717
9,2017-01-10,2017,174783,174783,213558031.54999995,2644076.5333333327,134145,0,105,0.8204001533329889,26035659,1406174338,532288,532288,212346326.24999368,2639198.733333312,134964,0,105,0.2734722556210203,1468205279,-357505,-357505,1211705.3000062704,4877.8000000207685,-819,0,0,0.5469278977119686,-1442169620,1221.8466987636095,398.9312670020622,822.9154317615473,0.767494550385335,0.2535544667548395,-819
10,2017-01-11,2017,173809,173809,214014591.0166668,2669386.2000000007,133817,0,107,0.8243128951895474,26427621,1416783420,534493,534493,212795642.18332928,2664469.81666658,134498,0,108,0.27238149049660326,1478458631,-360684,-360684,1218948.8333375156,4916.383333420847,-681,0,-1,0.5519314046929442,-1452031010,1231.3205358564103,398.1261535386418,833.1943823177685,0.769908347668993,0.2516365976729349,-681
11,2017-01-12,2017,174991,174991,214743777.85000023,2685149.6499999957,134942,0,80,0.8286483304855672,27084988,1429790448,539224,539224,213511694.83333007,2679502.66666661,135669,0,82,0.2727141225168076,1490572496,-364233,-364233,1232083.0166701674,5646.9833333855495,-727,0,-2,0.5559342079687596,-1463487508,1227.1704136212734,395.9610381461694,831.209375475104,0.7711368013212108,0.2516004480512737,-727
12,2017-01-13,2017,169424,169424,215098228.73333344,2628192.1499999966,130251,0,83,0.8194470677117758,26751325,1441169519,540445,540445,213912882.19999352,2623247.4333332833,130738,0,83,0.25976926421744395,1503214170,-371021,-371021,1185346.5333399177,4944.716666713357,-487,0,0,0.5596778034943318,-1476462845,1269.585352331036,395.80879127384566,873.7765610571903,0.7687871848144301,0.2419080572491188,-487
13,2017-01-14,2017,165063,165063,215060303.38333315,2575966.433333334,125653,0,95,0.8118173061194817,26054675,1449579093,544588,544588,213878747.4833301,2571237.0333332717,126203,0,96,0.248900085936526,1514790395,-379525,-379525,1181555.9000030458,4729.4000000623055,-550,0,-1,0.5629172201829556,-1488735720,1302.898307817822,392.73496199572907,910.1633458220929,0.7612426770384642,0.23174032479599257,-550
14,2017-01-15,2017,165828,165828,215303506.56666672,2560756.0666666664,126070,0,120,0.8156644233784408,25511306,1458178561,551009,551009,214134374.0499956,2555816.8166666217,126540,0,120,0.24825728799348315,1526936778,-385181,-385181,1169132.5166711211,4939.2500000447035,-470,0,0,0.5674071353849577,-1501425472,1298.354358532134,388.6222803075732,909.7320782245608,0.7602455556359602,0.22965142130164842,-470
15,2017-01-16,2017,170492,170492,215980837.2166668,2621464.916666663,130559,0,61,0.8186777092180276,26278457,1470603925,560008,560008,214810998.48332825,2616571.0999999563,131211,0,61,0.25259103441379094,1539618813,-389516,-389516,1169838.7333385348,4893.816666706465,-652,0,0,0.5660866748042367,-1513340356,1266.8092181255824,383.5855889261015,883.2236291994809,0.7657778664101541,0.2343020099712861,-652
16,2017-01-17,2017,174415,174415,216372561.59999993,2663056.6666666702,133449,0,68,0.8167187455207413,27189499,1480791639,564210,564210,215188895.94999638,2657957.4999999655,134157,0,68,0.2559614327998444,1548682309,-389795,-389795,1183665.6500035524,5099.166666704696,-708,0,0,0.5607573127208969,-1521492810,1240.5616581142674,381.3985855443831,859.1630725698843,0.7651234125505261,0.237778486733663,-708
17,2017-01-18,2017,173933,173933,216803999.13333338,2655053.8166666697,133340,0,55,0.8217072090977566,27099564,1491680546,567313,567313,215623619.53332794,2649752.233333261,133898,0,56,0.254882225508665,1560246504,-393380,-393380,1180379.6000054479,5301.58333340846,-558,0,-1,0.5668249835890916,-1533146940,1246.4799614410915,380.0787564066537,866.4012050344378,0.7666170306957276,0.23602138502026218,-558
18,2017-01-19,2017,172032,172032,217165811.9833336,2607701.1999999993,130781,0,77,0.8136102585565481,26354044,1501959196,571343,571343,215990267.08332708,2602217.6666666204,131233,0,78,0.24743280306225945,1571450167,-399311,-399311,1175544.9000065029,5483.533333378844,-452,0,-1,0.5661774554942887,-1545096123,1262.3570730057988,378.0395788227511,884.3174941830478,0.7602132161458334,0.22969214639892324,-452
19,2017-01-20,2017,160527,160527,217106230.68333334,2538145.7166666687,120521,0,58,0.79024712353685,25586441,1509118048,569841,569841,215924045.01666197,2533668.6166666173,120967,0,59,0.22468021781513825,1581626413,-409314,-409314,1182185.6666713655,4477.100000051316,-446,0,-1,0.5655669057217118,-1556039972,1352.4592790205593,378.91981274892817,973.5394662716311,0.7507833573168377,0.21228202252909145,-446
20,2017-01-21,2017,154714,154714,216771548.41666675,2487731.8833333342,117082,0,64,0.7985508745168513,24931948,1514426482,572134,572134,215606112.03332976,2484064.4333332684,117449,0,64,0.21771123547980428,1592655527,-417420,-417420,1165436.383336991,3667.4500000658445,-367,0,0,0.5808396390370469,-1567723579,1401.1113953272925,376.8454803128808,1024.2659150144118,0.7567640937471722,0.20528232896489285,-367
21,2017-01-22,2017,151333,151333,216835143.56666672,2447727.0666666664,115104,0,101,0.8027660853878529,24754059,1521522785,574677,574677,215684640.73333022,2444263.1999999373,115502,0,101,0.2130988363898285,1603748665,-423344,-423344,1150502.8333365023,3463.8666667290963,-398,0,0,0.5896672489980244,-1578994606,1432.8345011773158,375.31455188450246,1057.5199492928134,0.7606007942748773,0.2009859451483181,-398
22,2017-01-23,2017,150219,150219,216896024.5166668,2461246.6833333345,114676,0,117,0.8031340908939618,24623037,1529183079,578931,578931,215766017.76666266,2458112.2166666333,115074,0,117,0.20999566442288037,1614288435,-428712,-428712,1130006.7500041425,3134.46666670125,-398,0,0,0.5931384264710815,-1589665398,1443.865453216083,372.69729512957963,1071.1681580865034,0.7633921141799639,0.19876980158257201,-398
23,2017-01-24,2017,148452,148452,216907621.50000012,2445759.4666666673,113766,0,74,0.8034718292781495,24230244,1534403364,579148,579148,215746535.4999975,2442189.3999999515,114180,0,76,0.20765158474172962,1621121650,-430696,-430696,1161086.0000026226,3570.0666667157784,-414,0,-2,0.5958202445364199,-1596891406,1461.1296681755728,372.52401027025473,1088.605657905318,0.7663487187777868,0.19715167798213928,-414
24,2017-01-25,2017,144065,144065,217024347.04999998,2391731.916666665,111815,0,117,0.8150973518897725,24196212,1541190818,579529,579529,215849460.56666267,2388758.9833332757,112143,0,117,0.20411230499250463,1630594999,-435464,-435464,1174886.483337313,2972.933333389461,-328,0,0,0.6109850468972678,-1606398787,1506.4335338215387,372.45670288572734,1133.9768309358114,0.7761427133585534,0.19350714114392895,-328
25,2017-01-26,2017,141155,141155,216828913.8166665,2314583.4666666673,107384,0,80,0.7975913003435948,23529691,1546438249,583327,583327,215666492.04999632,2311327.866666613,107689,0,81,0.19449296878079975,1641236065,-442172,-442172,1162421.7666701972,3255.60000005411,-305,0,-1,0.6030983315627951,-1617706374,1536.105088850317,369.71800045257004,1166.387088397747,0.7607523644220892,0.18461171864151668,-305
26,2017-01-27,2017,132475,132475,216179059.09999976,2255524.3999999985,103358,0,64,0.8176108699754668,23576061,1549501008,582713,582713,215057955.91666448,2252933.6333332867,103502,0,64,0.18667680316038862,1652275369,-450238,-450238,1121103.1833352745,2590.7666667117737,-144,0,0,0.6309340668150782,-1628699308,1631.847964521606,369.06325398037194,1262.784710541234,0.7802075863370447,0.17762088712625254,-144
27,2017-01-28,2017,133535,133535,215911273.01666635,2255904.649999996,102621,0,31,0.8104916314074957,24019771,1556033790,589973,589973,214824968.5666633,2252970.4499999667,102748,0,31,0.18403893059513107,1663769615,-456438,-456438,1086304.4500030577,2934.200000029523,-127,0,0,0.6264527008123646,-1639749844,1616.889003007948,364.1267796435825,1252.7622233643656,0.7684951510839855,0.17415712244458645,-127
28,2017-01-29,2017,139404,139404,216412478.98333317,2267117.1333333324,105674,0,66,0.8022797050299841,24239221,1566536427,598373,598373,215312848.68333092,2264426.1333332565,105844,0,67,0.18778755057464583,1674926904,-458969,-458969,1099630.300002247,2691.000000075903,-170,0,-1,0.6144921544553383,-1650687683,1552.4122620823878,359.83048814590717,1192.5817739364807,0.7580413761441566,0.1768863234136567,-170
29,2017-01-30,2017,138798,138798,217003484.5166667,2308767.2166666696,107689,0,70,0.8150765861179552,24270524,1577632494,604047,604047,215900019.2833311,2306005.066666648,107883,0,71,0.18814926653058855,1676033523,-465249,-465249,1103465.2333356142,2762.150000021793,-194,0,-1,0.6269273195873666,-1651762999,1563.4482090279882,357.422550369973,1206.0256586580153,0.775868528364962,0.17860034070196523,-194
30,2017-01-31,2017,142450,142450,217328670.0833335,2346600.766666669,110954,0,82,0.822976482976483,24095038,1585438066,605837,605837,216167072.30000025,2343918.8999999547,111224,0,82,0.19469428245550716,1680666748,-463387,-463387,1161597.783333242,2681.866666714195,-270,0,0,0.6282822005209758,-1656571710,1525.6487896337908,356.8073133532621,1168.8414762805287,0.7788978588978589,0.18358733454708115,-270
31,2017-02-01,2017,143840,143840,217945563.71666676,2362574.133333335,112466,0,78,0.8307911568409347,23932339,1595056668,368002,368002,216761552.89999902,2358964.6666664705,112840,0,80,0.32743300308151246,1669637133,-224162,-224162,1184010.8166677356,3609.466666864697,-374,0,-2,0.5033581537594223,-1645704794,1515.1944084862816,589.0227577567487,926.171650729533,0.7818826473859845,0.30662876832191127,-374
32,2017-02-02,2017,150676,150676,218536311.63333327,2404289.6166666658,116182,0,87,0.8223539249780987,24494106,1605267016,380734,380734,217358539.96666247,2401066.5166666135,116462,0,87,0.32739918158084547,1677931826,-230058,-230058,1177771.6666707993,3223.100000052247,-280,0,0,0.4949547433972532,-1653437720,1450.3723992761506,570.8934320724245,879.4789672037261,0.7710717035227906,0.30588810035352765,-280
33,2017-02-03,2017,150832,150832,218992090.46666688,2407529.4,116789,0,62,0.8221531240055164,24359829,1614413611,385434,385434,217795805.39999682,2404078.8833332937,117040,0,62,0.32397245702247474,1685200885,-234602,-234602,1196285.0666700602,3450.516666706186,-251,0,0,0.4981806669830417,-1660841056,1451.8940971853908,565.0664066999715,886.8276904854193,0.7742985573353135,0.3036576949620428,-251
34,2017-02-04,2017,152889,152889,219065606.26666674,2416824.9999999995,118206,0,59,0.8286534675483517,24452453,1621082717,394892,394892,217869359.44999695,2413079.7166666146,118632,0,60,0.3238910892092028,1692721730,-242003,-242003,1196246.816669792,3745.2833333848976,-426,0,-1,0.5047623783391488,-1668269277,1432.8408601447243,551.7188483180134,881.1220118267108,0.7731491474206778,0.3004163163599161,-426
35,2017-02-05,2017,149666,149666,218987782.5666664,2392874.1166666686,116268,0,58,0.8293333155158824,24224471,1626513832,398777,398777,217775578.46666285,2389319.0833332986,116588,0,58,0.3136991351055836,1699304451,-249111,-249111,1212204.1000035405,3555.0333333699964,-320,0,0,0.5156341804102988,-1675079980,1463.1765569111649,546.1086734356868,917.0678834754781,0.7768497855224299,0.2923639026322983,-320
36,2017-02-06,2017,153688,153688,219554053.15000018,2449578.099999998,120167,0,48,0.8354718650772998,24607879,1636483450,408838,408838,218337015.0666666,2445463.4166664537,120606,0,49,0.31661440472754837,1705414758,-255150,-255150,1217038.0833335817,4114.683333544526,-439,0,-1,0.5188574603497513,-1680806879,1428.5699153479788,534.0428606603755,894.5270546876034,0.7818892821820832,0.2949970403925271,-439
37,2017-02-07,2017,155418,155418,220058337.61666667,2427255.0666666664,122068,0,59,0.8394716184740504,24364974,1644790676,411672,411672,218829633.3833331,2423645.783333136,122385,0,59,0.31895538195456397,1709212349,-256254,-256254,1228704.2333335876,3609.2833335306495,-317,0,0,0.5205162365194864,-1684847375,1415.9128132948995,531.5630729885274,884.349740306372,0.7854173905210464,0.2972876464758351,-317
38,2017-02-08,2017,163747,163747,220735637.73333356,2511271.783333337,127870,0,70,0.8370718242166257,24579773,1653563613,424956,424956,219502883.8166634,2507263.7333332626,128224,0,70,0.32554899801391285,1716771037,-261209,-261209,1232753.9166701436,4008.0500000743195,-354,0,0,0.5115228262027129,-1692191264,1348.0285912617242,516.5308498213071,831.497741440417,0.7808998027444778,0.3017347678347876,-354
39,2017-02-09,2017,153794,153794,220968451.86666673,2498056.1833333317,121402,0,58,0.8440186223129635,25099648,1660118106,422400,422400,219740109.0166669,2494511.166666433,121793,0,59,0.3100781249999957,1723856111,-268606,-268606,1228342.849999845,3545.016666898504,-391,0,-1,0.5339404973129678,-1698756463,1436.782006233447,520.2180611190031,916.5639451144439,0.7893806000234079,0.28833570075757575,-391
40,2017-02-10,2017,155476,155476,221283294.18333343,2500084.3000000007,121866,0,59,0.8380843345596752,24954676,1667459564,430998,430998,220049717.09999782,2496482.6333331103,122222,0,61,0.30469978979020607,1731203157,-275522,-275522,1233577.0833356082,3601.6666668904945,-356,0,-2,0.5333845447694692,-1706248481,1423.2633601541938,510.5585573482889,912.7048028059049,0.783825156294219,0.2835790421301259,-356
41,2017-02-11,2017,160668,160668,221474997.0166665,2513371.5166666666,126048,0,50,0.8395946921602312,24920467,1673958954,441850,441850,220248882.13333356,2510241.7333330754,126466,0,50,0.30771302478216145,1738341440,-281182,-281182,1226114.883332938,3129.7833335911855,-418,0,0,0.5318816673780697,-1713420973,1378.4636456336452,498.4698022707561,879.9938433628892,0.7845246097542758,0.2862193051940704,-418
42,2017-02-12,2017,166033,166033,221433354.21666676,2567318.183333333,128720,0,54,0.8320936199430234,25248922,1678478926,453468,453468,220174271.8666622,2563333.4833333082,129239,0,55,0.30798424585637546,1744815011,-287435,-287435,1259082.3500045538,3984.7000000248663,-519,0,-1,0.524109374086648,-1719566089,1333.6707414590278,485.53430863183775,848.13643282719,0.7752675672908398,0.28500136724090785,-519
43,2017-02-13,2017,167331,167331,222031709.91666645,2618719.6666666665,129695,0,64,0.8354518887713573,26035421,1689029102,458640,458640,220742586.9333294,2614557.933333287,130315,0,64,0.3088326356183571,1752829540,-291309,-291309,1289122.9833370447,4161.733333379496,-620,0,0,0.5266192531530003,-1726794119,1326.9012311924655,481.29815745100603,845.6030737414594,0.7750805290113607,0.2841335252049538,-620
44,2017-02-14,2017,171027,171027,222678807.7666665,2645436.449999999,132668,0,81,0.8364351827489239,25256805,1697620172,465482,465482,221394649.86666554,2641300.0999999125,133105,0,81,0.31019459399074556,1759605128,-294455,-294455,1284157.9000009596,4136.3500000862405,-437,0,0,0.5262405887581784,-1734348323,1302.0096696233138,475.6245136582414,826.3851559650724,0.7757137761873856,0.2859509068019816,-437
45,2017-02-15,2017,174478,174478,223268387.93333343,2684538.133333329,135443,0,86,0.8406274716583174,25964794,1706922615,475304,475304,221967717.3333333,2680245.533333102,136086,0,88,0.31301440762122223,1767839357,-300826,-300826,1300670.6000001132,4292.600000227336,-643,0,-2,0.5276130640370952,-1741874563,1279.6363319921907,467.0015765348773,812.6347554573133,0.7762755189766045,0.28631360140036693,-643
46,2017-02-16,2017,173877,173877,223804885.25,2609316.0499999993,135122,0,57,0.8338825721630816,24239995,1714414025,481622,481622,222518851.316667,2603734.0666665505,135562,0,57,0.30369667498578545,1776436038,-307745,-307745,1286033.9333330095,5581.983333448879,-440,0,0,0.5301858971772961,-1752196043,1287.144850957861,462.01969867794037,825.1251522799207,0.7771125565773507,0.2814697003043881,-440
47,2017-02-17,2017,175801,175801,224471896.21666658,2681276.2499999986,137066,0,59,0.8402113753619145,25350471,1722535056,492588,492588,223181857.36666602,2676039.549999941,137598,0,59,0.3031986162878502,1786284096,-316787,-316787,1290038.8500005603,5236.700000057463,-532,0,0,0.5370127590740643,-1760933625,1276.8522148148566,453.08017525125666,823.7720395636,0.7796656446777891,0.2793368900582231,-532
48,2017-02-18,2017,171962,171962,224633909.16666663,2654375.8499999964,133247,0,60,0.8379467556785797,25062900,1728574128,497667,497667,223315620.31666374,2649026.849999905,133751,0,61,0.29291875892916586,1793164691,-325705,-325705,1318288.8500028849,5349.00000009127,-504,0,-1,0.5450279967494138,-1768101791,1306.2997009029125,448.7249914434024,857.5747094595101,0.7748630511392052,0.2687560155686433,-504
49,2017-02-19,2017,170315,170315,224812949.23333326,2625187.05,131969,0,137,0.8326806212018906,24737952,1734553655,504634,504634,223489498.98333192,2620350.716666501,132261,0,137,0.28359959891723363,1803355019,-334319,-334319,1323450.250001341,4836.333333498798,-292,0,0,0.5490810222846569,-1778617067,1319.9832617992147,442.8744376782617,877.1088241209529,0.7748524792296627,0.26209292279156776,-292
50,2017-02-20,2017,171242,171242,225283787.63333362,2624643.23333333,132376,0,119,0.8286752081849081,24543670,1741868108,513841,513841,223969077.9499943,2619651.3999999417,132709,0,118,0.27894426486014146,1811688155,-342599,-342599,1314709.6833393276,4991.833333388437,-333,0,1,0.5497309433247667,-1787144485,1315.5872252913048,435.87233784379663,879.7148874475081,0.7730346527137034,0.25826860838274873,-333
51,2017-02-21,2017,172239,172239,225839250.91666675,2663990.0499999984,133570,0,68,0.8349734961303771,25059877,1750092896,519851,519851,224545191.33333045,2659433.5166665,134075,0,68,0.28002254492152584,1816507965,-347612,-347612,1294059.5833362937,4556.533333498519,-505,0,0,0.5549509512088513,-1791448088,1311.196946781314,431.9414434777089,879.2555033036051,0.7754921939862632,0.25791043972215116,-505
52,2017-02-22,2017,172158,172158,226471573.55000007,2684267.8833333286,134575,0,97,0.8430976196284814,24945732,1757908620,525008,525008,225180860.86666423,2678952.6999999885,135036,0,97,0.2798547831652091,1823819072,-352850,-352850,1290712.6833358407,5315.183333340101,-461,0,0,0.5632428364632722,-1798873340,1315.4867827809342,428.9093896981841,886.5773930827501,0.7816947222899894,0.2572075092189071,-461
53,2017-02-23,2017,173941,173941,227016322.33333313,2696761.8833333314,136660,0,98,0.8447749524263974,25037058,1765520757,534429,534429,225716453.1166647,2692080.1833331482,137090,0,98,0.27797144241798044,1831148022,-360488,-360488,1299869.216668427,4681.700000183191,-430,0,0,0.566803510008417,-1806110964,1305.1340531176268,422.35068290954405,882.7833702080827,0.7856687037558713,0.25651676836399223,-430
54,2017-02-24,2017,177223,177223,227595638.0833328,2724978.166666667,138891,0,85,0.8439931611585403,25322778,1773478613,542793,542793,226282281.2166649,2718328.3666665712,139463,0,86,0.279086134124795,1838812300,-365570,-365570,1313356.8666678965,6649.80000009574,-572,0,-1,0.5649070270337453,-1813489522,1284.2330740554714,416.8850394472016,867.3480346082698,0.78370753231804,0.2569358853190811,-572
55,2017-02-25,2017,169938,169938,228034182.60000008,2708065.8666666625,133626,0,88,0.8430839482634828,25106262,1780882916,544120,544120,226727642.1666646,2703565.699999982,134224,0,89,0.2667260898331235,1846601567,-374182,-374182,1306540.433335483,4500.166666680481,-598,0,-1,0.5763578584303592,-1821495305,1341.8669314691244,416.68683776862565,925.1800937004988,0.7863220704021466,0.2466808792178196,-598
56,2017-02-26,2017,171182,171182,228423245.7166666,2707239.800000003,133597,0,90,0.8394924700026876,25199475,1788045580,551462,551462,227107250.76666299,2702663.5166666247,134194,0,91,0.2636537059670445,1856432492,-380280,-380280,1315994.950003624,4576.283333378378,-597,0,-1,0.575838764035643,-1831233017,1334.3882284157598,411.8275615847746,922.5606668309852,0.7804383638466661,0.2433422429831974,-597
57,2017-02-27,2017,179201,179201,229306039.43333325,2789602.9666666677,140390,0,76,0.8451905960346212,25578474,1798653485,563855,563855,227983696.59999904,2784111.299999849,141169,0,76,0.27230582330563663,1866947519,-384654,-384654,1322342.8333342075,5491.666666818783,-779,0,0,0.5728847727289845,-1841369045,1279.6024544133863,404.3303625932182,875.2720918201682,0.783421967511342,0.250364012024368,-779
58,2017-02-28,2017,181572,181572,229928906.2500002,2788640.683333337,141450,0,91,0.840509549930607,25115045,1806270094,569355,569355,228581298.88333184,2782497.6999998423,142024,0,92,0.2712753905735421,1872999010,-387783,-387783,1347607.3666683733,6142.983333494514,-574,0,-1,0.5692341593570649,-1847883965,1266.3235865111371,401.4741222670071,864.8494642441301,0.7790298063578085,0.24944718145972197,-574
59,2017-03-01,2017,179873,179873,230456019.51666662,2763388.9000000004,141036,0,102,0.8480483452213518,25461837,1813540140,398477,398477,229104337.43333292,2758010.8666664865,141427,0,103,0.38714907008435545,1867084366,-218604,-218604,1351682.083333701,5378.033333513886,-391,0,-1,0.4608992751369963,-1841622529,1281.215188030814,574.9499655772678,706.2652224535462,0.7840865499546903,0.3549188535348339,-391
60,2017-03-02,2017,180861,180861,230606408.6333332,2773520.8166666664,141711,0,65,0.8496635537788679,25641650,1819115157,412255,412255,229306620.44999868,2769606.6333331796,142343,0,65,0.3776085189991643,1876272177,-231394,-231394,1299788.1833345294,3914.1833334867842,-632,0,0,0.4720550347797036,-1850630527,1275.0477362910367,556.2252015136231,718.8225347774136,0.7835354222303316,0.3452790142023747,-632
61,2017-03-03,2017,186116,186116,231267683.76666668,2826406.516666669,146105,0,41,0.8517644909626259,25737456,1827516173,423419,423419,229969570.73333198,2821879.3999998067,146942,0,34,0.3798837558069002,1884062657,-237303,-237303,1298113.0333347023,4527.116666862275,-837,0,7,0.47188073515572565,-1858325201,1242.5996892618941,543.125298423859,699.4743908380351,0.7850211695931569,0.3470368594701702,-837
62,2017-03-04,2017,178549,178549,231650176.2166667,2804417.8,139690,0,52,0.8472856190737553,25297646,1832775854,426361,426361,230350028.48333174,2800091.249999957,140513,0,52,0.3608350669972173,1892814977,-247812,-247812,1300147.7333349586,4326.550000042655,-823,0,0,0.48645055207653803,-1867517331,1297.4039407482915,540.2699320137905,757.134008734501,0.7823622647004463,0.32956344506181384,-823
63,2017-03-05,2017,178632,178632,232028835.58333328,2745480.8333333316,140403,0,73,0.8512416588293248,25022227,1839666327,435907,435907,230720406.98333007,2740656.733333259,141288,0,73,0.3548050386894486,1902741696,-257275,-257275,1308428.6000032127,4824.100000072736,-885,0,0,0.49643662013987616,-1877719469,1298.9208853023717,529.2881439924802,769.6327413098916,0.7859901921268306,0.3241241824517615,-885
64,2017-03-06,2017,177092,177092,232295581.2833329,2701865.8166666687,138355,0,52,0.8422910125810306,24669294,1845355145,445773,445773,230987816.66666818,2697509.3333331565,139217,0,52,0.3404670089933668,1911920388,-268681,-268681,1307764.6166647375,4356.483333512209,-862,0,0,0.5018240035876638,-1887251094,1311.722614704972,518.1736369557335,793.5489777492386,0.7812605877171188,0.31230469319586424,-862
65,2017-03-07,2017,180003,180003,232453921.66666627,2731600.7166666677,138954,0,39,0.8312083687494091,23184022,1847986435,455633,455633,231100852.53332913,2727229.500000012,139572,0,34,0.3322849749688893,1912969459,-275630,-275630,1353069.13333714,4371.216666655615,-618,0,5,0.49892339378051975,-1889785437,1291.3891527733774,507.2083289255368,784.1808238478407,0.7719538007699872,0.30632548564305045,-618
66,2017-03-08,2017,177666,177666,232181019.68333334,2738673.0166666624,138236,0,45,0.8257179201422908,14021701,1837263586,461853,461853,230897551.83332846,2734954.349999993,138584,0,32,0.31991780934627057,1908123210,-284187,-284187,1283467.8500048816,3718.6666666693054,-348,0,13,0.5058001107960203,-1894101509,1306.839911312988,499.93732168748164,806.9025896255064,0.7780667094435626,0.3000608418695992,-348
67,2017-03-09,2017,181594,181594,232192639.8499999,2783482.8333333335,141884,0,35,0.8301155324515133,13901055,1831325814,471983,471983,230910572.7499912,2779267.900000052,142240,0,43,0.3215115798662259,1902743407,-290389,-290389,1282067.1000086963,4214.933333281428,-356,0,-8,0.5086039525852873,-1888842352,1278.6360774585057,489.23493589809635,789.4011415604093,0.7813253741863718,0.30136678651561605,-356
68,2017-03-10,2017,182306,182306,232526460.3833335,2777152.9666666645,143556,0,43,0.8356225247660537,14110106,1827883222,479738,479738,231245499.81666285,2773031.316666708,144005,0,39,0.3200830453289051,1897059149,-297432,-297432,1280960.5666706562,4121.6499999566,-449,0,4,0.5155394794371486,-1882949043,1275.4734368771929,482.02456302536564,793.4488738518272,0.7874452843022172,0.3001742617845574,-449
69,2017-03-11,2017,179634,179634,232558965.78333366,2746872.6500000036,140509,0,44,0.8285402540721694,14081656,1823770350,488086,488086,231281761.51666197,2743298.366666721,140845,0,44,0.30723069295165384,1893201673,-308452,-308452,1277204.2666716874,3574.283333282452,-336,0,0,0.5213095611205155,-1879120017,1294.6266618977124,473.85452874424175,820.7721331534707,0.7821960207978446,0.2885659494433358,-336
70,2017-03-12,2017,175935,175935,232609259.61666682,2667060.4666666677,138273,0,51,0.8302157046636535,13595348,1819322851,494853,494853,231320359.55000588,2663238.5499998974,138607,0,51,0.29723978636079856,1890920716,-318918,-318918,1288900.0666609406,3821.916666770354,-334,0,0,0.5329759183028548,-1877325368,1322.131807864648,467.45267695660306,854.679130908045,0.785932304544292,0.28009732183092756,-334
71,2017-03-13,2017,175563,175563,232497744.75000027,2685513.4833333334,138129,0,41,0.8330684711471095,13771733,1814912761,504848,504848,231185621.36666203,2682043.183333358,138428,0,41,0.29120646214305773,1888231447,-329285,-329285,1312123.3833382428,3470.2999999755993,-299,0,0,0.5418620090040518,-1874459714,1324.2980853027134,457.93114237683824,866.3669429258752,0.7867773961483912,0.27419738218235984,-299
72,2017-03-14,2017,178563,178563,232730217.79999965,2749789.5166666643,140090,0,45,0.8286151106332224,14152749,1812005348,512945,512945,231410238.71666062,2745988.6333333454,140425,0,45,0.2903332715983161,1880776336,-334382,-334382,1319979.0833390355,3800.883333318867,-335,0,0,0.5382818390349062,-1866623587,1303.3507378348238,451.1404511529708,852.210286681853,0.7845410303366319,0.2737622942030822,-335
73,2017-03-15,2017,185754,185754,233107729.13333344,2798216.8166666697,144842,0,43,0.833344100261636,16975195,1811931633,525215,525215,231780773.73333108,2793945.583333288,145383,0,39,0.2974667517112012,1879346037,-339461,-339461,1326955.4000023603,4271.233333381824,-541,0,4,0.5358773485504348,-1862370842,1254.9271032297202,441.3064625597728,813.6206406699473,0.7797517146333323,0.2768066410898394,-541
74,2017-03-16,2017,196505,196505,233877358.36666688,2908259.5833333293,152661,0,51,0.8484720490572758,25609064,1822278549,540259,540259,232540193.71666545,2903252.8166665686,153910,0,51,0.3159577165766737,1883294026,-343754,-343754,1337164.6500014365,5006.766666760668,-1249,0,0,0.5325143324806021,-1857684962,1190.1852795942439,430.42354447897293,759.761735115271,0.7768809953945193,0.284881880727577,-1249
75,2017-03-17,2017,193660,193660,234414534.48333326,2907828.9166666656,151927,0,48,0.8618041929154198,25715040,1830898900,549430,549430,233091984.13332993,2902741.316666565,153211,0,39,0.3105054329031886,1892783607,-355770,-355770,1322550.350003332,5087.600000100676,-1284,0,9,0.5512987600122312,-1867068567,1210.4437389410991,424.24327782125096,786.2004611198481,0.7845037694929258,0.27885444915639845,-1284
76,2017-03-18,2017,188929,188929,234639008.36666656,2904784.799999996,147783,0,81,0.8553213111803898,25721327,1837155023,555801,555801,233267921.88332993,2899585.549999858,149086,0,81,0.2979069846941602,1903554496,-366872,-366872,1371086.4833366275,5199.250000138301,-1303,0,0,0.5574143264862296,-1877833169,1241.9427846792528,419.6968373272627,822.24594735199,0.7822144826892642,0.2682362932056617,-1303
77,2017-03-19,2017,188204,188204,234938349.00000012,2854585.633333338,146619,0,110,0.847070200420819,25382234,1843347816,564351,564351,233548632.21666437,2849784.933333207,147762,0,111,0.2882000740673776,1913429574,-376147,-376147,1389716.7833357453,4800.700000131037,-1143,0,-1,0.5588701263534415,-1888047340,1248.3175118488455,413.83577280214683,834.4817390466986,0.7790429533910013,0.2618264165386435,-1143
78,2017-03-20,2017,187867,187867,235613166.78333336,2836736.56666667,146232,0,128,0.8470194339612616,25332204,1853647067,576531,576531,234244316.89999762,2832384.866666532,147170,0,128,0.2813049081489111,1923599613,-388664,-388664,1368849.8833357394,4351.700000138022,-938,0,0,0.5657145258123504,-1898267409,1254.1487689872802,406.2996038374305,847.8491651498497,0.7783804499992015,0.25526814689929944,-938
79,2017-03-21,2017,189034,189034,235889513.98333308,2857083.316666668,146644,0,101,0.8459483479162475,25322639,1859345513,585456,585456,234486862.2166618,2851879.7999999025,147780,0,102,0.27948129321417786,1928100048,-396422,-396422,1402651.7666712701,5203.516666765325,-1136,0,-1,0.5664670547020696,-1902777409,1247.868182355201,400.5200428668624,847.3481394883386,0.7757546261519092,0.2524186275313602,-1136
80,2017-03-22,2017,188720,188720,236508413.78333354,2891391.6,147782,0,92,0.855505510809665,25538400,1867945569,591832,591832,235099530.9833309,2886173.7666665195,148944,0,92,0.2788223685099784,1937298086,-403112,-403112,1408882.8000026345,5217.8333334806375,-1162,0,0,0.5766831422996865,-1911759686,1253.2238966899827,397.2403164805737,855.983580209409,0.7830754557015684,0.2516660133281066,-1162
81,2017-03-23,2017,191471,191471,237249212.86666656,2921827.0500000054,150082,0,119,0.8525364154362807,25514203,1876650093,601823,601823,235824208.21666545,2917021.066666591,151144,0,119,0.27653479511417584,1945316560,-410352,-410352,1425004.6500011086,4805.9833334144205,-1062,0,0,0.5760016203221048,-1919802357,1239.0869263056366,391.8497767892976,847.237149516339,0.7838367167873986,0.25114360866899405,-1062
82,2017-03-24,2017,190733,190733,237703429.48333302,2894057.733333332,148044,0,82,0.8413384154813283,25329204,1882970504,609788,609788,236278561.28332886,2889067.449999829,149121,0,82,0.26810465276457046,1954026124,-419055,-419055,1424868.2000041604,4990.2833335031755,-1077,0,0,0.5732337627167579,-1928696920,1246.2627310603461,387.4765677306357,858.7861633297105,0.7761845092354234,0.24454564537183415,-1077
83,2017-03-25,2017,186075,186075,237689287.66666636,2849689.9166666656,144905,0,69,0.8444336960902857,24982237,1886365612,617811,617811,236280418.34999844,2845100.2333331723,145914,0,69,0.2592799416002659,1961952125,-431736,-431736,1408869.3166679144,4589.6833334933035,-1009,0,0,0.5851537544900198,-1936969888,1277.3843217340661,382.44773620087443,894.9365855331916,0.778745129652022,0.23617902562434143,-1009
84,2017-03-26,2017,185361,185361,237849735.5166667,2868465.816666663,146026,0,47,0.8567336171039216,25140252,1890861504,626189,626189,236431657.4666603,2864055.666666637,147122,0,47,0.25855292890804926,1970890408,-440828,-440828,1418078.0500064194,4410.150000025984,-1096,0,0,0.5981806881958723,-1945750156,1283.1703298788134,377.5723582922413,905.5979715865722,0.7877924698291442,0.23494823447872767,-1096
85,2017-03-27,2017,196541,196541,238580868.60000023,2968542.449999996,153366,0,57,0.8500669071593208,25249449,1899451646,641748,641748,237122778.66666222,2963561.4166665385,154546,0,41,0.26534247087642143,1977327023,-445207,-445207,1458089.9333380163,4981.033333457541,-1180,0,16,0.5847244362828994,-1952077574,1213.8987213863786,369.4951580163276,844.403563370051,0.780325733561954,0.2408203843253115,-1180
86,2017-03-28,2017,193640,193640,239052155.70000035,2962824.9499999997,152027,0,52,0.85090890311919,24355756,1904614009,644000,644000,237563547.1333307,2957553.8833332444,153079,0,36,0.2606195652173895,1979428497,-450360,-450360,1488608.566669643,5271.06666675536,-1052,0,16,0.5902893379018005,-1955072741,1234.5184657095658,368.8874955486502,865.6309701609157,0.7851012187564553,0.2377003105590062,-1052
87,2017-03-29,2017,194044,194044,239528541.66666663,2981662.699999993,152886,0,57,0.8547752056234668,25511090,1910185825,652048,652048,238004961.5333289,2976632.08333327,153798,0,35,0.258898117929968,1986923658,-458004,-458004,1523580.1333377361,5030.616666723043,-912,0,22,0.5958770876934988,-1961412568,1234.4032367229424,365.0114125544882,869.3918241684543,0.7878934674609882,0.23586913846833363,-912
88,2017-03-30,2017,192161,192161,240017428.38333338,2889393.9499999993,150697,0,51,0.8474924672540212,23787807,1915926618,658564,658564,238492758.86666232,2884652.483333194,151515,0,51,0.2508321135075719,1991578149,-466403,-466403,1524669.5166710615,4741.466666805092,-818,0,0,0.5966603537464492,-1967790342,1249.0433978972496,362.1405950927508,886.9028028044988,0.7842226050030964,0.23006875565624602,-818
89,2017-03-31,2017,189818,189818,239931626.4166668,2872263.2333333315,149690,0,85,0.8554562791726804,25918974,1919689263,670377,670377,238373350.19999525,2867598.2499999274,150882,0,85,0.24762036883723176,1997579135,-480559,-480559,1558276.2166715562,4664.983333404176,-1192,0,0,0.6078359103354487,-1971660161,1264.0088211690504,355.5810390272865,908.4277821417638,0.7885974986566079,0.2250703708510286,-1192
90,2017-04-01,2017,189829,189829,239813747.55000016,2907576.2166666663,149694,0,51,0.8629450716170877,26095796,1923342489,439010,439010,238243280.04999653,2902455.249999854,150930,0,54,0.3811644381676947,1984377439,-249181,-249181,1570467.5000036359,5120.966666812543,-1236,0,-3,0.481780633449393,-1958281643,1263.3146018258547,542.6830369467586,720.631564879096,0.7885728734808696,0.3437962688777021,-1236
91,2017-04-02,2017,192195,192195,240232432.4666664,2978619.250000004,151749,0,52,0.8659226306615678,26476208,1929871993,446915,446915,238651219.58332878,2973827.5833332,152943,0,36,0.38055558663280625,1993581531,-254720,-254720,1581212.883337617,4791.666666804347,-1194,0,16,0.4853670440287616,-1967105323,1249.9411143196567,533.9968888565584,715.9442254630983,0.7895574806836806,0.34221943770068136,-1194
92,2017-04-03,2017,194715,194715,240853301.43333298,2983602.0499999993,152094,0,47,0.8517166114577722,26501491,1938873776,456330,456330,239305395.3666634,2979200.2333331956,153125,0,38,0.37079306642122967,2002986475,-261615,-261615,1547906.0666695833,4401.816666803788,-1031,0,9,0.48092354503654255,-1976484984,1236.9529899254449,524.4130242733622,712.5399656520826,0.7811108543255527,0.33555760085902747,-1031
93,2017-04-04,2017,193803,193803,241171236.36666706,2941171.6,151229,0,59,0.8449662801917424,26495340,1946285248,465935,465935,239593345.3333314,2936129.199999846,152329,0,36,0.35830105057572303,2007126929,-272132,-272132,1577891.033335656,5042.400000154041,-1100,0,23,0.4866652296160193,-1980631589,1244.4143608028103,514.2205357685759,730.1938250342344,0.7803233180084932,0.32693186817903785,-1100
94,2017-04-05,2017,192814,192814,241322408.49999955,2822382.2666666606,150070,0,42,0.8396900639995021,24568507,1949934183,475724,475724,239727438.74999982,2817779.449999906,151073,0,45,0.346253289722611,2014418684,-282910,-282910,1594969.7499997318,4602.816666754428,-1003,0,-3,0.4934367742768911,-1989850177,1251.581360793301,503.9212626438856,747.6600981494154,0.7783148526559275,0.31756438607259674,-1003
95,2017-04-06,2017,191905,191905,241617670.6333336,2916632.383333331,147903,0,49,0.8302753966806486,24026168,1952845317,486088,486088,240011296.59999758,2911927.999999877,148957,0,49,0.3339950790803321,2019140433,-294183,-294183,1606374.0333360136,4704.383333453909,-1054,0,0,0.49628031760031655,-1995114265,1259.0483345057899,493.76099924293044,765.2873352628594,0.7707094656210104,0.3064403976234756,-1054
96,2017-04-07,2017,193586,193586,242028582.1166666,2937414.766666665,149229,0,47,0.835210190819584,24693574,1957118189,492862,492862,240493643.43332645,2932908.5666665686,150318,0,47,0.33381555080327124,2021105849,-299276,-299276,1534938.6833401322,4506.200000096578,-1089,0,0,0.5013946400163127,-1996412275,1250.2380446760953,487.95330829588494,762.2847363802105,0.7708666949056233,0.3049900377793378,-1089
97,2017-04-08,2017,191341,191341,241806361.35,2905099.1166666644,147273,0,57,0.8341285976345886,24342237,1958056196,501926,501926,240282392.21666265,2899858.166666558,148585,0,57,0.3250837772898793,2026362908,-310585,-310585,1523969.1333373487,5240.950000106357,-1312,0,0,0.5090448203447093,-2002020671,1263.7456757830262,478.7207520962505,785.0249236867757,0.7696886710114403,0.29602969362017506,-1312
98,2017-04-09,2017,188905,188905,241841417.41666675,2873801.116666662,145791,0,52,0.8345676398189571,23970533,1961074674,511097,511097,240313401.84999776,2868707.933333311,147212,0,53,0.315491971191381,2032510373,-322192,-322192,1528015.5666689873,5093.183333350811,-1421,0,-1,0.5190756686275761,-2008539840,1280.2277198415434,470.19137629451507,810.0363435470283,0.7717688785368306,0.28803143043297064,-1421
99,2017-04-10,2017,187980,187980,242096180.73333305,2897855.8333333335,146753,0,40,0.8442015107990204,24041105,1965065529,520414,520414,240577980.01666248,2892984.449999904,147945,0,41,0.31065459422690556,2039011414,-332434,-332434,1518200.7166705728,4871.383333429694,-1192,0,-1,0.5335469165721148,-2014970309,1287.8826509912387,462.2819140466292,825.6007369446095,0.7806841153314182,0.2842832821561295,-1192
100,2017-04-11,2017,189285,189285,242188504.9000002,2908462.433333334,146754,0,46,0.8352325857833429,24150098,1967163460,528412,528412,240671620.73333013,2903327.366666632,147886,0,38,0.3048132896300663,2036437024,-339127,-339127,1516884.166670084,5135.066666702274,-1132,0,8,0.5304192961532765,-2012286926,1279.4912692500739,455.46206508052455,824.0292041695493,0.7753070766304778,0.2798687387871585,-1132
101,2017-04-12,2017,194102,194102,242863328.0833337,2959665.5166666694,148802,0,42,0.8279409794850142,25086232,1974563215,539605,539605,241341361.8499993,2954299.249999895,150023,0,35,0.30387968977307644,2041716278,-345503,-345503,1521966.2333343923,5366.266666774172,-1221,0,7,0.5240612897119378,-2016630046,1251.214969878382,447.2556070644255,803.9593628139564,0.7666175515965833,0.2780237395872907,-1221
102,2017-04-13,2017,200558,200558,243549932.33333316,3011064.216666663,152988,0,33,0.8211888830163829,25424234,1981536553,552610,552610,241993093.6999964,3006064.449999884,154059,0,43,0.30296773493060264,2047407370,-352052,-352052,1556838.6333367527,4999.766666779295,-1071,0,-10,0.5182211480857803,-2021983136,1214.3615928226905,437.9093641084968,776.4522287141937,0.7628117552029837,0.27878431443513507,-1071
103,2017-04-14,2017,201366,201366,243980561.11666733,3016725.2666666666,153699,0,35,0.8246079278527655,25277058,1986335901,561287,561287,242428856.99999702,3011123.166666504,154931,0,30,0.3015302331962045,2054648090,-359921,-359921,1551704.1166703105,5602.100000162609,-1232,0,5,0.523077694656561,-2029371032,1211.6273905061794,431.9160376064242,779.7113528997552,0.7632817854056793,0.27602812821248307,-1232
104,2017-04-15,2017,197713,197713,244434547.43333343,3019402.833333336,151412,0,47,0.8303197058362386,25203312,1992174072,567081,567081,242847564.9833299,3014321.9166665794,152556,0,39,0.29508130231836094,2061892981,-369368,-369368,1586982.4500035346,5080.916666756384,-1144,0,8,0.5352384035178777,-2036689669,1236.3099413459581,428.24140640107834,808.0685349448797,0.7658171187529399,0.269019769662535,-1144
105,2017-04-16,2017,192242,192242,244557850.26666668,2960935.48333333,148401,0,61,0.8372416017311514,25357961,1996311904,572225,572225,242999809.48333094,2955644.416666546,149660,0,61,0.287722486784045,2071177950,-379983,-379983,1558040.7833357453,5291.066666784231,-1259,0,0,0.5495191149471064,-2045819989,1272.1353828334427,424.6577997873755,847.4775830460671,0.7719488977434692,0.2615404779588449,-1259
106,2017-04-17,2017,193851,193851,245097946.54999998,2942752.650000001,150031,0,42,0.8389175191255135,25088725,2003605992,584962,584962,243549308.26666498,2937881.1166665293,151144,0,41,0.2832372017327623,2080344779,-391111,-391111,1548638.2833350003,4871.533333471511,-1113,0,1,0.5556803173927511,-2055256054,1264.3625596463262,416.350648874055,848.0119107722712,0.7739500956920522,0.2583825957925472,-1113
107,2017-04-18,2017,202340,202340,245678941.48333368,3046276.9333333345,155075,0,46,0.8310912325788271,24954262,2010042313,599202,599202,244104941.99999607,3040931.316666512,156367,0,43,0.28625738899403086,2084515485,-396862,-396862,1573999.483337611,5345.616666822694,-1292,0,3,0.5448338435847963,-2059561223,1214.1886996309859,407.38338990857187,806.805309722414,0.766408026094692,0.2609587417932517,-1292
108,2017-04-19,2017,200756,200756,246293572.8499999,3038910.433333336,153631,0,40,0.8288071091274979,24848577,2016420170,600799,600799,244702112.48332986,3033159.6166665466,154893,0,47,0.2823024006364866,2086827088,-400043,-400043,1591460.3666700423,5750.816666789353,-1262,0,-7,0.5465047084910113,-2061978511,1226.8304451672673,407.29447366478615,819.5359715024811,0.7652623084739684,0.25781168077843003,-1262
109,2017-04-20,2017,195071,195071,246431692.63333303,2982135.3666666695,151455,0,51,0.8416268948229111,24741289,2020053796,607391,607391,244852680.76666456,2976918.183333211,152734,0,34,0.2760528226463691,2094241627,-412320,-412320,1579011.8666684628,5217.183333458379,-1279,0,17,0.565574072176542,-2069500338,1263.292301948178,403.12200998477846,860.1702919633994,0.7764096149607066,0.2514591095357027,-1279
110,2017-04-21,2017,191697,191697,246585508.98333323,2938101.516666669,148751,0,35,0.8384273097648887,24598602,2023616221,613889,613889,244995605.44999793,2933200.8833332187,149961,0,32,0.26766565291119515,2100052154,-422192,-422192,1589903.5333352983,4900.633333450183,-1210,0,3,0.5707616568536935,-2075453552,1286.3295147202784,399.0877918483601,887.2417228719183,0.7759693683260562,0.24428031777731804,-1210
111,2017-04-22,2017,190641,190641,246737856.6,2943321.066666664,147799,0,37,0.8382981625148839,24562571,2027155959,622941,622941,245156961.98333228,2938227.016666554,149058,0,43,0.2622832659914824,2104013267,-432300,-432300,1580894.6166677177,5094.0500001101755,-1259,0,-6,0.5760148965234015,-2079450696,1294.253893968244,393.54764252687215,900.7062514413719,0.7752739442197638,0.239281087615039,-1259
112,2017-04-23,2017,192226,192226,246970019.30000022,2951271.2499999995,147843,0,37,0.8314015793909257,24358770,2030275744,629939,629939,245414709.4499968,2945612.4999998817,148915,0,36,0.25853138160996564,2111335443,-437713,-437713,1555309.8500034213,5658.750000117812,-1072,0,1,0.57287019778096,-2086976673,1284.789879100643,389.5848795676991,895.2049995329439,0.7691103180631133,0.23639590500032542,-1072
113,2017-04-24,2017,199280,199280,247684202.4333335,3025081.4000000004,152781,0,40,0.8317794058610994,24778556,2037483948,643707,643707,246156933.26666182,3020009.1666665543,154042,0,33,0.26304825021321854,2118239927,-444427,-444427,1527269.1666716635,5072.233333446085,-1261,0,7,0.5687311556478809,-2093461371,1242.8954357353145,382.40524534712506,860.4901903881895,0.766664993978322,0.239304528302473,-1261
114,2017-04-25,2017,199803,199803,248148765.3166665,3032102.166666671,154422,0,40,0.8419993693788387,24847745,2043023625,648383,648383,246597286.6666655,3025714.7499998426,155819,0,35,0.2658120277675423,2120533001,-448580,-448580,1551478.6500010192,6387.416666828562,-1397,0,5,0.5761873416112964,-2095685256,1241.967164240109,380.3265765244701,861.640587715639,0.7728712782090359,0.2403193791323955,-1397
115,2017-04-26,2017,196777,196777,248398637.46666673,2999506.133333339,152903,0,57,0.8460389171498708,24836112,2046598686,655388,655388,246832459.71666783,2994374.3666665372,154246,0,35,0.2602473649197095,2126798250,-458611,-458611,1566177.7499988973,5131.766666801646,-1343,0,22,0.5857915522301613,-2101962138,1262.3357275833391,376.62035270201443,885.7153748813247,0.7770369504566083,0.23535066250831568,-1343
116,2017-04-27,2017,196481,196481,248839389.3000002,3021392.499999996,151183,0,39,0.8322687689903858,24928810,2051637540,664577,664577,247252214.14999932,3016243.6999997147,152466,0,35,0.2516683544570397,2132011427,-468096,-468096,1587175.1500008702,5148.800000281073,-1283,0,4,0.5806004145333461,-2107082617,1266.4806739582973,372.0444946936161,894.4361792646812,0.7694535349473995,0.22941811106914625,-1283
117,2017-04-28,2017,201266,201266,249315421.4166665,3030566.300000002,154646,0,37,0.8281428557232715,24153073,2056503712,676352,676352,247726677.28332794,3025265.249999934,156032,0,34,0.2520374006434497,2137508885,-475086,-475086,1588744.1333385706,5301.050000068266,-1386,0,3,0.5761054550798218,-2113355812,1238.7359087807504,366.2688618993186,872.4670468814318,0.7683662416901017,0.23069644208932627,-1386
118,2017-04-29,2017,204650,204650,249803095.68333334,3109770.8333333354,156611,0,48,0.8263376496457366,25139798,2061560657,686298,686298,248203987.38333046,3104013.599999883,158141,0,34,0.2530110826492288,2143083141,-481648,-481648,1599108.300002873,5757.233333452139,-1530,0,14,0.5733265669965079,-2117943343,1220.6356984282108,361.6562883518974,858.9794100763135,0.7652626435377474,0.23042614141378817,-1530
119,2017-04-30,2017,199853,199853,249867174.1,3045261.8999999957,153929,0,54,0.8303903368976199,24398384,2063869027,690016,690016,248261075.73333165,3039637.999999921,155411,0,54,0.24658848490470617,2151127447,-490163,-490163,1606098.3666683435,5623.900000074878,-1482,0,0,0.5838018519929137,-2126729063,1250.254807783721,359.79031751920485,890.4644902645161,0.7702111051622943,0.2252281106525066,-1482
120,2017-05-01,2017,187916,187916,249693427.88333347,2880120.8499999954,145022,0,38,0.8228623427488877,23965117,2067214211,424743,424743,248073604.28333032,2874883.983333319,146234,0,31,0.37207205298262364,2136888833,-236827,-236827,1619823.600003153,5236.866666676477,-1212,0,7,0.45079028976626406,-2112923716,1328.7502282048015,584.0557802796758,744.6944479251257,0.7717384363226122,0.34428819309558956,-1212
121,2017-05-02,2017,183663,183663,249840019.03333345,2892339.5999999987,142767,0,38,0.8321654334297051,25285643,2072789649,435117,435117,248228542.6833322,2887937.299999785,143715,0,32,0.35826226049546234,2142482315,-251454,-251454,1611476.3500012457,4402.300000213552,-948,0,6,0.4739031729342427,-2117196672,1360.3176417315053,570.4868867070976,789.8307550244077,0.7773313078845494,0.33029047359675673,-948
122,2017-05-03,2017,183701,183701,250119255.4666667,2886377.8166666673,142526,0,37,0.8299737072743218,26336316,2078361183,442725,442725,248495194.39999896,2881983.2333330875,143479,0,40,0.35135354904286537,2147659303,-259024,-259024,1624061.0666677356,4394.583333579823,-953,0,-3,0.4786201582314565,-2121322987,1361.5563087118019,561.2856613021604,800.2706474096415,0.7758585963059537,0.32408154045965326,-953
123,2017-05-04,2017,184339,184339,250404644.03333318,2885951.7333333343,142356,0,30,0.8280342195628702,26570263,2083196339,454393,454393,248786974.39999825,2880796.5333331805,143300,0,25,0.34252288217468035,2155752966,-270054,-270054,1617669.6333349347,5155.2000001538545,-944,0,5,0.4855113373881898,-2129182703,1358.3921147089502,547.5149802043567,810.8771345045935,0.7722511242873185,0.31536577368049246,-944
124,2017-05-05,2017,186774,186774,250895870.46666646,2894803.316666666,143635,0,42,0.8248310792722756,26522719,2091029773,466441,466441,249287592.64999765,2890311.4666666365,144410,0,37,0.33575307487978795,2162172261,-279667,-279667,1608277.8166688085,4491.85000002943,-775,0,5,0.48907800439248766,-2135649542,1343.31261560317,534.4461414198101,808.8664741833597,0.7690310214483814,0.30959971357577915,-775
125,2017-05-06,2017,185415,185415,251164815.1500002,2903689.8500000024,141927,0,56,0.8211309764582152,26531637,2096862834,475575,475575,249543258.41666597,2899278.6833332554,142758,0,50,0.32545865531198664,2168220927,-290160,-290160,1621556.7333342433,4411.166666747071,-831,0,6,0.49567232114622856,-2141689290,1354.6089321252337,524.7190420368312,829.8898900884025,0.7654558692662405,0.30017978236871157,-831
126,2017-05-07,2017,183640,183640,251588158.183333,2876196.183333331,141277,0,38,0.8223208451317799,26114316,2104046517,482891,482891,249954863.96666554,2871888.3666665265,142247,0,31,0.31902230524072817,2178132894,-299251,-299251,1633294.2166674733,4307.816666804254,-970,0,7,0.5032985398910518,-2152018578,1370.0073959013996,517.6217075212948,852.3856883801049,0.7693149640601176,0.29457372367677176,-970
127,2017-05-08,2017,183910,183910,252170268.46666667,2895311.233333334,142185,0,37,0.8274155837094226,26338319,2112207640,494621,494621,250498578.6999997,2890929.599999801,143069,0,41,0.31270407038925,2188969489,-310711,-310711,1671689.7666669786,4381.633333533071,-884,0,-4,0.5147115133201725,-2162631170,1371.1612661990466,506.44549806821726,864.7157681308294,0.7731227230710673,0.2892497487975642,-884
128,2017-05-09,2017,186260,186260,252226659.8500002,2907749.1000000015,143458,0,36,0.8238161709438415,26189347,2115267452,503502,503502,250530233.81666267,2903186.783333242,144310,0,35,0.30982995102303623,2192355621,-317242,-317242,1696426.0333375335,4562.316666759551,-852,0,1,0.5139862199208053,-2166166274,1354.1643930527232,497.57544918721806,856.5889438655051,0.7702029421239128,0.28661256559060344,-852
129,2017-05-10,2017,187698,187698,252857483.59999987,2937893.0500000003,144247,0,36,0.8233705207301083,26538541,2122438382,512671,512671,251103140.63332832,2933315.599999901,145093,0,32,0.3065455233473299,2197051859,-324973,-324973,1754342.9666715562,4577.450000099372,-846,0,4,0.5168249973827784,-2170513318,1347.1506547752233,489.79392365343136,857.3567311217919,0.7685057912178074,0.28301386269166773,-846
130,2017-05-11,2017,189330,189330,253335926.64999995,2938151.833333334,144476,0,51,0.819870068135002,26563911,2128858387,523838,523838,251577844.0166603,2933462.7999999537,145427,0,51,0.3020303987110528,2202069390,-334508,-334508,1758082.6333396435,4689.033333380241,-951,0,0,0.5178396694239491,-2175505479,1338.0654235990066,480.25886632252775,857.8065572764789,0.7630908994876671,0.2776182712976149,-951
131,2017-05-12,2017,187813,187813,253695946.95000044,2922951.316666664,144193,0,64,0.8250547086729882,26557361,2134521664,534159,534159,251946690.38333136,2918132.1833332125,145028,0,53,0.2950825503267723,2208746761,-346346,-346346,1749256.5666690767,4819.13333345158,-835,0,11,0.529972158346216,-2182189400,1350.7901314073065,471.6698405967724,879.120290810534,0.7677477064952906,0.2715071729578646,-835
132,2017-05-13,2017,187252,187252,254065008.0499996,2926648.083333331,142981,0,37,0.8207121953303569,26498095,2140534080,544591,544591,252293043.6333321,2921785.333333292,143917,0,37,0.28802165294689314,2214876336,-357339,-357339,1771964.4166674912,4862.750000039116,-936,0,0,0.5326905423834638,-2188378241,1356.8079809561425,463.2706813614843,893.5372995946582,0.7635752889154722,0.2642662107893814,-936
133,2017-05-14,2017,185974,185974,254565200.0166663,2882728.799999999,141998,0,36,0.8175551421166409,25698056,2146854909,552952,552952,252768911.39999753,2878479.7666666275,142750,0,36,0.2792231513766159,2225226464,-366978,-366978,1796288.6166687608,4249.033333371393,-752,0,0,0.538331990740025,-2199528408,1368.8214482490364,457.12631729335914,911.6951309556773,0.7635368384827986,0.25815984027546696,-752
134,2017-05-15,2017,187383,187383,255382821.46666643,2925356.666666671,143344,0,54,0.8206667627266079,26173979,2156389935,567038,567038,253580242.5999952,2921325.0999998758,144176,0,55,0.27588274507176036,2235199707,-379655,-379655,1802578.8666712344,4031.5666667954065,-832,0,-1,0.5447840176548475,-2209025728,1362.892159196226,447.2014972541438,915.6906619420822,0.7649786800296718,0.25426161915074474,-832
135,2017-05-16,2017,188848,188848,255896699.38333303,2948707.4333333336,143939,0,69,0.8174087096500884,26603711,2163445875,575080,575080,254116527.1999973,2944159.5499998867,144808,0,69,0.27311504486332777,2240496060,-386232,-386232,1780172.1833357215,4547.883333446924,-869,0,0,0.5442936647867607,-2213892349,1355.0405584561818,441.88030743548256,913.1602510206992,0.762194992798441,0.25180496626556303,-869
136,2017-05-17,2017,189751,189751,256652729.68333277,2967704.1333333333,145531,0,88,0.8224357183888349,26831826,2172405114,585404,585404,254870480.79999876,2963220.649999876,146363,0,88,0.2708317674631507,2248036309,-395653,-395653,1782248.8833340108,4483.483333457261,-832,0,0,0.5516039509256843,-2221204483,1352.5764274408714,435.3753660719755,917.2010613688958,0.7669577498932812,0.25002049866417037,-832
137,2017-05-18,2017,188849,188849,257172035.8666663,2963006.5833333316,145074,0,88,0.823387997818363,26742003,2180515605,594779,594779,255373776.83333093,2958788.8499998543,145901,0,89,0.26538092299829075,2257106624,-405930,-405930,1798259.033335358,4217.733333477285,-827,0,-1,0.5580070748200723,-2230364621,1361.7865906976806,429.35910116754445,932.4274895301362,0.7682010495157506,0.24530287720312924,-827
138,2017-05-19,2017,189035,189035,257667432.68333322,2942845.033333335,145455,0,111,0.823905625942285,26686273,2188668121,604992,604992,255843620.73332995,2938383.449999865,146349,0,112,0.26164808790860156,2265759396,-415957,-415957,1823811.9500032663,4461.583333469927,-894,0,-1,0.5622575380336834,-2239073123,1363.0673297713822,422.88760964331755,940.1797201280647,0.7694606818843072,0.24190237226277372,-894
139,2017-05-20,2017,187075,187075,257800160.89999968,2926224.5999999987,144043,0,96,0.8235039422691435,26403204,2193639740,614550,614550,255961109.88333094,2921948.89999991,144934,0,96,0.25512163371572555,2273257025,-427475,-427475,1839051.016668737,4275.700000088662,-891,0,0,0.5683823085534179,-2246853821,1378.0577891220082,416.50168396929615,961.556105152712,0.7699746091139917,0.23583760475144414,-891
140,2017-05-21,2017,187619,187619,258181088.0000003,2912330.7,144182,0,94,0.8213773658318192,26615693,2200482695,624548,624548,256357667.1333313,2907306.9333332544,145062,0,95,0.2509110588777836,2282317255,-436929,-436929,1823420.8666689992,5023.766666745767,-880,0,-1,0.5704663069540357,-2255701562,1376.0924426630581,410.4691186799594,965.6233239830988,0.7684829361631818,0.23226717562140942,-880
141,2017-05-22,2017,191608,191608,258688380.44999975,2959417.316666666,146635,0,93,0.8181965262410755,27309088,2208168086,639400,639399,256866567.24999702,2954822.6666665906,147487,0,94,0.24927431967469124,2292323847,-447792,-447791,1821813.20000273,4594.650000075344,-852,0,-1,0.5689222065663843,-2265014759,1350.091752171098,401.73126209142805,948.36049007967,0.7652864181036283,0.2306646856427901,-852
142,2017-05-23,2017,191157,191157,258751752.75,2977634.0833333307,146790,0,91,0.8263626233933368,27681683,2210640121,645926,645926,256884254.01666406,2973190.2333332067,147896,0,91,0.24990169152503527,2291780321,-454769,-454769,1867498.733335942,4443.850000123959,-1106,0,0,0.5764609318683015,-2264098638,1353.6085665186208,397.6992008630463,955.9093656555744,0.7679028233336995,0.22896740493493062,-1106
143,2017-05-24,2017,194096,194096,259283371.24999982,2982014.1499999994,149111,0,98,0.824968057043937,26922372,2217544843,659000,659000,257418230.28333026,2977137.0499999123,150106,0,98,0.24759787556905258,2297822843,-464904,-464904,1865140.9666695595,4877.100000087172,-995,0,0,0.5773701814748845,-2270900471,1335.8511831773958,390.6194693222007,945.231713855195,0.768233245404336,0.2277784522003035,-995
144,2017-05-25,2017,187854,187854,259103615.03333372,2839382.3166666646,147281,0,82,0.8289363015959201,18486374,2210661269,662346,662346,257249722.33332944,2835603.849999952,147769,0,82,0.23734271815637437,2292583583,-474492,-474492,1853892.7000042796,3778.4666667124256,-488,0,0,0.5915935834395458,-2274097209,1379.2818626876922,388.39175043456055,990.8901122531316,0.7840184398522256,0.22309940725844196,-488
145,2017-05-26,2017,191486,191486,256194515.13333324,2895557.316666665,149507,0,89,0.8356955599887198,22532284,2188148256,681077,681077,254325159.96666598,2891018.1166666658,150097,0,89,0.23839595229320587,2295608089,-489591,-489591,1869355.1666672528,4539.199999999255,-590,0,0,0.5972996076955139,-2273075805,1337.9281782132023,373.41616288123953,964.5120153319627,0.7807724846725087,0.22038183641497217,-590
146,2017-05-27,2017,196762,196762,256691504.81666628,3028484.283333335,151358,0,111,0.8274870147691118,27817145,2195709128,685962,685962,254811745.96666515,3023520.7999999155,152290,0,111,0.24220146305480886,2278595712,-489200,-489200,1879758.8500011265,4963.483333419543,-932,0,0,0.585285551714303,-2250778567,1304.5786524667683,371.466270677771,933.1123817889973,0.7692440613533101,0.22200938244392546,-932
147,2017-05-28,2017,193679,193679,257226729.60000026,2978617.8500000006,147795,0,120,0.8139550493342081,27090453,2202836219,693900,693900,255256709.31666446,2973116.483333307,148569,0,120,0.23119325551233538,2285977034,-500221,-500221,1970020.283335805,5501.366666693706,-774,0,0,0.5827617938218728,-2258886581,1328.1085177019722,367.858062136712,960.2504555652602,0.7630925397177805,0.21410722006052746,-774
148,2017-05-29,2017,191179,191179,257713673.78333336,2991333.099999999,146911,0,115,0.8180919452450326,26963903,2209906071,705340,705340,255782204.78332818,2986420.4666665774,147672,0,116,0.2254685683500142,2294758689,-514161,-514161,1931469.0000051856,4912.633333421778,-761,0,-1,0.5926233768950184,-2267794786,1348.0229197941896,362.636749345462,985.3861704487276,0.7684473713117026,0.20936286046445685,-761
149,2017-05-30,2017,191638,191638,258378544.46666676,2990653.099999994,145727,0,101,0.809129713313644,26865573,2218371958,712575,712575,256448506.68332964,2985252.316666602,146515,0,101,0.22196681051117287,2298119985,-520937,-520937,1930037.7833371162,5400.7833333918825,-788,0,0,0.5871629028024712,-2271254412,1348.2636244725302,359.88984553672196,988.3737789358082,0.7604285162650414,0.20561344419885627,-788
150,2017-05-31,2017,194187,194187,259188425.95000014,3009897.5833333363,147946,0,83,0.8126548121140972,27323527,2228354968,725193,725193,257247866.8999964,3005236.216666483,148868,0,83,0.22198090715161364,2307511550,-531006,-531006,1940559.0500037372,4661.366666853428,-922,0,0,0.5906739049624835,-2280188023,1334.7362385226618,354.7302123710466,980.0060261516152,0.761873863852884,0.20528052532222457,-922
151,2017-06-01,2017,193551,193551,259660831.45,3009223.0666666655,147965,0,119,0.8220572355606534,27860490,2236354806,432595,432595,257735505.08333218,3004457.7666665846,149116,0,119,0.3757093817542977,2293691384,-239044,-239044,1925326.366667807,4765.300000080839,-1151,0,0,0.44634785380635567,-2265830894,1341.5628513931729,595.7893759366895,745.7734754564834,0.764475512913909,0.34470116390619404,-1151
152,2017-06-02,2017,195525,195525,260196552.3833333,3019115.533333336,149128,0,96,0.8183301368111486,28269484,2244539849,446470,446470,258287141.3499962,3014394.3499998646,150166,0,97,0.36572894035433784,2303257640,-250945,-250945,1909411.0333370864,4721.183333471417,-1038,0,-1,0.4526011964568108,-2274988156,1330.7584829731916,578.5095109413761,752.2489720318155,0.7627055363764225,0.3363406275897597,-1038
153,2017-06-03,2017,194846,194846,260505477.90000013,3027920.1000000024,149083,0,72,0.8232758178253602,28151568,2251703128,458682,458682,258593943.83332968,3023706.0499998955,150148,0,72,0.35778164392760226,2313328672,-263836,-263836,1911534.0666704476,4214.050000106916,-1065,0,0,0.46549417389775793,-2285177104,1336.981400182709,563.7760885173817,773.2053116653273,0.7651324635866273,0.3273466148660728,-1065
154,2017-06-04,2017,192810,192810,261156195.3000005,3007262.1166666714,148044,0,115,0.8244178206524552,27819681,2260724220,467957,467957,259256441.36666536,3002536.8166664653,149201,0,116,0.348230713505727,2325825186,-275147,-275147,1899753.9333351254,4725.300000206102,-1157,0,-1,0.4761871071467282,-2298005505,1354.4743286136636,554.0176583888377,800.4566702248259,0.7678232456822779,0.31883485021059627,-1157
155,2017-06-05,2017,193988,193988,261791308.96666682,3008680.216666663,148813,0,77,0.8201125842835639,27644081,2269405037,481469,481469,259895346.5333319,3004187.4666664954,149904,0,77,0.33722212645051,2338040487,-287481,-287481,1895962.4333349168,4492.750000167638,-1091,0,0,0.48289045783305395,-2310396406,1349.523212604217,539.7966359897146,809.7265766145024,0.7671247706043672,0.31134714799914426,-1091
156,2017-06-06,2017,191557,191557,261873846.23333332,2979206.600000003,146357,0,87,0.820439869072913,27408534,2273759081,491503,491503,259966335.2166661,2974582.1499998197,147308,0,87,0.3258291404121624,2344769793,-299946,-299946,1907511.016667217,4624.450000183191,-951,0,0,0.4946107286607506,-2317361259,1367.080535993638,528.9211565680497,838.1593794255883,0.7640389022588576,0.299709259149995,-951
157,2017-06-07,2017,193441,193441,262044490.5333331,2999482.3166666655,147105,0,82,0.815452773713949,27141827,2277728228,503607,503607,260145889.03332865,2995043.9166665203,148063,0,82,0.31923106708207105,2350593900,-310166,-310166,1898601.5000044405,4438.400000145193,-958,0,0,0.4962217066318779,-2323452073,1354.6481383643234,516.5652761644072,838.0828621999161,0.7604644310151416,0.2940050475867095,-958
158,2017-06-08,2017,195076,195076,262695701.4000004,3028396.383333341,148446,0,73,0.8121040004921157,27083240,2285002411,515868,515868,260764878.08332732,3023711.6999998908,149354,0,73,0.3122387897679179,2353560072,-320792,-320792,1930823.3166730702,4684.683333450463,-908,0,0,0.4998652107241978,-2326476832,1346.6326016526912,505.4876016409766,841.1450000117145,0.7609649572474317,0.28951979963866725,-908
159,2017-06-09,2017,198165,198165,263395574.13333338,3035788.116666661,150216,0,93,0.8104357479877871,27477808,2292721532,528734,528734,261475311.3499959,3031209.783333241,151205,0,93,0.3091157368355385,2359986694,-330569,-330569,1920262.7833374739,4578.333333420102,-989,0,0,0.5013200111522486,-2332508886,1329.1730332467055,494.53091980087515,834.6421134458303,0.7580349708576186,0.2859755567071533,-989
160,2017-06-10,2017,194787,194787,263700952.7833333,3002340.499999998,147059,0,88,0.806013748350763,27266400,2297863126,539882,539882,261798084.08333093,2997429.399999954,148085,0,88,0.2966796448112736,2368425236,-345095,-345095,1902868.7000023723,4911.100000044331,-1026,0,0,0.5093341035394894,-2341158836,1353.7913350651393,484.91723021573404,868.8741048494053,0.754973381180469,0.27429141923605527,-1026
161,2017-06-11,2017,193647,193647,264111496.7833333,2990452.5166666764,147273,0,73,0.8119000036148247,27025241,2302964017,550561,550561,262208298.81666404,2985663.98333323,148210,0,73,0.29062538029392604,2377662187,-356914,-356914,1903197.9666692615,4788.533333446365,-937,0,0,0.5212746233208987,-2350636946,1363.8811692581517,476.25657977347475,887.6245894846769,0.7605230135246092,0.26919814516465934,-937
162,2017-06-12,2017,191608,191608,264622554.86666667,2991082.7499999963,144999,0,92,0.8060884722976079,26669256,2310702494,561970,561970,262758751.23333204,2986161.983333263,146026,0,92,0.2805398864708037,2385686078,-370362,-370362,1863803.6333346367,4920.766666733194,-1027,0,0,0.5255485858268043,-2359016822,1381.0621418034043,467.56722108534626,913.494920718058,0.7567481524779759,0.2598466110290585,-1027
163,2017-06-13,2017,192257,192257,265094598.23333308,3013584.73333333,145023,0,123,0.8013440342874381,26472163,2316404541,570982,570982,263191351.8166641,3008808.3166665807,146084,0,123,0.2755673558886317,2389705887,-378725,-378725,1903246.4166689813,4776.416666749399,-1061,0,0,0.5257766783988064,-2363233724,1378.855377090733,460.94509427033444,917.9102828203986,0.7543184383403465,0.2558469443870385,-1061
164,2017-06-14,2017,197912,197912,265776911.66666642,3055358.166666668,149344,0,94,0.8006285621892548,27946429,2324256722,586421,586421,263880697.59999642,3050565.4999999264,150274,0,95,0.2753482566279226,2399156247,-388509,-388509,1896214.0666700006,4792.666666741483,-930,0,-1,0.5252803055613322,-2371209818,1342.904481116185,449.98507488646624,892.9194062297188,0.7545980031529165,0.25625617090793135,-930
165,2017-06-15,2017,199590,199590,266606731.49999985,3071729.6833333327,151149,0,125,0.8030963475124011,28132851,2333697148,598861,598861,264729583.89999625,3066559.566666549,152164,0,126,0.2726809727132023,2405742328,-399271,-399271,1877147.6000036001,5170.116666783579,-1015,0,-1,0.5304153747991989,-2377609477,1335.7719900796626,442.0551411763268,893.7168489033359,0.7572974597925748,0.2540890123083654,-1015
166,2017-06-16,2017,200564,200564,267253920.33333296,3057090.8666666676,150765,0,88,0.7979846831933941,28468101,2342626782,613279,613279,265367327.26666448,3052485.6833332013,151684,0,88,0.2652283870799467,2415424979,-412715,-412715,1886593.0666684806,4605.183333466295,-919,0,0,0.5327562961134473,-2386956878,1332.511918057742,432.7024523368067,899.8094657209352,0.7517051913603637,0.24733278002344772,-919
167,2017-06-17,2017,200395,200395,267648775.30000007,3049302.9833333297,149412,0,99,0.7925846453254817,27806051,2349695690,627720,627720,265737105.19999737,3044201.5499999067,150421,0,100,0.25761326706175114,2423757393,-427325,-427325,1911670.100002706,5101.433333422989,-1009,0,-1,0.5349713782637305,-2395951342,1335.6060545422793,423.3370056713142,912.269048870965,0.7455874647571047,0.23963072707576627,-1009
168,2017-06-18,2017,198965,198965,268021166.73333338,3021208.6500000013,148635,0,92,0.7926670519940684,27482389,2354965717,639889,639889,266130170.7833376,3016518.7666665865,149554,0,92,0.2508872632597199,2434092566,-440924,-440924,1890995.949995786,4689.883333414793,-919,0,0,0.5417797887343485,-2406610177,1347.0769569187212,415.90052459619966,931.1764323225216,0.7470409368481894,0.2337186605801944,-919
169,2017-06-19,2017,199453,199453,268689360.1500001,3050498.4333333327,149119,0,98,0.7918958351090226,27605436,2363754223,655876,655876,266746566.5166634,3045819.299999918,150051,0,98,0.24488622849441183,2443546693,-456423,-456423,1942793.633336693,4679.133333414793,-932,0,0,0.5470096066146108,-2415941257,1347.1312045945667,406.7027403299761,940.4284642645906,0.7476397948388843,0.22877952539809354,-932
170,2017-06-20,2017,193984,193984,268626884.28333306,2975371.033333336,142860,0,94,0.7746051220719227,22325306,2361361226,662314,662314,266718191.08333087,2970483.4166666204,143487,0,94,0.22920548259587364,2443742305,-468330,-468330,1908693.2000021935,4887.616666715592,-627,0,0,0.545399639476049,-2421416999,1384.7888706456877,402.7065577404839,982.0823129052037,0.7364524909270868,0.21664497504204955,-627
171,2017-06-21,2017,202288,202288,269037963.4833333,3083073.7999999984,151268,0,59,0.7934677291782022,27851317,2368167989,682436,682436,267068510.90000567,3078929.8999999324,152176,0,60,0.2391770070746554,2451142844,-480148,-480148,1969452.5833276212,4143.900000066031,-908,0,-1,0.5542907221035468,-2423291527,1329.9749045090825,391.34587111466226,938.6290333944203,0.7477853357589179,0.2229894085306168,-908
172,2017-06-22,2017,203207,203207,269842451.9500001,3083257.133333334,151399,0,34,0.7882848523918958,27680653,2377154331,694629,694629,267886849.8333298,3078383.2166665457,152202,0,34,0.23391911365635726,2454788753,-491422,-491422,1955602.1166703105,4873.916666788049,-803,0,0,0.5543657387355385,-2427108100,1327.919077344777,385.6545722008868,942.2645051438901,0.7450481528687496,0.21911264862250207,-803
173,2017-06-23,2017,201890,201890,270239077.53333366,3055286.199999998,151198,0,51,0.7933082371588482,27550194,2382673412,708207,708207,268291329.06666243,3050829.2999999356,152084,0,51,0.22972661947707237,2461014147,-506317,-506317,1947748.4666712284,4456.9000000623055,-886,0,0,0.5635816176817758,-2433463953,1338.546126768704,378.831795035438,959.7143317332659,0.7489127742830254,0.21474512395387224,-886
174,2017-06-24,2017,195865,195865,270082872.96666676,2998100.2833333365,146924,0,42,0.7946085313864139,27101029,2383897855,719447,719447,268147434.10000485,2993545.533333243,147808,0,42,0.21972014616781751,2467743525,-523582,-523582,1935438.8666619062,4554.750000093598,-884,0,0,0.5748883852185963,-2440642496,1378.923610480008,372.7132562926871,1006.2103541873208,0.7501289153243306,0.20544668335541047,-884
175,2017-06-25,2017,195483,195483,270300975.5000001,2988395.9166666674,146718,0,68,0.7976499235227602,27243822,2388781494,733221,733221,268345989.46666843,2983575.433333308,147657,0,68,0.21612174228506503,2477120897,-537738,-537738,1954986.0333316922,4820.483333359472,-939,0,0,0.5815281812376951,-2449877075,1382.7339231544438,365.9824111238882,1016.7515120305557,0.750540967756787,0.20138130249951924,-939
176,2017-06-26,2017,199435,199435,270943415.4166667,3025853.5000000023,148545,0,33,0.7869080151427789,26929029,2396734879,751273,751273,268990505.30000716,3021422.0499995975,149596,0,33,0.21258450656420144,2482985385,-551838,-551838,1952910.116659522,4431.450000404846,-1051,0,0,0.5743235085785774,-2456056356,1358.5549949440503,358.04628317536657,1000.5087117686837,0.744829142327074,0.19912335462608133,-1051
177,2017-06-27,2017,200890,200890,271348975.15000004,3058959.3666666667,150291,0,71,0.792239534073373,27584359,2402143098,762652,762652,269408492.6333307,3054526.4666666086,151302,0,71,0.2125137021865782,2485385443,-561762,-561762,1940482.516669333,4432.9000000581145,-1011,0,0,0.5797258318867948,-2457801084,1350.7341089651054,353.252194491499,997.4819144736064,0.7481258400119468,0.19838930468942584,-1011
178,2017-06-28,2017,200503,200503,271858491.39999986,3042653.9833333325,150049,0,60,0.7928160675900114,26837924,2408218447,774921,774921,269919412.2999954,3037967.2833333216,151093,0,61,0.2089361367158711,2491404385,-574418,-574418,1939079.1000044346,4686.7000000108965,-1044,0,-1,0.5838799308741404,-2464566461,1355.8824127319783,348.31861867209096,1007.5637940598874,0.7483628673885179,0.19497858491381703,-1044
179,2017-06-29,2017,200728,200728,272338059.6666666,3058556.599999998,150038,0,70,0.7965356103782231,27718469,2414125699,789148,789148,270415017.63333154,3053567.283333333,151065,0,70,0.20579536411420934,2498502213,-588420,-588420,1923042.0333350897,4989.316666665021,-1027,0,0,0.5907402462640137,-2470783744,1356.7517220650166,342.66705058282037,1014.0846714821962,0.7474692120680723,0.19142797041873008,-1027
180,2017-06-30,2017,196705,196705,272722617.43333334,2980004.0499999984,148052,0,74,0.7933301136219215,25300702,2418982231,798681,798681,270798171.5333301,2975720.9333333327,148717,0,66,0.19736665827783662,2504048990,-601976,-601976,1924445.9000032544,4283.116666665766,-665,0,8,0.5959634553440849,-2478748288,1386.4549321742372,339.0567342071867,1047.3981979670505,0.7526600747311964,0.18620325261274526,-665
181,2017-07-01,2017,201306,201306,272494828.6166668,3050910.9000000027,153210,0,97,0.8134531509244635,26779966,2419788523,468137,468137,270589601.850008,3047807.7333332226,153849,0,78,0.35343499872900186,2487846558,-266831,-266831,1905226.766658783,3103.166666780133,-639,0,19,0.4600181521954616,-2461066592,1353.6349071397117,578.0137050692597,775.621202070452,0.761080146642425,0.3286409747573894,-639
182,2017-07-02,2017,201751,201751,272824392.3000001,3032724.566666665,153141,0,105,0.80702450049814,26715789,2424890410,483561,483561,270908522.1833426,3028986.266666583,153698,0,101,0.3403707081422988,2494412826,-281810,-281810,1915870.1166574955,3738.300000082236,-557,0,4,0.4666537923558412,-2467697037,1352.2827262318406,560.2365000141504,792.0462262176902,0.7590594346496424,0.31784614557418817,-557
183,2017-07-03,2017,203968,203968,273472576.5999997,3036186.8666666686,153226,0,113,0.797208385629117,24980080,2431096061,502570,502570,271556274.3833418,3032959.433333217,153630,0,93,0.32615158087430673,2500799914,-298602,-298602,1916302.2166579366,3227.433333451394,-404,0,20,0.47105680475481027,-2475819834,1340.7621617116397,540.3352257065519,800.4269360050878,0.7512256824599938,0.30568875977475773,-404
184,2017-07-04,2017,206415,206415,274015676.5500003,3098506.3333333367,156311,0,112,0.8103916866506797,26842663,2436996840,520912,520912,272083515.73334086,3094891.599999926,156957,0,112,0.32529102804312493,2501925879,-314497,-314497,1932160.8166594505,3614.733333410695,-646,0,0,0.4851006586075548,-2475083216,1327.49885691447,522.3214587748811,805.177398139589,0.7572657025894436,0.30131192984611604,-646
185,2017-07-05,2017,210585,210585,274874205.5333334,3117981.4333333313,157637,0,150,0.8013296293658149,27069910,2445139740,539343,539343,272927305.35001206,3113936.16666657,158192,0,143,0.3160066970369571,2509112833,-328758,-328758,1946900.1833213568,4045.266666761134,-555,0,7,0.48532293232885776,-2482042923,1305.2886270785357,506.03661371337364,799.252013365162,0.7485670869245198,0.2933050025679391,-555
186,2017-07-06,2017,209410,209410,275601871.53333354,3113648.683333335,156046,0,192,0.7949524855546535,26371040,2451674466,556825,556825,273710782.0000093,3111062.7499999152,156799,0,193,0.30233556323799965,2516574169,-347415,-347415,1891089.5333242416,2585.933333419729,-753,0,-1,0.4926169223166538,-2490203129,1316.0874434522398,491.5562016791798,824.53124177306,0.7451697626665393,0.2815947559825798,-753
187,2017-07-07,2017,213326,213326,276106673.9333337,3095293.1666666637,157122,0,62,0.781925316182745,27007833,2456970158,578603,578603,274202157.30000937,3092483.516666571,157773,0,62,0.29104757493479444,2524483127,-365277,-365277,1904516.633324325,2809.6500000925735,-651,0,0,0.4908777412479505,-2497475294,1294.2945254368135,473.9037946571473,820.3907307796662,0.7365346933800849,0.27267919454271755,-651
188,2017-07-08,2017,207094,207094,276097556.3499999,3057498.416666667,154305,0,148,0.7984731571170574,26555020,2459321437,594861,594861,274152381.0500085,3053996.86666654,155065,0,148,0.2814085979749847,2530905339,-387767,-387767,1945175.2999914289,3501.5500001269393,-760,0,0,0.5170645591420726,-2504350319,1333.1992059161535,460.8679692398871,872.3312366762664,0.7450964296406463,0.2606743424094032,-760
189,2017-07-09,2017,207156,207156,276441143.26666653,3046471.399999998,155215,0,69,0.7985720905983893,26749126,2464227802,613409,613409,274308718.7166828,3045653.483333245,156261,0,69,0.2733543198746633,2536208065,-406253,-406253,2132424.54998374,817.9166667531244,-1046,0,0,0.525217770723726,-2509458939,1334.4587811440003,447.1873068648859,887.2714742791145,0.7492662534515051,0.2547419421625702,-1046
190,2017-07-10,2017,208529,208529,277074286.23333347,3061958.683333334,155623,0,95,0.7955536160438114,26048493,2470617178,632285,632285,274218501.6500106,3058646.5833332483,156201,0,90,0.26532339055964127,2536381877,-423756,-423756,2855784.5833228827,3312.100000085775,-578,0,5,0.5302302254841701,-2510333384,1328.7086507552115,433.69446001409267,895.0141907411188,0.7462894849157671,0.24704207754414545,-578
191,2017-07-11,2017,206921,206921,277548616.81666636,3084480.1666666577,155655,0,76,0.8027169789436553,25972612,2474787366,644884,644884,274698670.3166784,3083106.0999998897,156336,0,76,0.2609973266509934,2534649773,-437963,-437963,2849946.49998796,1374.0666667679325,-681,0,0,0.541719652292662,-2508677161,1341.3264812013588,425.9660191858976,915.3604620154612,0.7522436098800992,0.24242499426253403,-681
192,2017-07-12,2017,207763,207763,278249106.63333327,3108425.9666666635,156214,0,89,0.8013746432232879,26129971,2480964870,671190,671190,275378563.40001404,3115056.8166665593,161050,0,89,0.2571045456577112,2539737309,-463427,-463427,2870543.233319223,-6630.849999895785,-4836,0,0,0.5442700975655768,-2513607338,1339.2620756984318,410.284067700672,928.9780079977597,0.7518855619142966,0.23994695987723297,-4836
193,2017-07-13,2017,208712,208712,278959646.36666656,3105404.699999999,157274,0,219,0.8045248955498484,25989807,2486684692,692385,692385,270194575.7833396,3123941.1499997703,162520,0,219,0.2513731522202222,2486043060,-483673,-483673,8765070.583326936,-18536.449999771547,-5246,0,0,0.5531517433296262,-2460053253,1336.576940313286,390.23747739095967,946.3394629223264,0.7535455555981448,0.23472490016392614,-5246
194,2017-07-14,2017,205993,205993,279475975.5333332,3084077.566666663,157005,0,59,0.8141198972780621,25550993,2491990706,710865,710865,264328056.56666067,3113058.2499998696,164056,0,59,0.2472551046963948,2431954738,-504872,-504872,15147918.96667251,-28980.683333206456,-7051,0,0,0.5668647925816673,-2406403745,1356.7255952063088,371.8400210541533,984.8855741521554,0.7621860937022131,0.23078362276944286,-7051
195,2017-07-15,2017,207194,207194,279510224.16666675,3080135.3333333386,156165,0,73,0.8048109501240384,26302894,2493867016,719064,719064,258001199.96667233,3086970.8166663577,160095,0,73,0.23888694191337106,2376799970,-511870,-511870,21509024.199994415,-6835.483333019074,-3930,0,0,0.5659240082106674,-2350497076,1349.026632849729,358.80144182808806,990.2251910216409,0.7537139106344778,0.22264360335102298,-3930
196,2017-07-16,2017,203503,203503,279633489.0,3035279.016666669,153868,0,152,0.8078799821132857,25938328,2496486700,729151,729151,256282077.23332745,3038789.016666596,156205,0,153,0.23045157998823348,2366548098,-525648,-525648,23351411.76667255,-3509.999999926891,-2337,0,-1,0.5774284021250522,-2340609770,1374.1000820626723,351.48011486417414,1022.6199671984982,0.7560969617155521,0.21422860285455275,-2337
197,2017-07-17,2017,208970,208970,280165821.71666634,3080954.200000001,156507,0,207,0.8030817820739813,26411521,2504118227,751887,751887,256080078.45000833,3080739.966666247,158780,0,207,0.22823376385014896,2365864839,-542917,-542917,24085743.266658008,214.23333375388756,-2273,0,0,0.5748480182238324,-2339453318,1340.6987688025379,340.58319727566555,1000.1155715268724,0.7489448246159736,0.21117534948735647,-2273
198,2017-07-18,2017,210257,210257,280639472.3333335,3122261.1666666665,159503,0,124,0.8134283281888354,26784945,2509166461,763091,763091,256039368.04999748,3120773.9666666617,160233,0,124,0.2269716193743611,2361656697,-552834,-552834,24600104.283336014,1487.2000000048429,-730,0,0,0.5864567088144743,-2334871752,1334.7449660811935,335.5292724589826,999.2156936222109,0.7586097014605935,0.2099788884942949,-730
199,2017-07-19,2017,212377,212377,281513492.6666664,3166060.500000004,160601,0,111,0.8105632907518231,26647242,2517659951,802562,802561,257029455.61666968,3209436.7166663436,170873,0,111,0.2293280768339345,2366785693,-590185,-590184,24484037.049996704,-43376.21666633943,-10272,0,0,0.5812352139178886,-2340138451,1325.536629044889,320.2615821310401,1005.2750469138489,0.7562071222401673,0.21290940762209026,-10272
200,2017-07-20,2017,213473,213473,281949252.1499992,3145615.7500000033,159561,0,201,0.8017547886617977,26586971,2522134900,828409,828409,250367902.383339,3184963.316666327,170416,0,202,0.2214570339047422,2317725472,-614936,-614936,31581349.766660213,-39347.56666632369,-10855,0,-1,0.5802977547570556,-2291138501,1320.7724262553072,302.2274050418803,1018.5450212134269,0.7474528394691601,0.205714809954986,-10855
201,2017-07-21,2017,213585,213585,281628161.4333333,3145242.350000005,160071,0,321,0.8049628953344101,26846321,2521106673,837956,837956,243864105.050003,3160102.81666632,165943,0,321,0.21402078390751184,2267525150,-624371,-624371,37764056.383330286,-14860.466666314751,-5872,0,0,0.5909421114268982,-2240678829,1318.5764985056687,291.0225656836433,1027.5539328220254,0.7494486972399748,0.19803307094883263,-5872
202,2017-07-22,2017,213108,213108,281943519.8000001,3141831.750000002,159251,0,77,0.8004532912889235,26799890,2524165304,855076,855075,241116706.86667368,3161072.7666663122,166045,0,77,0.20940828651488766,2248725978,-641968,-641967,40826812.93332639,-19241.016666310374,-6794,0,0,0.5910450047740359,-2221926088,1323.007675920191,281.98310892807496,1041.0245669921162,0.7472783752838936,0.19418741725881675,-6794
203,2017-07-23,2017,206554,206554,281935974.03333354,3090459.2666666647,157002,0,82,0.813433775187118,25712773,2525445435,868085,868085,238626019.50000173,3117697.8166662813,162708,0,82,0.2016645835373219,2228342016,-661531,-661531,43309954.53333181,-27238.549999616574,-5706,0,0,0.6117691916497962,-2202629243,1364.950444113082,274.88785026812087,1090.0625938449612,0.7601014746749034,0.1874332582638797,-5706
204,2017-07-24,2017,209656,209656,282524700.8166662,3138025.16666667,159047,0,79,0.8125071545770213,26559815,2532753299,895208,895208,237980683.2999978,3170628.266666631,167581,0,80,0.20169167389031264,2227361288,-685552,-685552,44544017.51666838,-32603.099999961443,-8534,0,-1,0.6108154806867087,-2200801473,1347.5631549617763,265.8384233608254,1081.724731600951,0.7586093410157592,0.18719783558681335,-8534
205,2017-07-25,2017,211153,211153,282977818.4333333,3141341.966666664,159131,0,83,0.8075281904590509,26290276,2538227093,912886,912886,236413831.8999962,3196954.2166666584,166710,0,83,0.19688657729442652,2213565213,-701733,-701733,46563986.53333709,-55612.24999999441,-7579,0,0,0.6106416131646244,-2187274937,1340.1553301792221,258.9741018046023,1081.1812283746199,0.7536288852159335,0.18261864022451874,-7579
206,2017-07-26,2017,220346,220346,283874604.6000003,3177436.2833333304,162201,0,147,0.7901164532144893,26578140,2545693432,930818,930818,235571579.2166618,3204981.6666666446,166564,0,149,0.19336003386269376,2205319164,-710472,-710472,48303025.38333851,-27545.38333331421,-4363,0,-2,0.5967564193517956,-2178741024,1288.3129469107691,253.08017165188232,1035.2327752588867,0.7361195574233251,0.17894368179386302,-4363
207,2017-07-27,2017,226494,226494,284721517.6333332,3194933.7666666666,163729,0,78,0.7791288069441136,27369883,2553491317,950450,950450,235467721.29999733,3194329.0666666348,165341,0,78,0.1889210374033399,2204107297,-723956,-723956,49253796.33333588,604.7000000318512,-1612,0,0,0.5902077695407737,-2176737414,1257.0819431566981,247.74340712293895,1009.3385360337592,0.7228844914214063,0.17396075543163764,-1612
208,2017-07-28,2017,225561,225561,285315161.4333339,3163493.3333333316,162795,0,111,0.7762822473743243,27317295,2560003326,975285,975285,236054971.74999565,3164305.0833332897,165729,0,111,0.18404261318486323,2212250227,-749724,-749724,49260189.683338225,-811.7499999580905,-2934,0,0,0.592239634189461,-2184932932,1264.9135330723568,242.03691408152042,1022.8766189908364,0.7217338103661537,0.16992879004598654,-2934
209,2017-07-29,2017,223835,223835,285369154.08333313,3153084.7,159574,0,147,0.7669533361627994,27706916,2564086999,994998,994998,235640998.96666414,3148621.8666666234,160150,0,147,0.17472195924011832,2216495557,-771163,-771163,49728155.116669,4462.833333376795,-576,0,0,0.592231376922681,-2188788641,1274.908544612474,236.82560062097022,1038.082943991504,0.7129090624790583,0.1609550973971807,-576
210,2017-07-30,2017,221820,221820,285670081.64999974,3118482.316666663,157994,0,235,0.763456856911009,27461741,2569025841,1016653,1016653,236253290.29999962,3117271.016666632,158941,0,235,0.1687980067928775,2228179452,-794833,-794833,49416791.35000011,1211.300000031013,-947,0,0,0.5946588501181315,-2200717711,1287.8463693535286,232.3834093835356,1055.462959969993,0.7122621945721757,0.1563375114222847,-947
211,2017-07-31,2017,223718,223718,286107538.6333338,3149215.5833333354,160716,0,158,0.7692943795313738,27496271,2575280927,1048055,1048055,236708840.51666635,3147762.8666666485,163139,0,158,0.16752842169542456,2236693090,-824337,-824337,49398698.11666745,1452.7166666868143,-2423,0,0,0.6017659578359492,-2209196819,1278.8758107677245,225.85536113721736,1053.020449630507,0.7183865401979278,0.1556588156155927,-2423
212,2017-08-01,2017,234944,234944,286397392.9500001,3233584.3999999966,168626,0,150,0.773763109506947,28018367,2579505395,569381,569381,236400133.4166626,3229084.916666434,169188,0,150,0.3222095573965378,2210584209,-334437,-334437,49997259.5333375,4499.483333562501,-562,0,0,0.45155355211040926,-2182565842,1219.0027961982435,415.1879557214986,803.8148404767448,0.7177284799782075,0.2971437403074567,-562
213,2017-08-02,2017,233281,233281,286729452.99999976,3249621.633333335,167556,0,142,0.7725489859868564,27824618,2583289538,591086,591086,237100911.6499949,3245175.0833331617,168074,0,142,0.3075170110609931,2218789034,-357805,-357805,49628541.35000485,4446.550000173505,-518,0,0,0.4650319749258633,-2190964416,1229.1161860588722,401.1276052046486,827.9885808542236,0.7182582379190762,0.28434779372206415,-518
214,2017-08-03,2017,232844,232844,287148542.58333343,3258153.3166666697,167182,0,136,0.7789764821081927,28013149,2587929646,616625,616625,237892492.2833308,3254215.599999713,167652,0,137,0.2974692884654347,2227017143,-383781,-383781,49256050.300002635,3937.716666956898,-470,0,-1,0.481507193642758,-2199003994,1233.222855574262,385.79767651867957,847.4251790555825,0.7180000343577674,0.2718864788161362,-470
215,2017-08-04,2017,234858,234858,287848289.1,3281689.7833333337,169718,0,138,0.7841759701606931,28316406,2594384918,643241,643241,238868464.33332688,3277230.2499997346,170319,0,138,0.29004525519983665,2235618795,-408383,-408383,48979824.76667315,4459.533333599102,-601,0,0,0.4941307149608564,-2207302389,1225.6269281863936,371.35142867654093,854.2754995098526,0.7226409149358336,0.26478256205683404,-601
216,2017-08-05,2017,236915,236915,288177093.2166664,3282085.383333335,168498,0,163,0.7684570415549868,28434689,2599323713,669204,669204,239525363.63333,3277409.5166664636,169080,0,163,0.27540630360846297,2246023103,-432289,-432289,48651729.58333641,4675.866666871589,-582,0,0,0.4930507379465239,-2217588414,1216.3733542269017,357.9257799315754,858.4475742953264,0.7112171031804656,0.25265838219735687,-582
217,2017-08-06,2017,237348,237348,288458875.5,3261798.466666671,168454,0,199,0.7686645769081684,28593280,2603979403,696467,696467,240081677.6499956,3257252.283333226,169111,0,199,0.26521141705206147,2257721735,-459119,-459119,48377197.850004405,4546.183333444875,-657,0,0,0.503453159856107,-2229128455,1215.341504878912,344.7136442214715,870.6278606574406,0.7097342299071405,0.24281265300437782,-657
218,2017-08-07,2017,237054,237054,289210898.3833333,3286086.3833333305,169681,0,133,0.7720772482219236,28274219,2612879457,723733,723733,241072302.1666612,3281594.249999944,170248,0,133,0.2563749338499184,2265375244,-486679,-486679,48138596.21667212,4492.133333386388,-567,0,0,0.5157023143720052,-2237101025,1220.0211697897244,333.0956335646726,886.9255362250517,0.7157904949927021,0.2352359226399791,-567
219,2017-08-08,2017,235279,235279,289676463.8166665,3253996.133333338,167849,0,198,0.7716923312322818,28388651,2618922622,745724,745724,241843579.71666113,3249425.633333267,168571,0,198,0.2472912230262121,2273158435,-510445,-510445,47832884.10000536,4570.5000000707805,-722,0,0,0.5244011082060697,-2244769784,1231.2040760827208,324.30708910623923,906.8969869764816,0.7134040862125391,0.22605012041988726,-722
220,2017-08-09,2017,233448,233448,289956831.5499994,3232193.2333333357,166132,0,179,0.7701543812754877,28170065,2623279315,771365,771365,242442016.96666327,3227767.93333326,166747,0,179,0.23670117259662668,2283693239,-537917,-537917,47514814.583336145,4425.3000000757165,-615,0,0,0.533453208678861,-2255523174,1242.0617505825683,314.3025895220334,927.7591610605349,0.7116445632432062,0.216171332637597,-615
221,2017-08-10,2017,233941,233941,290529325.4333331,3265960.4500000025,169256,0,176,0.7848132648830269,28715893,2630114442,797436,797436,243260775.91666365,3261621.1833333196,169887,0,172,0.23371781559899213,2292476226,-563495,-563495,47268549.51666945,4339.266666682903,-631,0,4,0.5510954492840348,-2263760333,1241.8914402919245,305.0536668982384,936.8377733936861,0.7234986599185265,0.21304154816185875,-631
222,2017-08-11,2017,236871,236871,291100496.88333344,3270504.383333332,170621,0,221,0.7804585618332343,29530754,2638359334,821425,821425,244087846.84999642,3265496.9999999856,171272,0,221,0.22813160057217466,2303773777,-584554,-584554,47012650.03333703,5007.383333346341,-651,0,0,0.5523269612610596,-2274243023,1228.9410560319054,297.1517142161444,931.789341815761,0.7203118997260112,0.2085059500258697,-651
223,2017-08-12,2017,233354,233354,291178441.4666668,3216329.883333334,165560,0,233,0.7682276712634026,29515873,2642730516,844269,844269,244501609.03332877,3211779.766666649,166228,0,230,0.2150144089146934,2315225525,-610915,-610915,46676832.433338046,4550.1166666848585,-668,0,3,0.5532132623487093,-2285709652,1247.797087115142,289.60154765048674,958.1955394646552,0.7094800174841657,0.1968898538262094,-668
224,2017-08-13,2017,231519,231519,291552295.8500002,3185590.366666665,165399,0,224,0.7713017074192615,29735114,2649902500,868665,868665,245097559.6166619,3181224.7499999898,165956,0,224,0.20852112149102245,2328157270,-637146,-637146,46454736.2333383,4365.61666667508,-557,0,0,0.5627805859282391,-2298422156,1259.3018104345656,282.15429379180915,977.1475166427565,0.7144078887693882,0.19104718159474596,-557
225,2017-08-14,2017,229172,229172,292088311.30000013,3190216.1166666676,163266,0,162,0.7675981358979275,28575738,2658165674,891343,891343,245840689.28332806,3186027.166666607,163826,0,163,0.20008459145357027,2339416073,-662171,-662171,46247622.016672075,4188.950000060722,-560,0,-1,0.5675135444443572,-2310840335,1274.5375146178421,275.80930044138796,998.7282141764542,0.712416874661826,0.1837968099822403,-560
226,2017-08-15,2017,232886,232886,292382099.35,3234604.533333332,166696,0,134,0.7812964282953891,29268348,2662980402,912197,912197,246467171.08332875,3230703.6499999603,167436,0,134,0.20296931474232263,2345914077,-679311,-679311,45914928.26667127,3900.8833333714865,-740,0,0,0.5783271135530665,-2316645729,1255.4730612832032,270.1907275329,985.2823337503032,0.715783688156437,0.18355245632248296,-740
227,2017-08-16,2017,242621,242621,292955929.39999986,3361690.9833333334,175444,0,124,0.7941563178785018,30125083,2670110726,940783,940783,247305752.2833278,3356794.483333278,176171,0,125,0.20791298312150347,2353674536,-698162,-698162,45650177.11667207,4896.500000055414,-727,0,-1,0.5862433347569984,-2323549453,1207.4632014541191,262.87225883474485,944.5909426193743,0.7231195980562276,0.1872599738728272,-727
228,2017-08-17,2017,241002,241002,293598421.9166665,3351647.2999999984,173233,0,311,0.7853793744450259,29972637,2678087591,960573,960573,248218672.949997,3347161.5999999694,174023,0,313,0.20040434199170265,2362709912,-719571,-719571,45379748.9666695,4485.700000029057,-790,0,-2,0.5849750324533233,-2332737275,1218.2406034666371,258.40688104912067,959.8337224175165,0.7188031634592245,0.18116582498154749,-790
229,2017-08-18,2017,241237,241237,294205437.8499999,3363666.2666666615,173918,0,368,0.7874745582145367,29992225,2684533835,984393,984393,249118563.11666185,3359584.9499999746,174711,0,368,0.19609444601901999,2373100029,-743156,-743156,45086874.73333806,4081.3166666869074,-793,0,0,0.5913801121955167,-2343107804,1219.57012336416,253.06819849050314,966.5019248736569,0.7209424756567193,0.17748094511033702,-793
230,2017-08-19,2017,233095,233095,294349639.86666673,3216283.916666668,170497,0,299,0.7962161350522325,28341072,2687849290,1000005,1000005,249415247.73333204,3214394.2833333523,171221,0,301,0.18834905825470794,2381049516,-766910,-766910,44934392.1333347,1889.6333333156072,-724,0,-2,0.6078670767975246,-2352708444,1262.7883046254392,249.41400066332872,1013.3743039621105,0.7314485510199704,0.1712201438992805,-724
231,2017-08-20,2017,234903,234903,294661531.9666666,3307142.500000005,172229,0,311,0.8024674014380401,29592146,2691363530,1024590,1024590,250001204.3166638,3302036.916666615,173004,0,311,0.187346157975382,2393849392,-789687,-789687,44660327.65000278,5105.583333390299,-775,0,0,0.6151212434626581,-2364257246,1254.3966316593087,244.00121445325817,1010.3954172060505,0.7331919983993394,0.16885193101630896,-775
232,2017-08-21,2017,238981,238981,295369178.6000002,3319494.716666666,174138,0,293,0.7964315154761267,29378341,2701056170,1047238,1047238,250860817.01666293,3313870.183333258,175024,0,294,0.1849331288589576,2403094413,-808257,-808257,44508361.58333728,5624.533333407715,-886,0,-1,0.611498386617169,-2373716072,1235.9525594084894,239.54518172245747,996.4073776860319,0.7286688063067776,0.16712915306740206,-886
233,2017-08-22,2017,235050,235050,295402161.36666703,3263236.2499999995,172735,0,289,0.8069134226760253,29077024,2705544516,1064789,1064789,251150003.64999825,3258627.0333332685,173446,0,289,0.18087151538943508,2408175986,-829739,-829739,44252157.716668785,4609.216666731052,-711,0,0,0.6260419072865901,-2379098962,1256.7630775012424,235.8683303922169,1020.8947471090255,0.7348861944267178,0.1628923664688497,-711
234,2017-08-23,2017,222722,222722,295314176.35000026,3253951.3833333324,171236,0,295,0.8400472337712478,29230091,2709617864,1079141,1079141,251290742.63333118,3248687.08333333,171916,0,298,0.17590194423156896,2417139969,-856419,-856419,44023433.71666908,5264.300000002142,-680,0,-3,0.6641452895396789,-2387909878,1325.9317730174848,232.86182494533261,1093.0699480721523,0.7688328948195509,0.1593081904959593,-680
235,2017-08-24,2017,234114,234114,295754110.13333327,3374405.6166666695,177966,0,243,0.8320348206429347,30068077,2715314880,1100701,1100701,251919036.09999794,3369671.5666666804,178753,0,243,0.17991080229781256,2423499905,-866587,-866587,43835074.03333533,4734.0499999891035,-787,0,0,0.6521240183451221,-2393431828,1263.2910040977185,228.87145201103473,1034.4195520866838,0.76016812322202,0.1623992346695424,-787
236,2017-08-25,2017,231500,231500,296236957.4666666,3351911.2500000005,175521,0,157,0.8284276457883363,26441713,2718651972,1110717,1110717,252632360.11666626,3347904.8,176147,0,157,0.17530027900896325,2425986832,-879217,-879217,43604597.35000032,4006.450000000652,-626,0,0,0.653127366779373,-2399545119,1279.6412849532035,227.44980054925446,1052.191484403949,0.7581900647948164,0.1585885513591671,-626
237,2017-08-26,2017,231209,231209,296196593.9833333,3341431.666666665,175821,0,158,0.8388903546142236,30099802,2721780420,1140298,1140298,252841338.70000136,3344213.5999992755,182223,0,158,0.17874713452097554,2435984491,-909089,-909089,43355255.28333193,-2781.9333326104097,-6402,0,0,0.660143220093248,-2405884689,1281.0772676813328,221.73268628025426,1059.3445814010786,0.7604418513120164,0.15980296378665929,-6402
238,2017-08-27,2017,227817,227817,296496840.2666664,3270818.3500000034,172779,0,159,0.8320976924461295,29537121,2726886648,1148447,1148447,248974454.08333376,3266877.3499992983,174429,0,159,0.16861378888184952,2401234210,-920630,-920630,47522386.18333265,3941.000000705011,-1650,0,0,0.66348390356428,-2371697089,1301.4693384017278,216.79228913770837,1084.6770492640194,0.7584113564834933,0.15188249871348003,-1650
239,2017-08-28,2017,231120,231120,297025904.81666696,3328402.049999999,174204,0,160,0.8246884735202493,28651764,2732876975,1164319,1164319,248938908.8499987,3323440.8333333544,175044,0,163,0.1667120436924923,2400885391,-933199,-933199,48086995.96666825,4961.216666644439,-840,0,-3,0.6579764298277571,-2372233627,1285.1588128100855,213.80644724512672,1071.3523655649587,0.7537383177570094,0.15034024180658392,-840
240,2017-08-29,2017,224878,224878,297013652.1666667,3272502.933333333,168564,0,75,0.8118846663524221,26557748,2732737058,1172214,1172214,249129480.53333354,3268156.2499994724,169284,0,66,0.15819807646044326,2403689942,-947336,-947336,47884171.63333315,4346.68333386071,-720,0,9,0.6536865898919788,-2377132194,1320.7768308445766,212.52900966319592,1108.2478211813807,0.7495797721431176,0.14441390394586653,-720
241,2017-08-30,2017,223503,223503,297156608.14999944,3276832.633333332,169931,0,74,0.8235146731811203,26800364,2733867683,1188485,1188485,249555940.06666592,3272295.183333339,170770,0,66,0.15758381468844918,2409595358,-964982,-964982,47600668.08333352,4537.449999992736,-839,0,8,0.6659308584926711,-2382794994,1329.5419218086533,209.97819919196786,1119.5637226166855,0.7603074679087082,0.1436871310954703,-839
242,2017-08-31,2017,225826,225826,297403489.3999999,3280678.4833333353,172292,0,75,0.8287973926828612,26961820,2736440085,1204769,1204769,250057861.20000172,3276643.9166664947,173150,0,58,0.15804523522766994,2411587791,-978943,-978943,47345628.1999982,4034.5666668405756,-858,0,17,0.6707521574551913,-2384625971,1316.9585849282187,207.5566861365139,1109.4018987917048,0.7629413796462763,0.14372049745635884,-858
243,2017-09-01,2017,228146,228146,297368547.91666687,3320961.616666666,175002,0,141,0.8397079063406767,26925273,2736305809,571030,571030,250330619.48332906,3317582.7833332475,176022,0,141,0.3416352906152082,2393459866,-342884,-342884,47037928.43333781,3378.8333334187046,-1020,0,0,0.4980726157254685,-2366534593,1303.4133752801577,438.38435718496237,865.0290180951953,0.7670614431109903,0.30825350682100766,-1020
244,2017-09-02,2017,226053,226053,297590441.05,3337760.466666673,172143,0,155,0.8339106315775517,27125317,2738264527,586487,586487,250829259.69999582,3334035.3999998625,173033,0,155,0.32816072649521527,2397206119,-360434,-360434,46761181.350004196,3725.0666668103077,-890,0,0,0.5057499050823364,-2370080802,1316.463134972772,427.6808517494775,888.7822832232945,0.76151610463033,0.2950329674826552,-890
245,2017-09-03,2017,224681,224681,298033282.16666645,3288734.666666665,171034,0,166,0.8346989732109076,26903169,2742266503,603144,603144,251542802.04999608,3284089.0499998583,171960,0,105,0.31796552730358657,2406463111,-378463,-378463,46490480.11667037,4645.616666806862,-926,0,61,0.516733445907321,-2379559942,1326.4730091403655,417.05264754353203,909.4203615968336,0.7612303666086585,0.28510604432772274,-926
246,2017-09-04,2017,231913,231913,298659963.8833332,3366213.0499999993,175885,0,163,0.8305700844713315,27557142,2748893881,628348,628348,252403843.43332735,3361221.5499999356,176682,0,163,0.31211526097003356,2415193262,-396435,-396435,46256120.45000586,4991.500000063796,-797,0,0,0.518454823501298,-2387636120,1287.8103594163897,401.69435318219735,886.1160062341924,0.7584094035263224,0.28118494846804637,-797
247,2017-09-05,2017,234606,234606,299375587.8333331,3398526.9166666646,176803,0,154,0.8253113731106619,27666319,2754169399,643146,643146,253354963.53333047,3393546.1499998756,177720,0,156,0.3077559372210996,2418701513,-408540,-408540,46020624.300002605,4980.7666667890735,-917,0,-2,0.5175554358895623,-2391035194,1276.0781388086114,393.93071485064115,882.1474239579702,0.753616702045131,0.2763291694265377,-917
248,2017-09-06,2017,233671,233671,299647993.5166668,3416252.6333333324,177261,0,158,0.8412939560322003,27684273,2756170123,657490,657490,253976215.2166634,3411182.9166665636,178351,0,159,0.3075073385146541,2426359794,-423819,-423819,45671778.30000344,5069.716666768771,-1090,0,-1,0.5337866175175461,-2398675521,1282.349942939718,386.28148750043863,896.0684554392793,0.7585922087036903,0.27126039939770946,-1090
249,2017-09-07,2017,236402,236402,300020215.63333356,3411392.150000006,179750,0,138,0.8411054051996179,29540582,2760558541,676587,676586,254646737.8833295,3405796.649999861,180708,0,138,0.2997944092925225,2436054859,-440185,-440184,45373477.75000405,5595.500000144821,-958,0,0,0.5413109959070954,-2406514277,1269.110310544469,376.3700961641676,892.7402143803015,0.7603573573827632,0.2670876029246793,-958
250,2017-09-08,2017,239149,239149,300444306.8499999,3416881.8166666664,178878,0,143,0.8194431086895618,30759559,2767486227,697991,697991,255382314.16667318,3413690.7499996885,179844,0,143,0.28515124120510305,2446362968,-458842,-458842,45061992.68332672,3191.0666669779457,-966,0,0,0.5342918674844588,-2415603409,1256.3059299850718,365.88195860214984,890.423971382922,0.7479772024971879,0.2576594827153932,-966
251,2017-09-09,2017,234741,234741,300628037.28333354,3399106.383333332,176807,0,170,0.8265577807029874,30317059,2772593502,713058,713058,255720892.08333606,3394052.0666663027,177652,0,172,0.2764136998673331,2455894206,-478317,-478317,44907145.199997485,5054.3166670291685,-845,0,-2,0.5501440808356542,-2425577147,1280.6797162972532,358.625654691955,922.0540616052982,0.7532003356891211,0.24914102359134882,-845
252,2017-09-10,2017,229461,229461,300954995.56666636,3307494.7833333313,172971,0,177,0.8306378861767363,29773453,2778330855,725088,725088,256304939.6166679,3302754.1499995934,173700,0,178,0.26645041705282546,2467736713,-495627,-495627,44650055.94999847,4740.633333737962,-729,0,-1,0.5641874691239108,-2437963260,1311.5736250023592,353.4811493455524,958.0924756568068,0.753814373684417,0.23955712961737058,-729
253,2017-09-11,2017,232078,232078,300652347.91666675,3335641.8499999973,175485,0,230,0.8331897034617665,29692753,2780125126,748912,748912,256259116.74999365,3330968.8166666585,176258,0,230,0.2624286965624759,2479853833,-516834,-516834,44393231.166673094,4673.033333338797,-773,0,0,0.5707610068992905,-2450161080,1295.4797435201388,342.175204496648,953.3045390234907,0.7561466403536742,0.23535208408998654,-773
254,2017-09-12,2017,238027,238027,301081245.2666666,3407644.800000001,181922,0,265,0.8420011175202801,30187110,2787086422,764695,764695,256863631.26666138,3402374.933333317,182749,0,265,0.2662839432715014,2481349413,-526668,-526668,44217614.000005215,5269.866666684393,-827,0,0,0.5757171742487787,-2451162303,1264.9037515351897,335.9033748967384,929.0003766384514,0.764291445928403,0.23898286244842715,-827
255,2017-09-13,2017,235474,235474,301337827.65000045,3421570.4166666665,179413,0,183,0.8393538140091916,30798420,2793598354,775925,775925,257316654.13332778,3416327.983333311,180066,0,183,0.2585958694461473,2488231112,-540451,-540451,44021173.51667267,5242.433333355468,-653,0,0,0.5807579445630443,-2457432692,1279.7074311813637,331.625677911303,948.0817532700607,0.7619227600499419,0.2320662435158037,-653
256,2017-09-14,2017,232920,232920,301601258.69999987,3405494.266666666,176439,0,180,0.8315988322170705,29678202,2798614988,793093,793093,257800202.26666045,3400925.499999992,177080,0,180,0.24778809042570915,2498713964,-560173,-560173,43801056.43333942,4568.766666674055,-641,0,0,0.5838107417913614,-2469035762,1294.8705937660993,325.0567112137674,969.813882552332,0.757509015971149,0.22327772405001683,-641
257,2017-09-15,2017,237624,237624,301993583.45,3441857.6666666665,178500,0,429,0.8265831734168264,30609626,2803868894,811933,811933,258489217.73333764,3436500.733332811,179353,0,429,0.24681100534157702,2506636630,-574309,-574309,43504365.71666235,5356.933333855588,-853,0,0,0.5797721680752494,-2476027004,1270.888392797024,318.3627438881504,952.5256489088736,0.7511867488132512,0.22089630548333422,-853
258,2017-09-16,2017,248798,248798,302368261.8500002,3509700.733333332,189406,0,140,0.8386281240202891,30793470,2809765976,838361,838361,259019658.9166625,3504483.1666666577,190090,0,143,0.2524270570792227,2517387160,-589563,-589563,43348602.93333769,5217.566666674335,-684,0,-3,0.5862010669410664,-2486593690,1215.3162881132494,308.95957578735477,906.3567123258946,0.7612842546965811,0.2267400320387041,-684
259,2017-09-17,2017,243766,243766,302791306.2500001,3435653.816666663,183886,0,148,0.8315023424103444,29793898,2815277449,848300,848300,259625062.16667274,3430704.4499996407,184747,0,148,0.2433360839325735,2526790242,-604534,-604534,43166244.08332738,4949.366667022463,-861,0,0,0.5881662584777709,-2496996344,1242.1392082981224,306.0533563204913,936.0858519776311,0.7543545859553834,0.2177849817281622,-861
260,2017-09-18,2017,243308,243308,303627938.3999997,3458472.6333333384,180242,0,142,0.8099815871241389,29687875,2824078065,865151,865151,260638581.89999485,3452819.983333306,181139,0,142,0.23173873693724958,2535561394,-621843,-621843,42989356.50000483,5652.650000032503,-897,0,0,0.5782428501868894,-2505873519,1247.9159682377879,301.263689113224,946.6522791245638,0.740797672086409,0.20937269910108178,-897
261,2017-09-19,2017,244627,244627,304185287.2666666,3475946.200000004,181547,0,118,0.8139207855224474,29548736,2829877210,879822,879822,261449659.68332547,3470211.633333301,182394,0,118,0.22995105828224072,2541966446,-635195,-635195,42735627.58334112,5734.56666670274,-847,0,0,0.5839697272402067,-2512417710,1243.4657141961704,297.16199377070075,946.3037204254697,0.7421380305526373,0.2073078418134577,-847
262,2017-09-20,2017,205880,205880,294588380.5000002,2885416.6833333313,112186,0,77,0.5837138138721579,25181267,2789978437,877792,877792,252059831.3833349,2882430.5333329663,113444,0,56,0.13956837155043278,2543348427,-671912,-671912,42528549.116665274,2986.1500003649853,-1258,0,21,0.44414544232172515,-2518167160,1430.8742009908694,287.15211733911326,1143.7220836517563,0.5449096561103556,0.1292379060187379,-1258
263,2017-09-21,2017,233045,233045,294751454.55,3366841.5166666643,177251,0,112,0.8296809629041599,28651760,2791327653,919783,919783,252118825.73332906,3362197.3833332933,178146,0,110,0.21337641595897888,2546570674,-686738,-686738,42632628.816670954,4644.133333371021,-895,0,2,0.6163045469451811,-2517918914,1264.783430453346,274.10685534884755,990.6765751044984,0.7605870110922783,0.19368264036191146,-895
264,2017-09-22,2017,236998,236998,294778758.08333325,3377657.3999999943,179529,0,81,0.8253951510139331,28730453,2791212414,926420,926420,252482050.31666094,3372629.5333333453,180399,0,75,0.21429912998424586,2510980747,-689422,-689422,42296707.76667231,5027.866666649003,-870,0,6,0.6110960210296873,-2482250294,1243.802724425241,272.535189564842,971.2675348603989,0.7575127216263429,0.1947270136655081,-870
265,2017-09-23,2017,238385,238385,295005917.58333355,3416219.733333333,179931,0,78,0.8234746313736174,28937718,2793455128,937509,937509,253073743.71666348,3410818.1833333,180781,0,71,0.2120075647273846,2514721135,-699124,-699124,41932173.86667007,5401.550000032876,-850,0,7,0.6114670666462328,-2485783417,1237.5187934783378,269.94273518085,967.5760582974879,0.7547916186001636,0.192831215486998,-850
266,2017-09-24,2017,239842,239842,295373397.06666666,3405957.633333333,181610,0,123,0.8260855062916419,29651447,2797712401,954448,954448,253717355.21666348,3401243.7333333096,182553,0,122,0.210727038036645,2524270850,-714606,-714606,41656041.85000318,4713.90000002319,-943,0,1,0.6153584682549968,-2494619403,1231.5332471654951,265.82627363320313,965.7069735322921,0.7572068278283203,0.19126552729954907,-943
267,2017-09-25,2017,237887,237887,295977040.48333347,3443856.549999997,179847,0,79,0.8258711068700679,29650537,2804806556,969225,969225,254531223.29999602,3438731.766666621,180670,0,54,0.2056199540870274,2534037052,-731338,-731338,41445817.18333745,5124.78333337605,-823,0,25,0.6202511527830405,-2504386515,1244.1917401259147,262.61314276870286,981.578597357212,0.7560186138796992,0.18640666511903842,-823
268,2017-09-26,2017,237261,237261,296234725.5833335,3413252.16666667,178520,0,84,0.8201263587357375,29035889,2808272021,981639,981639,255068512.8999948,3407959.3333333153,179307,0,42,0.20163828046766621,2538477721,-744378,-744378,41166212.6833387,5292.833333354443,-787,0,42,0.6184880782680713,-2509441832,1248.5605539188214,259.8394245746092,988.7211293442122,0.7524203303534925,0.18266083560249746,-787
269,2017-09-27,2017,237146,237146,296260066.7333328,3381981.8500000047,177152,0,99,0.8132500653605803,29812998,2811168127,999638,999638,255318654.09999478,3376944.333333333,177978,0,49,0.19575386289836932,2547816131,-762492,-762492,40941412.633338034,5037.516666671727,-826,0,50,0.617496202462211,-2518003133,1249.2728814035777,255.41111292287286,993.8617684807048,0.7470166058040195,0.178042451367395,-826
270,2017-09-28,2017,231459,231459,296246403.91666687,3316308.199999998,174013,0,69,0.8167623639607888,29538475,2814626836,1011775,1011775,255607158.0333316,3311365.36666656,174856,0,37,0.18916063354006218,2552994246,-780316,-780316,40639245.88333526,4942.833333437797,-843,0,32,0.6276017304207266,-2523455771,1279.9087696597103,252.6324113892235,1027.2763582704868,0.7518091757071447,0.17282103234414767,-843
271,2017-09-29,2017,231275,231275,296152812.6000001,3311339.1333333366,173939,0,67,0.8194703275321594,29493748,2817474410,1028044,1028044,255760046.21666622,3306582.1666665864,174648,0,50,0.1867410344304272,2559501591,-796769,-796769,40392766.38333386,4756.966666750144,-709,0,17,0.6327292931017322,-2530007843,1280.5223763917418,248.78317096998398,1031.7392054217578,0.7520873419089829,0.16988377929349327,-709
272,2017-09-30,2017,234043,234043,296606728.9000001,3335100.383333334,175049,0,74,0.8165935319578023,29191267,2823678502,1044942,1044942,256363119.76666695,3329318.4499998596,175804,0,60,0.18571939878002627,2564502333,-810899,-810899,40243609.13333315,5781.933333474211,-755,0,14,0.630874133177776,-2535311066,1267.3172404216323,245.33717638554768,1021.9800640360846,0.7479352084873293,0.16824283070256532,-755
273,2017-10-01,2017,223123,223123,296186600.8999999,3245974.0000000023,169018,0,96,0.8274359882217434,28391233,2822643833,560614,560613,256166983.71666062,3248135.5166665902,171723,0,54,0.3381845619267447,2546450514,-337491,-337490,40019617.1833393,-2161.516666587908,-2705,0,42,0.4892514262949987,-2518059281,1327.4588496031333,456.9408553077803,870.517994295353,0.7575104314660523,0.30631236465732214,-2705
274,2017-10-02,2017,222572,222572,296103928.9333334,3232456.216666669,167016,0,73,0.816081986952537,29229505,2825878143,577900,577900,255020393.1666646,3227410.3833331987,167757,0,39,0.31889081155909155,2540380100,-355328,-355328,41083535.7666688,5045.833333470393,-741,0,34,0.49719117539344543,-2511150595,1330.373672040209,441.288100305701,889.085571734508,0.7503908847474076,0.29028724692853436,-741
275,2017-10-03,2017,216926,216926,295553273.0333331,3156708.5999999987,163425,0,104,0.815116675732738,28460938,2824499206,585002,585002,254640615.58332705,3152850.649999885,164101,0,69,0.30678185715604056,2541938234,-368076,-368076,40912657.45000607,3857.9500001138076,-676,0,35,0.5083348185766975,-2513477296,1362.4612680514697,435.2816154189679,927.1796526325018,0.7533675078137245,0.2805135708937747,-676
276,2017-10-04,2017,211250,211250,295058562.80000025,3149794.2666666633,160745,0,74,0.8243550295857984,28108545,2824269050,597891,597891,254446313.34999543,3144709.3333331426,161437,0,62,0.2960456002849985,2547143027,-386641,-386641,40612249.450004816,5084.9333335207775,-692,0,12,0.5283094293007999,-2519034482,1396.7269244970425,425.5730782868373,971.1538462102053,0.7609230769230769,0.2700107544686239,-692
277,2017-10-05,2017,218686,218686,294903251.91666627,3208666.6499999953,166016,0,73,0.8274375131467027,29018299,2823613970,618131,618131,254513841.39999473,3203815.783333189,166758,0,86,0.2967299811852174,2552225337,-399445,-399445,40389410.51667154,4850.866666806396,-742,0,-13,0.5307075319614853,-2523207038,1348.5236911218196,411.7474150301388,936.7762760916808,0.7591523920141207,0.26977776555455074,-742
278,2017-10-06,2017,221584,221584,294869720.29999965,3225611.516666666,168622,0,128,0.8272573832045634,28373509,2824013956,633863,633863,254734256.93333066,3222464.516666536,169403,0,92,0.2930112658413519,2553387895,-412279,-412279,40135463.366669,3147.0000001299195,-781,0,36,0.5342461173632116,-2525014386,1330.7356140335028,401.875889479794,928.8597245537087,0.7609845476207668,0.2672549115502877,-781
279,2017-10-07,2017,216699,216699,295038857.9833331,3217491.7499999967,164499,0,93,0.8262613117734738,28168611,2827324451,644499,644499,255048879.26666236,3214142.24999986,165177,0,70,0.2817987304867909,2554909709,-427800,-427800,39989978.71667075,3349.5000001369044,-678,0,23,0.544462581286683,-2526741098,1361.514626201935,395.7320015495173,965.7826246524178,0.7591128708485041,0.2562874418734552,-678
280,2017-10-08,2017,218101,218101,295349644.0666666,3222399.1333333305,165999,0,71,0.8249343194208182,28499629,2830563589,660476,660476,255570606.9999969,3219640.83333321,166656,0,50,0.2757420405889055,2564202859,-442375,-442375,39779037.0666697,2758.30000012042,-657,0,21,0.5491922788319127,-2535703230,1354.187482252106,386.94912002858075,967.2383622235253,0.7611106780803389,0.25232710953918086,-657
281,2017-10-09,2017,220363,220363,296005141.2666669,3215992.1666666646,167488,0,60,0.8259598934485368,28512204,2838574368,677628,677628,256362210.5999965,3212143.149999893,168225,0,50,0.27278388732460335,2571199475,-457265,-457265,39642930.66667038,3849.016666771844,-737,0,10,0.5531760061239335,-2542687271,1343.2615333185104,378.32293028032564,964.9386030381847,0.7600550001588289,0.24825568010766969,-737
282,2017-10-10,2017,217960,217960,295782544.6833336,3190855.7833333313,165421,0,61,0.8204349421912273,28083794,2838692824,689227,689227,256368173.31666285,3186399.1833332116,166038,0,50,0.26259418159764913,2575718494,-471267,-471267,39414371.36667073,4456.600000119768,-617,0,11,0.5578407605935781,-2547634700,1357.0496636232958,371.96478564632963,985.0848779769663,0.7589511837034318,0.24090466566167607,-617
283,2017-10-11,2017,223378,223378,295838953.08333313,3217159.55,171276,0,99,0.8320112096983592,28775688,2841070137,708063,708063,256719332.89999792,3212722.4666662733,171815,0,69,0.2647024346703505,2583619225,-484685,-484685,39119620.183335215,4437.083333726507,-539,0,30,0.5673087750280087,-2554843537,1324.3871513010822,362.5656656257959,961.8214856752863,0.7667541118641943,0.2426549614935394,-539
284,2017-10-12,2017,218834,218834,295621600.36666644,3192049.733333335,166940,0,201,0.8221117376641657,28780759,2842474742,718141,718141,256657198.28332996,3187213.316666592,167363,0,201,0.2521914220187955,2588784747,-499307,-499307,38964402.08333647,4836.41666674288,-423,0,0,0.5699203156453702,-2560003988,1350.8942868414708,357.39109490104306,993.5031919404278,0.7628613469570542,0.23305033412658516,-423
285,2017-10-13,2017,215852,215852,295623084.5166669,3180678.35,165628,0,216,0.8215304931156532,28607716,2844535867,731275,731275,256862583.06666273,3176832.5500000007,166160,0,216,0.24433626200813474,2594045834,-515423,-515423,38760501.45000416,3845.799999999348,-532,0,0,0.5771942311075184,-2565438118,1369.5637961041218,351.253062208694,1018.3107338954278,0.7673220539999629,0.22721958223650474,-532
286,2017-10-14,2017,212439,212439,295393451.30000013,3150875.616666665,163020,0,103,0.8243589924637185,28486939,2844007203,748918,748918,256891243.16666025,3151177.049999999,164951,0,103,0.23754937122622188,2599354525,-536479,-536479,38502208.13333988,-301.43333333404735,-1931,0,0,0.5868096212374966,-2570867586,1390.4859809168756,343.01651604936757,1047.4694648675081,0.7673732224309096,0.22025241748762883,-1931
287,2017-10-15,2017,207845,207845,295126705.04999995,3116013.2333333283,159573,0,65,0.8258702398421902,28422347,2843896779,759793,759793,256408218.99999756,3111462.7999999896,160159,0,66,0.22827270059081686,2601289011,-551948,-551948,38718486.050002396,4550.433333338704,-586,0,-1,0.5975975392513734,-2572866664,1419.9365154321729,337.47115201113667,1082.4653634210363,0.767750006014097,0.2107929396559326,-586
288,2017-10-16,2017,211573,211573,295367618.0000002,3144965.433333332,162429,0,57,0.822420630231646,28206603,2847312060,773518,773518,256848506.59999648,3140421.749999999,162932,0,57,0.22672516993786426,2606956621,-561945,-561945,38519111.4000037,4543.683333333116,-503,0,0,0.5956954602937817,-2578750018,1396.055347326928,332.0523977463957,1064.0029495805325,0.7677208339438397,0.21063763222058182,-503
289,2017-10-17,2017,219884,219884,295707635.7833329,3223280.8333333354,170258,0,59,0.8346628222153497,27997532,2850359652,790898,790898,257367096.7166626,3219411.2999999914,170638,0,55,0.23337901979775116,2607757313,-571014,-571014,38340539.0666703,3869.5333333439194,-380,0,4,0.6012838024175986,-2579759781,1344.8347118632228,325.411237247613,1019.4234746156098,0.7743082716341344,0.21575222089321253,-380
290,2017-10-18,2017,219925,219925,296007671.9666669,3261340.4500000007,168452,0,65,0.8244265090371709,28601600,2853991989,799966,799966,257793356.583328,3258608.866666627,168996,0,65,0.2282984526842404,2610619279,-580041,-580041,38214315.38333887,2731.5833333735354,-544,0,0,0.5961280563529304,-2582017679,1345.948264029405,322.2553915833023,1023.6928724461027,0.7659520291008298,0.2112539782940775,-544
291,2017-10-19,2017,221414,221414,296290020.13333267,3276205.416666667,169012,0,62,0.8215876141526731,29447619,2857619933,814456,814456,258274659.94999576,3271368.4166666474,169548,0,62,0.22498575736442528,2617035367,-593042,-593042,38015360.18333691,4837.000000019558,-536,0,0,0.5966018567882478,-2587587748,1338.1720222449017,317.1130913763245,1021.0589308685771,0.7633302320539803,0.20817330831868142,-536
292,2017-10-20,2017,220499,220499,296688570.1500004,3234224.466666661,168599,0,53,0.8229561131796517,28269120,2861464863,828799,828799,258902428.6833303,3229407.5333333,169085,0,50,0.22049133746541277,2622781434,-608300,-608300,37786141.466670096,4816.933333361056,-486,0,3,0.602464775714239,-2594512314,1345.532497426294,312.3826509000738,1033.1498465262202,0.764624782878834,0.20401207047788428,-486
293,2017-10-21,2017,210447,210447,296139182.53333336,3141180.233333334,161742,0,76,0.8287312244888264,26917357,2858427505,836168,836168,258565839.38334548,3136662.666666116,162159,0,87,0.20967795945312007,2628339735,-625721,-625721,37573343.14998788,4517.566667217761,-417,0,-11,0.6190532650357063,-2601422378,1407.1912763466971,309.22714021984274,1097.9641361268543,0.7685640565082895,0.19393112388897923,-417
294,2017-10-22,2017,207798,207798,295537704.05,3121155.7833333286,158226,0,71,0.8198105852799351,27442017,2855877999,851402,851402,258264143.43333054,3118339.0499999933,158636,0,67,0.20128681868259699,2638547481,-643604,-643604,37273560.616669476,2816.733333335258,-410,0,4,0.6185237665973381,-2611105464,1422.2355559245036,303.3398364501499,1118.8957194743537,0.76144139982098,0.18632326445087044,-410
295,2017-10-23,2017,228943,228943,295998686.83333296,3211528.0666666664,176128,0,58,0.8307002179581823,28952753,2862027274,883317,883317,258868465.48332763,3207126.4833333483,176538,0,58,0.21653607934637054,2644623739,-654374,-654374,37130221.35000533,4401.583333318122,-410,0,0,0.6141641386118117,-2615670986,1292.8924965311583,293.06405909014273,999.8284374410155,0.769309391420572,0.1998580351108379,-410
296,2017-10-24,2017,219990,219990,296159937.7833334,3246839.9833333315,167254,0,86,0.8203372880585484,29058779,2865442617,883709,883709,259197188.63332742,3242555.116666639,167749,0,81,0.20549298468161356,2642203028,-663719,-663719,36962749.150005996,4284.866666692309,-495,0,5,0.6148443033769349,-2613144249,1346.2427282300714,293.30604150611504,1052.9366867239564,0.7602800127278513,0.18982379946339803,-495
297,2017-10-25,2017,224360,224360,296611401.5666669,3300280.3833333384,170696,0,54,0.8239258334819046,29357326,2869895540,900116,900116,259834367.36666262,3296551.89999998,171252,0,48,0.2067611285656509,2646244465,-675756,-675756,36777034.20000428,3728.483333358541,-556,0,6,0.6171647049162537,-2616887139,1322.0333462589895,288.6676465773996,1033.3656996815898,0.7608129791406668,0.190255478182812,-556
298,2017-10-26,2017,226781,226781,297274133.85000044,3336512.3499999987,173040,0,61,0.8264448961773695,29685781,2875844865,914264,914264,260767053.68332928,3333063.7999999803,173596,0,59,0.20663834516069907,2652600382,-687483,-687483,36507080.16667116,3448.55000001844,-556,0,2,0.6198065510166704,-2622914601,1310.8423273995636,285.2207389586917,1025.6215884408718,0.7630268849683175,0.18987513453444518,-556
299,2017-10-27,2017,230346,230346,297698797.1666663,3325978.566666668,177043,0,80,0.8322089378586988,29135965,2880684273,931326,931326,261378170.44999367,3321702.0166666396,177464,0,93,0.2073044240147916,2661464641,-700980,-700980,36320626.71667266,4276.550000028219,-421,0,-13,0.6249045138439071,-2632328676,1292.3983796838943,280.65164126202177,1011.7467384218726,0.7685959382841464,0.1905498182161778,-421
300,2017-10-28,2017,219231,219231,297288541.1833327,3220304.4499999965,168714,0,167,0.8340152624400746,28967543,2881044727,937046,937046,261146409.6166612,3215557.433333298,169179,0,167,0.19671819739906488,2668825504,-717815,-717815,36142131.56667149,4747.01666669827,-465,0,0,0.6372970650410097,-2639857961,1356.0515674486394,278.691131082851,1077.3604363657885,0.7695718215033458,0.1805450319408012,-465
301,2017-10-29,2017,208798,208798,296428959.0499999,3081489.3833333296,159103,0,261,0.825683196199198,28242161,2879486795,949205,949205,260543485.51666096,3077560.716666668,159562,0,261,0.1828698753167132,2678782092,-740407,-740407,35885473.533338934,3928.666666661389,-459,0,0,0.6428133208824849,-2650539931,1419.6925212406245,274.4860019876222,1145.2065192530022,0.7619948466939338,0.1681006737216934,-459
302,2017-10-30,2017,226038,226038,296678785.0500004,3185655.883333337,173091,0,73,0.8282810854812018,28178547,2883258566,978176,978176,260986977.46666127,3181965.0666666846,173655,0,70,0.19282726216959067,2685736122,-752138,-752138,35691807.583339155,3690.8166666524485,-564,0,3,0.6354538233116112,-2657557575,1312.51729819765,266.8098353125217,1045.7074628851283,0.7657606243198046,0.17752940166186862,-564
303,2017-10-31,2017,218184,218184,296615451.21666676,3196866.8166666683,166548,0,66,0.8263392366076343,27531450,2883468031,978968,978968,261111473.71666232,3191891.7666666764,167047,0,52,0.1854258770460357,2682123850,-760784,-760784,35503977.50000444,4975.0499999918975,-499,0,14,0.6409133595615986,-2654592400,1359.473890004156,266.72115300669924,1092.7527369974566,0.7633373666263338,0.17063581240653422,-499
304,2017-11-01,2017,221561,221561,297076849.8333333,3272567.783333333,167679,0,63,0.8201894737792296,29071374,2888386516,525789,525789,261672942.99999613,3268029.5833332,168309,0,43,0.3490088229308702,2651415040,-304228,-304228,35403906.83333719,4538.200000133365,-630,0,20,0.47118065084835936,-2622343666,1340.8354802213987,497.6767163253627,843.158763896036,0.756807380360262,0.32010749559233836,-630
305,2017-11-02,2017,225720,225720,297592198.2,3248506.8833333375,172093,0,61,0.8253234095339369,28970868,2893541562,544213,544213,262346990.06666154,3244089.916666551,172672,0,61,0.34523798586215276,2657051491,-318493,-318493,35245208.13333845,4416.966666786466,-579,0,0,0.48008542367178414,-2628080623,1318.4130701754386,482.0667460473409,836.3463241280976,0.762418040049619,0.3172875326388748,-579
306,2017-11-03,2017,216415,216415,297455440.6499996,3119694.033333339,164651,0,54,0.8198461289651823,27767777,2895481680,556252,556250,262414231.0666626,3117461.6666665548,165212,0,50,0.3213040132889399,2662534258,-339837,-339835,35041209.58333701,2232.3666667840444,-561,0,4,0.49854211567624235,-2634766481,1374.467761707828,471.7559210187193,902.7118406891087,0.7608114040154333,0.29700926918015574,-561
307,2017-11-04,2017,209252,209252,296947181.2999996,3098007.8666666616,158360,0,61,0.8126756255615242,27288078,2894184994,568558,568558,262094130.6999944,3093945.016666591,158867,0,58,0.30169129622660057,2669415730,-359306,-359306,34853050.60000521,4062.850000070408,-507,0,3,0.5109843293349237,-2642127652,1419.08885602049,460.98046408632786,958.1083919341622,0.756790855045591,0.2794209209966266,-507
308,2017-11-05,2017,209736,209736,297022608.66666687,3094565.266666671,158684,0,79,0.8148243506121987,27900219,2896528273,584515,584515,262297544.6333298,3090464.583333203,159183,0,54,0.2948837925459532,2678421726,-374779,-374779,34725064.03333706,4100.683333467692,-499,0,25,0.5199405580662455,-2650521507,1416.1737072637357,448.7439067146777,967.429800549058,0.7565892359919136,0.27233347305030664,-499
309,2017-11-06,2017,220404,220404,297534976.7166667,3214747.300000001,167243,0,55,0.8172537703489963,27947201,2900193144,607794,607794,263043586.26666033,3211760.2833332503,167775,0,48,0.2982243983981345,2683989414,-387390,-387390,34491390.450006366,2987.0166667508893,-532,0,7,0.5190293719508617,-2656042213,1349.9527082841814,432.78411150268073,917.1685967815007,0.7588020181121939,0.27603925014067265,-532
310,2017-11-07,2017,219272,219272,297825871.0166669,3208801.9000000013,167533,0,50,0.8263435367944846,27505835,2900499280,614494,614494,263559857.23332965,3206357.133333238,168072,0,46,0.2969158364442956,2682325910,-395222,-395222,34266013.783337235,2444.766666763462,-539,0,4,0.529427700350189,-2654820075,1358.2485270197146,428.90550149119383,929.3430255285208,0.7640419205370499,0.2735128414598027,-539
311,2017-11-08,2017,216556,216556,297882710.46666676,3159806.183333329,164641,0,78,0.8171419863684225,27208508,2901305415,629730,629730,263771031.13332844,3157506.0333332205,165173,0,78,0.28270369841043624,2687201119,-413174,-413174,34111679.33333832,2300.150000108406,-532,0,0,0.5344382879579863,-2659992611,1375.545865580574,418.86368941185657,956.6821761687174,0.7602698609135743,0.26229177584043956,-532
312,2017-11-09,2017,217980,217980,298212008.08333355,3178854.4333333345,166722,0,79,0.8265345444536195,27564426,2904868400,644498,644498,264240838.5333253,3177046.683333261,167135,0,79,0.28120956155023397,2693818651,-426518,-426518,33971169.55000824,1807.7500000735745,-413,0,0,0.5453249829033855,-2666254225,1368.0705022632055,409.99481539636326,958.0756868668423,0.7648499862372695,0.2593258629196677,-413
313,2017-11-10,2017,217948,217948,298327297.6333335,3154945.466666664,166059,0,129,0.8256464844825377,27865907,2907856814,659238,659238,264451268.23332638,3150890.6999999136,166354,0,129,0.2741923250783486,2700231537,-441290,-441290,33876029.40000713,4054.7666667504236,-295,0,0,0.5514541594041891,-2672365630,1368.8003451893733,401.1468820567479,967.6534631326253,0.7619202745609044,0.25234285644941584,-295
314,2017-11-11,2017,215506,215506,297907585.09999996,3140599.4999999953,164398,0,137,0.8297216782827392,27874519,2906514909,673698,673698,264167959.13333774,3136232.5666662115,164801,0,140,0.2671419538131426,2704952910,-458192,-458192,33739625.96666223,4366.933333783876,-403,0,-3,0.5625797244695967,-2677078391,1382.3632989336722,392.11628820827394,990.2470107253982,0.7628465100739654,0.24462147727913694,-403
315,2017-11-12,2017,211392,211392,297886987.36666656,3108052.300000001,160202,0,82,0.817438692098093,27907103,2908090097,685150,685150,264312154.64999473,3104291.76666656,160672,0,82,0.25414288841859906,2711159132,-473758,-473758,33574832.716671824,3760.5333334412426,-470,0,0,0.563295803679494,-2683252029,1409.1686883451907,385.77268430269976,1023.396004042491,0.7578432485619134,0.23450631248631687,-470
316,2017-11-13,2017,219034,219034,298343076.0333331,3157860.400000002,165662,0,50,0.8163024918505806,28366888,2913910087,705943,705943,264895056.1166618,3153301.8333332557,166036,0,51,0.25462678998163013,2717656921,-486909,-486909,33448019.916671336,4558.566666746046,-374,0,-1,0.5616757018689504,-2689290033,1362.0856854795745,375.23575715980155,986.849928319773,0.7563300674781084,0.23519745928495644,-374
317,2017-11-14,2017,214225,214225,298562810.29999983,3154136.183333336,163527,0,46,0.821150659353483,27558782,2915228744,714530,714530,265319340.5833271,3151003.799999885,163856,0,46,0.24723804458875157,2717493192,-500305,-500305,33243469.71667272,3132.3833334511146,-329,0,0,0.5739126147647314,-2689934410,1393.6879929980153,371.3200853474691,1022.3679076505462,0.7633422803127553,0.22931997256938128,-329
318,2017-11-15,2017,214121,214121,298729100.8999996,3168592.0999999996,163773,0,48,0.8225069003040332,28367102,2916811772,726113,726113,265643173.88332957,3164814.1833333382,164131,0,48,0.24369072031487946,2722460424,-511992,-511992,33085927.01667005,3777.916666661389,-358,0,0,0.5788161799891537,-2694093322,1395.1415363275887,365.84274607854366,1029.298790249045,0.7648619238654779,0.22604057495183258,-358
319,2017-11-16,2017,221291,221291,298856342.03333336,3201053.55,169536,0,54,0.8309330248405951,28473900,2917613909,745971,745971,265967892.0333284,3198841.3666666825,169973,0,50,0.24821474293236323,2727544000,-524680,-524680,32888450.000004947,2212.1833333172835,-437,0,4,0.5827182819082318,-2699070100,1350.512863303674,356.5391845438072,993.9736787598669,0.7661224360683444,0.22785470212649017,-437
320,2017-11-17,2017,210581,210581,298077904.83333343,3161261.0333333337,164780,0,66,0.8458645366865951,28896677,2913289435,748266,748266,265302657.53333658,3157590.6333328946,165077,0,66,0.23908743682059538,2732189836,-537685,-537685,32775247.299996853,3670.4000004390255,-297,0,0,0.6067770998659997,-2703293159,1415.50237121741,354.556611597128,1060.945759620282,0.7825017451716917,0.22061272328289672,-297
321,2017-11-18,2017,199637,199637,297287053.7000001,3031435.166666661,156271,0,128,0.844873445303226,28073729,2911651482,755307,755307,264628855.5333267,3027961.1500000237,156537,0,125,0.2242545084316689,2737775640,-555670,-555670,32658198.16667342,3474.016666637268,-266,0,3,0.6206189368715571,-2709701911,1489.1380540681341,350.35933141534065,1138.7787226527935,0.7827757379644054,0.2072495025201673,-266
322,2017-11-19,2017,204190,204190,297368788.20000005,3068421.766666667,160570,0,89,0.8467750624418441,28033951,2914511374,768012,768012,264844201.26666307,3064280.98333338,160977,0,88,0.2262868288516319,2744734611,-563822,-563822,32524586.933336973,4140.783333287109,-407,0,1,0.6204882335902122,-2716700660,1456.3337489593027,344.84383221442255,1111.4899167448802,0.7863754346442039,0.2096021937157232,-407
323,2017-11-20,2017,205049,205049,297679754.49999994,3095808.1,158063,0,50,0.8323132519544117,27315009,2918691329,778416,778416,265286838.1499957,3092462.466666694,158437,0,50,0.220407853898168,2748497156,-573367,-573367,32392916.350004226,3345.633333306294,-374,0,0,0.6119053980562438,-2721182147,1451.7493599090947,340.80342406887286,1110.9459358402219,0.7708547712985676,0.203537697066864,-374
324,2017-11-21,2017,212589,212589,297927027.58333296,3110700.8666666695,160604,0,79,0.8138520807755816,27306518,2921338877,794720,794720,265698602.01666233,3107902.2166667227,161129,0,79,0.21931372055566703,2748387585,-582131,-582131,32228425.566670626,2798.6499999468215,-525,0,0,0.5945383602199146,-2721081067,1401.4225928121068,334.32982939483384,1067.092763417273,0.7554671220053719,0.20274939601369035,-525
325,2017-11-22,2017,211386,211386,297892889.1333336,3094025.6000000024,158159,0,96,0.8074754241056645,27814931,2921593087,807601,807601,265559779.03332773,3090510.9500000253,158484,0,96,0.21238829570542916,2748531574,-596215,-596215,32333110.100005895,3514.6499999770895,-325,0,0,0.5950871284002354,-2720716643,1409.2366057039426,328.82547078734143,1080.4111349166012,0.7481999754004522,0.19624047023220625,-325
326,2017-11-23,2017,208671,208671,297977761.4333331,3072815.0000000023,156321,0,302,0.812652452904332,27467229,2923801001,821195,821195,265796361.48333874,3068586.2833329495,156674,0,302,0.20757189218151478,2751666176,-612524,-612524,32181399.949994355,4228.716667052824,-353,0,0,0.6050805607228171,-2724198947,1427.9787868622525,323.67021411886185,1104.3085727433906,0.7491266155814655,0.19078781531792083,-353
327,2017-11-24,2017,209249,209249,298213189.68333375,3072612.866666666,156473,0,217,0.8051460222032123,26574336,2926128785,836401,836401,266168748.50001416,3070821.916666249,156807,0,217,0.2026575769278168,2756831730,-627152,-627152,32044441.1833196,1790.9500004174188,-334,0,0,0.6024884452753955,-2730257394,1425.1594496668263,318.23102614656625,1106.92842352026,0.7477837409019876,0.18747825504751908,-334
328,2017-11-25,2017,209584,209584,298194674.03333366,3058553.183333335,157189,0,246,0.811784296511184,26821687,2927263437,851286,851286,266305868.98333132,3056139.1499999957,157685,0,246,0.20139647545008754,2759686929,-641702,-641702,31888805.050002337,2414.0333333392628,-496,0,0,0.6103878210610965,-2732865242,1422.7931236799263,312.8277323758776,1109.9653913040488,0.7500047713565922,0.18523152031162265,-496
329,2017-11-26,2017,208668,208668,298205336.2666663,3045780.7000000007,156289,0,262,0.8131769126075863,26230949,2928112919,866207,866207,266485418.9999951,3043556.816666671,156792,0,262,0.19733620254742587,2765636239,-657539,-657539,31719917.26667118,2223.883333329577,-503,0,0,0.6158407100601604,-2739405290,1429.0899240260428,307.64634665847205,1121.4435773675707,0.7489840320509135,0.18100985099404646,-503
330,2017-11-27,2017,215372,215372,298629365.1166668,3106931.150000002,161190,0,247,0.8073797893876644,27265029,2932148609,884984,884984,266986085.91666144,3102325.4166666805,161585,0,247,0.1976691104019986,2771666748,-669612,-669612,31643279.200005352,4605.733333321288,-395,0,0,0.6097106789856658,-2744401719,1386.5746945594915,301.6846473118852,1084.8900472476062,0.7484259792359267,0.1825852218797176,-395
331,2017-11-28,2017,215520,215520,298662831.81666636,3119381.3500000015,162104,0,196,0.8150890868596887,27563160,2932521379,895780,895780,267214259.91666156,3115242.733333389,162502,0,196,0.19775168010002545,2770161342,-680260,-680260,31448571.900004804,4138.616666612681,-398,0,0,0.6173374067596633,-2742598182,1385.7778016734705,298.303444949275,1087.4743567241956,0.7521529324424647,0.18140838152224878,-398
332,2017-11-29,2017,214832,214832,298785653.8500006,3090191.0499999993,162179,0,140,0.8111454531913306,26865568,2934588733,910621,910621,267482408.14999437,3086622.5000000033,162587,0,140,0.1926586362493295,2773452406,-695789,-695789,31303245.700006247,3568.5499999960884,-408,0,0,0.618486816942001,-2746586838,1390.7874704420226,293.73626146332487,1097.0512089786978,0.7549108140314292,0.17854519058971843,-408
333,2017-11-30,2017,211011,211011,298797392.6833329,3066045.4000000013,159478,0,115,0.8110240698352218,26577368,2936644414,922086,922086,267624376.53332698,3062689.2666666843,159732,0,115,0.1862624527430199,2776822716,-711075,-711075,31173016.150005937,3356.133333317004,-254,0,0,0.6247616170922019,-2750245348,1416.0275657825086,290.23797838089615,1125.7895874016126,0.7557805043338973,0.17322896128994475,-254
334,2017-12-01,2017,207967,207967,298708883.1000002,3046942.0666666673,157215,0,124,0.8106093755259247,26633130,2937972744,506834,506834,267692803.59999618,3043006.033333217,157557,0,124,0.3343126151757767,2741771605,-298867,-298867,31016079.500004023,3936.033333450556,-342,0,0,0.476296760350148,-2715138475,1436.3282785249592,528.1666257591168,908.1616527658424,0.7559612823188294,0.31086509586965355,-342
335,2017-12-02,2017,204332,204332,298469699.8166664,3028844.833333335,155258,0,109,0.8207867588042992,26314033,2936298834,521651,521651,267646721.61666793,3025537.6833332377,155556,0,109,0.323258270376167,2746054958,-317319,-317319,30822978.199998498,3307.15000009723,-298,0,0,0.4975284884281322,-2719740925,1460.7095306494648,513.0762168895832,947.6333137598816,0.7598320380557132,0.298199370843725,-298
336,2017-12-03,2017,201739,201739,298592947.50000054,3000580.999999999,152985,0,98,0.8170408299832953,26680210,2939798317,533582,533582,267892692.4333349,2997418.083333287,153259,0,98,0.3101622618454182,2752215274,-331843,-331843,30700255.06666565,3162.9166667121463,-274,0,0,0.5068785681378771,-2725535064,1480.095308790073,502.06471064116647,978.0305981489065,0.7583313092659327,0.287226705548538,-274
337,2017-12-04,2017,202727,202727,298912203.06666666,3024846.133333337,153682,0,106,0.8131526634340756,27022926,2944586535,549190,549190,268303323.8666702,3021384.9666665792,153844,0,104,0.30095777417651265,2757815356,-346463,-346463,30608879.19999647,3461.166666757781,-162,0,2,0.512194889257563,-2730792430,1474.4567969074997,488.5437168678785,985.9130800396211,0.7580736655699537,0.2801289171325042,-162
338,2017-12-05,2017,209250,209250,298964723.1333333,3027467.099999993,158025,0,84,0.8097443249701319,26606450,2945294234,568267,568267,268479025.2166677,3024014.6999998926,158302,0,84,0.299537013410948,2758999284,-359017,-359017,30485697.916665614,3452.4000001004897,-277,0,0,0.5102073115591839,-2732392834,1428.7441965750697,472.45225433936463,956.2919422357052,0.7551971326164875,0.27856975682205726,-277
339,2017-12-06,2017,208300,208300,299071922.216667,3055120.0666666636,157771,0,100,0.8148679788766202,26371341,2946190259,580635,580635,268637594.8166709,3051586.1499999156,158159,0,100,0.29425887175248444,2761303275,-372335,-372335,30434327.3999961,3533.916666748002,-388,0,0,0.5206091071241358,-2734931934,1435.7749506321027,462.66173209791157,973.1132185341911,0.7574219875180028,0.2723897112643916,-388
340,2017-12-07,2017,208373,208373,299118736.31666666,3028320.7333333287,159529,0,114,0.8262346849159927,26153130,2947242423,595001,595001,268887208.51667064,3026007.0666666436,159872,0,114,0.29076925921133295,2765262316,-386628,-386628,30231527.79999602,2313.666666685138,-343,0,0,0.5354654257046598,-2739109186,1435.4966157643585,451.91051530446276,983.5861004598958,0.7655934310107355,0.2686919853916212,-343
341,2017-12-08,2017,203883,203883,299033793.3166665,2993459.166666665,153537,0,113,0.8129123075489354,26153849,2949531121,606721,606721,268913468.4333414,2990072.6999998707,153884,0,113,0.27491219193005295,2769852208,-402838,-402838,30120324.8833251,3386.466666794382,-347,0,0,0.5380001156188825,-2743698359,1466.6931196650357,443.2242635961857,1023.4688560688501,0.7530642574417681,0.2536322296409717,-347
342,2017-12-09,2017,209095,209095,298998091.2833334,3029930.000000005,157864,0,149,0.8172170544489342,26579688,2951500555,626852,626852,269014052.2000114,3026212.966666544,158128,0,149,0.27382221002724655,2774460915,-417757,-417757,29984039.08332205,3717.033333461266,-264,0,0,0.5433948444216876,-2747881227,1429.9628938201938,429.1508237989372,1000.8120700212567,0.7549869676462851,0.25225731113564287,-264
343,2017-12-10,2017,200926,200926,299075196.4000002,2988255.8833333324,152223,0,128,0.818818868638205,26230899,2954006826,632676,632676,269152048.7000023,2984613.0666665863,152510,0,127,0.2613391372519307,2780408595,-431750,-431750,29923147.699997902,3642.8166667460464,-287,0,1,0.5574797313862743,-2754177696,1488.484299692425,425.4184585791184,1063.0658411133068,0.7576072783014642,0.24105545334420778,-287
344,2017-12-11,2017,200697,200697,299177555.0500002,2977017.6833333303,154099,0,154,0.8281339531731916,26076684,2956390199,648323,648323,269394919.5333382,2974264.4333332703,154371,0,151,0.25738405085120364,2787482247,-447626,-447626,29782635.516662,2753.2500000600703,-272,0,3,0.570749902321988,-2761405563,1490.6927111516375,415.52577886846245,1075.166932283175,0.7678191502613392,0.23810816522011405,-272
345,2017-12-12,2017,205013,205013,299217333.88333344,3016092.2833333365,155697,0,103,0.8166213849853426,25774524,2958484917,662673,662673,269496119.5166698,3013588.183333025,155971,0,103,0.2537812767382934,2786558383,-457660,-457660,29721214.366663635,2504.1000003116205,-274,0,0,0.5628401082470492,-2760783859,1459.5041967257366,406.68039820042435,1052.8237985253122,0.7594494007697072,0.2353664627953757,-274
346,2017-12-13,2017,202494,202494,299520316.98333305,2994164.433333333,152847,0,127,0.8091103933943716,26041469,2961721366,673229,673229,269972669.95001006,2990625.949999933,153146,0,127,0.2447889202633874,2789582260,-470735,-470735,29547647.03332299,3538.483333399985,-299,0,0,0.5643214731309842,-2763540791,1479.1565033202617,401.01164677993677,1078.1448565403248,0.7548223651071143,0.2274798025634665,-299
347,2017-12-14,2017,203293,203293,299558465.1833337,3000025.916666669,154120,0,137,0.813205570285254,26336465,2962180836,690179,690179,270121887.683346,2997568.0666666236,154480,0,137,0.24088243774441143,2795958737,-486886,-486886,29436577.49998772,2457.8500000452623,-360,0,0,0.5723231325408425,-2769622272,1473.5306438654243,391.37946486831095,1082.1511789971132,0.7581175938177901,0.2238259929670419,-360
348,2017-12-15,2017,207118,207118,299678528.0333331,3003423.0666666627,158698,0,87,0.8262294923666699,26720990,2964438944,707468,707468,270347105.2166785,3000625.4166666074,159166,0,87,0.24353044943375723,2801719422,-500350,-500350,29331422.816654623,2797.6500000553206,-468,0,0,0.5826990429329126,-2774998432,1446.8975561435177,382.1333335453738,1064.764222598144,0.7662202222887436,0.2249797870716414,-468
349,2017-12-16,2017,193909,193909,299313431.3833332,2916707.15,146405,0,80,0.8098283215322652,26429075,2964701038,711314,711314,270122620.9000019,2913145.0166666247,146661,0,80,0.22156178565303036,2803561711,-517405,-517405,29190810.483331323,3562.133333375212,-256,0,0,0.5882665358792349,-2777132636,1543.5767879950554,379.75158776574324,1163.825200229312,0.7550191069006595,0.2061832046044363,-256
350,2017-12-17,2017,192904,192904,299280190.8666665,2902500.2333333315,145874,0,92,0.8089256832414055,26267062,2966556916,726177,726177,270203902.9833403,2899516.6833332554,146148,0,92,0.2159225643334933,2810226830,-533273,-533273,29076287.883326173,2983.550000076182,-274,0,0,0.5930031189079121,-2783959768,1551.4462679191022,372.09096815699246,1179.3552997621098,0.7561999751171568,0.20125671840336448,-274
351,2017-12-18,2017,196647,196647,299697086.6333333,2969556.4499999997,149697,0,103,0.8161121196865448,26311104,2972048519,740664,740664,270712790.03333014,2965861.6500000227,149915,0,103,0.2174521780456479,2815279381,-544017,-544017,28984296.600003183,3694.7999999769963,-218,0,0,0.598659941640897,-2788968277,1524.0358949454267,365.5001323587081,1158.5357625867186,0.7612473111717951,0.20240621928431785,-218
352,2017-12-19,2017,197637,197637,299930263.7000003,2975822.5333333313,150129,0,122,0.8119380480375625,25704276,2974570544,750644,750644,271071729.6833351,2972258.966666264,150353,0,122,0.21446517923276912,2815415846,-553007,-553007,28858534.01666516,3563.5666670673527,-224,0,0,0.5974728688047934,-2789711570,1517.5815444476505,361.1188921557158,1156.4626522919348,0.7596199092275232,0.20029867686946143,-224
353,2017-12-20,2017,202952,202952,300158798.8166666,3016008.7999999975,154848,0,114,0.8171735188616029,25563572,2975586678,767868,767868,271436963.53332686,3013493.233333363,155131,0,114,0.21695265332061817,2817415901,-564916,-564916,28721835.28333974,2515.5666666342877,-283,0,0,0.6002208655409847,-2791852329,1478.9644783824087,353.4943031006981,1125.4701752817107,0.7629784382514092,0.20202821318247408,-283
354,2017-12-21,2017,206915,206915,300665074.2666665,3078000.250000003,158407,0,105,0.8227146412778203,26033366,2979344231,782959,782959,272015700.48332715,3075557.4000000264,158711,0,105,0.218344766456481,2820623598,-576044,-576044,28649373.78333932,2442.8499999763444,-304,0,0,0.6043698748213393,-2794590232,1453.0849588800545,347.42010818360495,1105.6648506964495,0.7655655704033058,0.20270665513775307,-304
355,2017-12-22,2017,206626,206626,301154775.3999997,3086921.4500000034,157873,0,102,0.8229070881689621,25637126,2982464923,794861,794861,272598796.2999954,3082766.016666682,158192,0,102,0.21511308266476803,2824818059,-588235,-588235,28555979.100004256,4155.4333333214745,-319,0,0,0.607794005504194,-2799180933,1457.4873220214286,342.9515302675505,1114.5357917538781,0.7640519586112106,0.19901844473436237,-319
356,2017-12-23,2017,208068,208068,301228539.70000035,3068562.1666666684,157696,0,129,0.8196695311148281,25488737,2982334687,808773,808773,272799585.8166623,3066386.5999999996,158069,0,129,0.2119655329740233,2832413509,-600705,-600705,28428953.883338034,2175.5666666687466,-373,0,0,0.6077039981408048,-2806924772,1447.7408332852738,337.3005600046766,1110.4402732805972,0.7579060691696945,0.19544297349194398,-373
357,2017-12-24,2017,197011,197011,300904876.93333346,2974997.9833333315,149135,0,65,0.8178274309556325,25164083,2979737793,814442,814442,272606823.29999536,2971287.6166666565,149380,0,65,0.19875694033460892,2839195557,-617431,-617431,28298053.633338094,3710.3666666750796,-245,0,0,0.6190704906210236,-2814031474,1527.350639981186,334.71606731970525,1192.634572661481,0.7569881884767855,0.18341392020549038,-245
358,2017-12-25,2017,193273,193273,300656500.5166661,2941361.7166666654,146791,0,113,0.8185313002850887,25482237,2978191927,829258,829258,272437929.69999814,2938062.0166666927,147090,0,113,0.19183052801420317,2846164172,-635985,-635985,28218570.816667974,3299.6999999727122,-299,0,0,0.6267007722708855,-2820681935,1555.605286391095,328.532169361041,1227.073117030054,0.759500809735452,0.17737543683630427,-299
359,2017-12-26,2017,197750,197750,300975893.8500004,2967346.8500000047,150909,0,309,0.8233072060682673,26379612,2981661476,844194,844194,272832648.4499953,2963819.3666667314,151268,0,309,0.19397792450550677,2851238332,-646444,-646444,28143245.400005102,3527.483333273325,-359,0,0,0.6293292815627606,-2824858720,1522.0019916561334,323.1871447202838,1198.8148469358496,0.7631302149178255,0.17918630077920478,-359
360,2017-12-27,2017,200142,200142,301423864.9166664,3002434.2833333346,152792,0,328,0.8231905347203483,26975447,2986660795,856093,856093,273386289.08332855,2998779.36666663,153237,0,328,0.19392869699904478,2850741762,-655951,-655951,28037575.833337843,3654.9166667046957,-445,0,0,0.6292618377213035,-2823766315,1506.0500290626974,319.34181109216934,1186.708217970528,0.7634179732390003,0.17899573994881396,-445
361,2017-12-28,2017,202940,202940,302039007.6833332,3047146.0833333298,154156,0,93,0.8162757465260668,27071043,2993308046,867851,867851,274100680.54999995,3042650.266666326,154526,0,87,0.19200185285262225,2853751388,-664911,-664911,27938327.133333266,4495.816667003557,-370,0,6,0.6242738936734445,-2826680345,1488.316781725304,315.83841068340064,1172.4783710419033,0.7596136789198777,0.17805591051920203,-370
362,2017-12-29,2017,205599,205599,302677757.94999987,3029951.416666666,156010,0,113,0.8127763267331073,27189957,2999414209,882063,882063,274786909.51666915,3026377.883332888,156326,0,113,0.1905158701816085,2858949964,-676464,-676464,27890848.433330715,3573.5333337779157,-316,0,0,0.6222604565514988,-2831760007,1472.1752437998232,311.5275320659286,1160.6477117338945,0.7588071926419876,0.17722770369009924,-316
363,2017-12-30,2017,198551,198551,303128376.68333274,2973024.4833333343,150856,0,89,0.8125116468816566,26904707,3005282451,890460,890460,275292414.2166674,2969630.149999553,151115,0,89,0.18205871122791026,2866956000,-691909,-691909,27835962.466665328,3394.3333337814547,-259,0,0,0.6304529356537463,-2840051293,1526.702845532547,309.1575300593709,1217.545315473176,0.7597846397147332,0.16970442243334904,-259
364,2017-12-31,2017,193155,193155,303220611.86666656,2933067.766666666,146647,0,104,0.8124200771401207,27639579,3008951319,902101,902100,275503645.9166643,2930144.850000024,147008,0,103,0.17500811993335422,2878053353,-708946,-708945,27716965.950002253,2922.916666642297,-361,0,1,0.6374119572067665,-2850413774,1569.8305084862754,305.40255616524144,1264.427952321034,0.7592192798529678,0.16296179696065075,-361
365,2018-01-01,2018,194471,194471,303474488.73333335,2939072.783333331,146530,0,129,0.8019190521980144,27761805,3014635440,482366,482366,275832610.6833452,2935570.2166666053,146786,0,125,0.32459999253678073,2857334440,-287895,-287895,27641878.04998815,3502.5666667255573,-256,0,4,0.47731905966123367,-2829572635,1560.5128205919307,571.8326139971416,988.6802065947891,0.7534799533092338,0.3043042005448145,-256
366,2018-01-02,2018,202124,202124,303942653.9999998,2990570.683333335,153192,0,150,0.8112891096554588,28648183,3022277227,504064,504064,276356295.6166748,2986621.7666665916,153521,0,150,0.3266053517013701,2865392274,-301940,-301940,27586358.38332504,3948.9166667433456,-329,0,0,0.48468375795408863,-2836744091,1503.7435138825663,548.2563635107343,955.487150371832,0.7579109853357345,0.3045664836211275,-329
367,2018-01-03,2018,199100,199100,304297732.95000017,2979455.1166666728,150009,0,109,0.8100803616273246,27772287,3027857744,511959,511959,276761456.2999978,2975609.116666466,150253,0,109,0.3165155803492015,2865459169,-312859,-312859,27536276.65000236,3846.0000002067536,-244,0,0,0.49356478127812303,-2837686882,1528.3663131592173,540.5930090104829,987.7733041487344,0.7534354595680562,0.2934863924650216,-244
368,2018-01-04,2018,196538,196538,304531621.0499999,2958989.1166666676,136316,0,120,0.7384373505378107,27778058,3032756854,525840,525840,277067244.86666495,2955165.449999841,136500,0,121,0.27696827932450746,2871891393,-329302,-329302,27464376.183334947,3823.666666826699,-184,0,-1,0.4614690712133032,-2844113335,1549.4795970753742,526.9040865408964,1022.5755105344778,0.6935859731960231,0.2595846645367412,-184
369,2018-01-05,2018,199260,199260,305048122.55000013,2958627.766666667,149959,0,118,0.8035531466425784,27913476,3040136686,544367,544367,277648865.2000098,2955654.233333172,150250,0,118,0.2953173135035782,2877793962,-345107,-345107,27399257.34999031,2973.5333334952593,-291,0,0,0.5082358331390002,-2849880486,1530.9049611060932,510.0398539955762,1020.865107110517,0.7525795443139617,0.27600864857715474,-291
370,2018-01-06,2018,194946,194946,305355360.84999985,2945711.3666666667,147378,0,116,0.8071055574364185,28569039,3047118261,557485,557485,278023647.6500063,2942723.7166666016,147771,0,116,0.2843574266572195,2886347566,-362539,-362539,27331713.19999355,2987.6500000650994,-393,0,0,0.522748130779199,-2857778527,1566.3586883034268,498.7105440505239,1067.648144252903,0.7559939675602475,0.265067221539593,-393
371,2018-01-07,2018,198763,198763,305659019.866667,2969948.050000002,150348,0,65,0.8133606355307578,27918778,3051799657,575506,575506,278476897.38334227,2966420.2333332626,150732,0,64,0.2827546541652117,2895398293,-376743,-376743,27182122.483324707,3527.816666739527,-384,0,1,0.530605981365546,-2867479515,1537.8064321159723,483.8818316113859,1053.9246005045864,0.7564184481015078,0.2619121260247504,-384
372,2018-01-08,2018,195876,195876,306112143.88333315,2946329.9499999955,146585,0,152,0.8002818109416163,27822588,3058450858,586996,586996,278995025.8500079,2942447.733333232,146874,0,152,0.268483941968938,2903439641,-391120,-391120,27117118.033325255,3882.2166667636484,-289,0,0,0.5317978689726783,-2875617053,1562.7853534038532,475.2928910077886,1087.4924623960646,0.7483561028405726,0.25021294864019517,-289
373,2018-01-09,2018,190534,190534,306059807.6500007,2912508.349999999,142493,0,92,0.7988600459760461,25932442,3060353341,598494,598494,279064359.4833397,2909597.2999999225,142686,0,90,0.2554110818153536,2906797474,-407960,-407960,26995448.166660964,2911.050000076648,-193,0,2,0.5434489641606925,-2880865032,1606.3264700788347,466.27762263838855,1140.0488474404463,0.7478612741033096,0.23840840509679295,-193
374,2018-01-10,2018,194922,194922,306403243.38333267,2944602.0666666664,145852,0,91,0.797719087635055,26494173,3064515576,616206,616206,279465281.9000105,2941458.9333332605,146032,0,91,0.25313612655507933,2910979673,-421284,-421284,26937961.483322144,3143.1333334059455,-180,0,0,0.5445829610799756,-2884485500,1571.9274549990903,453.52573960657725,1118.401715392513,0.7482582776700424,0.2369856833591364,-180
375,2018-01-11,2018,200604,200604,306770002.2666662,2956767.05,151340,0,112,0.8069878965524127,27315488,3069793168,635556,635556,279915899.31667644,2953131.383333262,151643,0,112,0.2559664293941048,2917053458,-434952,-434952,26854102.949989736,3635.6666667377576,-303,0,0,0.5510214671583078,-2889737970,1529.2317315041882,440.4268063186823,1088.804925185506,0.7544216466271859,0.23859895902170697,-303
376,2018-01-12,2018,201395,201395,306914621.79999983,2936437.8833333333,151238,0,87,0.8020705578589336,27299248,3073097434,649836,649836,280254461.1833444,2932737.2166665304,151590,0,87,0.24984611501979131,2922746988,-448441,-448441,26660160.61665541,3700.66666680295,-352,0,0,0.5522244428391423,-2895447740,1523.9436023734445,431.269522130729,1092.6740802427155,0.7509521090394499,0.23327424150093254,-352
377,2018-01-13,2018,195502,195502,306840379.83333343,2922769.7833333355,146010,0,96,0.7944829208908347,25311592,3072436207,662088,662088,280292594.0666764,2919395.1166665563,146229,0,93,0.2354369811867916,2927038128,-466586,-466586,26547785.766657054,3374.6666667792015,-219,0,3,0.5590459397040431,-2901726536,1569.4999531121596,423.3464344115531,1146.1535187006066,0.7468465795746335,0.22086036901439082,-219
378,2018-01-14,2018,192016,192016,306676741.34999996,2733454.6333333296,144288,0,117,0.7958972168985915,23011270,3069905244,674355,674355,280212068.966676,2731387.666666628,144597,0,114,0.2274855232036521,2929163709,-482339,-482339,26464672.383323967,2066.9666667017154,-309,0,3,0.5684116936949394,-2906152439,1597.1415993979667,415.5260492866161,1181.6155501113506,0.7514373802183152,0.21442267055186068,-309
379,2018-01-15,2018,202802,202802,307478480.3000002,3021094.099999998,153047,0,107,0.8063184781215176,26956043,3076376568,699083,699083,281045185.0833421,3017693.7666666303,153286,0,107,0.23485766353923218,2935979022,-496281,-496281,26433295.216658115,3400.3333333679475,-239,0,0,0.5714608145822854,-2909022979,1516.1511242492686,402.01976744298184,1114.1313568062867,0.7546621828187099,0.2192672400845107,-239
380,2018-01-16,2018,205053,205053,307867249.31666666,3039122.0666666687,153531,0,98,0.8018365983428675,27048223,3078738703,706672,706672,281480794.0833438,3035294.466666515,153830,0,98,0.2337166323273014,2933396868,-501619,-501619,26386455.23332286,3827.6000001537614,-299,0,0,0.568119966015566,-2906348645,1501.4032924008263,398.3188722396583,1103.084420161168,0.7487381311173209,0.21768231937872168,-299
381,2018-01-17,2018,201667,201667,308185729.6166669,2978274.2833333337,151641,0,114,0.8044895793560677,28066622,3083524724,719091,719091,281876070.2500084,2974386.4166665655,151975,0,114,0.22665837842499134,2939552402,-517424,-517424,26309659.36665851,3887.866666768212,-334,0,0,0.5778312009310763,-2911485780,1528.1911746426877,391.9894286675934,1136.2017459750941,0.7519376001031404,0.21134320969112394,-334
382,2018-01-18,2018,199011,199011,308608178.0333336,2965974.049999999,149400,0,144,0.8012923908728673,26706874,3088580680,733016,733016,282397575.566677,2962312.266666538,149681,0,144,0.21850000545691226,2944319233,-534005,-534005,26210602.466656625,3661.7833334608003,-281,0,0,0.582792385415955,-2917612359,1550.709146898079,385.25431309368,1165.4548338043992,0.7507122721859596,0.20419881694260425,-281
383,2018-01-19,2018,200488,200488,308709170.05000025,2972965.7166666673,151726,0,171,0.8103876541239377,27455938,3091470645,749022,749022,282624280.5000079,2969547.2333329413,152066,0,171,0.21823257527815806,2952599342,-548534,-548534,26084889.549992323,3418.483333725948,-340,0,0,0.5921550788457796,-2925143404,1539.7887656617866,377.3244050241621,1162.4643606376244,0.7567834483859384,0.20301940396944282,-340
384,2018-01-20,2018,198007,198007,308779114.15000004,2964995.3000000017,150114,0,208,0.8135974990783156,26788997,3093064097,761053,761053,282863117.58333063,2961291.316666688,150448,0,208,0.212818292549931,2958029476,-563046,-563046,25915996.566669405,3703.9833333138376,-334,0,0,0.6007792065283846,-2931240479,1559.4353439524866,371.6733494031699,1187.7619945493168,0.7581247127626801,0.1976839983549109,-334
385,2018-01-21,2018,198690,198690,308852474.1499999,2979423.3333333354,150184,0,171,0.8124817554985161,28073974,3097141556,775035,775035,282991002.3999986,2975831.1333332965,150411,0,171,0.20916861819143673,2966705032,-576345,-576345,25861471.75000131,3592.200000038836,-227,0,0,0.6033131373070794,-2938631058,1554.4439788112131,365.1331906300988,1189.3107881811143,0.7558709547536363,0.19406994522828,-227
386,2018-01-22,2018,200114,200114,309309557.1000004,3003089.8500000024,153259,0,187,0.8178338347142132,28249378,3104956286,789073,789073,283545099.4166627,2999124.8000000287,153526,0,187,0.20836855398676613,2974165250,-588959,-588959,25764457.68333769,3965.0499999737367,-267,0,0,0.6094652807274471,-2945915872,1545.6667554493959,359.3395027033781,1186.3272527460176,0.7658584606774139,0.1945650148972275,-267
387,2018-01-23,2018,186878,186878,309122049.95000046,2831827.033333336,145910,0,167,0.8295251447468404,24200537,3103759507,790925,790925,283416133.5999969,2828114.633333371,146082,0,167,0.19659891898726262,2970553071,-604047,-604047,25705916.35000354,3712.3999999649823,-172,0,0,0.6329262257595778,-2946352534,1654.138261058019,358.33502999651915,1295.8032310615,0.7807767634499513,0.1846976641274457,-172
388,2018-01-24,2018,192644,192644,309771968.83333325,2969015.383333334,147735,0,207,0.8173418326031442,28916408,3113147326,803414,803414,284100679.89999616,2965340.883333323,147956,0,207,0.1966570161834392,2978799627,-610770,-610770,25671288.933337092,3674.50000001071,-221,0,0,0.620684816419705,-2949883219,1608.002163749368,353.61679022271977,1254.3853735266482,0.7668808787192957,0.18415910103632746,-221
389,2018-01-25,2018,188302,188302,310048037.16666687,2935978.933333336,144664,0,203,0.8174050195961801,27575964,3117933875,813514,813514,284500583.09999996,2932065.2999996967,144879,0,203,0.1898307834899006,2986624313,-625212,-625212,25547454.0666669,3913.6333336392418,-215,0,0,0.6275742361062795,-2959048349,1646.5467024602333,349.7181156071069,1296.8285868531264,0.7682552495459422,0.1780903586170613,-215
390,2018-01-26,2018,190252,190252,310187094.2333332,2924842.9166666684,145691,0,179,0.8146984000168195,28107686,3121888185,829034,829034,284690021.299997,2921057.266666694,146038,0,179,0.1878306559200222,2996103143,-638782,-638782,25497072.9333362,3785.6499999742955,-347,0,0,0.6268677440967972,-2967995457,1630.4012269691418,343.3996932574502,1287.0015337116915,0.765779071967706,0.17615441586231687,-347
391,2018-01-27,2018,186121,186121,310241540.28333294,2913894.8499999964,142982,0,179,0.8156790475013569,28799135,3125646046,838153,838153,284852740.36666757,2910995.5166663732,143270,0,179,0.18180690160388294,3003259221,-652032,-652032,25388799.916665375,2899.33333362313,-288,0,0,0.633872145897474,-2974460086,1666.8809015819436,339.8576875184693,1327.0232140634744,0.7682206736477882,0.1709353781469493,-288
392,2018-01-28,2018,182216,182216,310388258.6166663,2861467.4999999963,139012,0,133,0.8112295297888222,28258099,3131075871,846820,846820,285081029.31666285,2858335.5666666934,139281,0,133,0.17523912992135496,3010641585,-664604,-664604,25307229.30000347,3131.933333302848,-269,0,0,0.6359903998674673,-2982383486,1703.408364889287,336.64890923296906,1366.7594556563179,0.7628967818413311,0.1644753312392244,-269
393,2018-01-29,2018,184836,184836,311017520.316667,2898478.216666668,142278,0,161,0.8192559890930342,27597407,3139927030,862376,862376,285754868.91666555,2894976.41666666,142487,0,161,0.17618185107192277,3020243917,-677540,-677540,25262651.400001466,3501.8000000081956,-209,0,0,0.6430741380211115,-2992646510,1682.6674474489116,331.3576316092581,1351.3098158396535,0.7697526455885217,0.16522607308181117,-209
394,2018-01-30,2018,188285,188285,311535790.6833336,2928242.0999999978,143616,0,160,0.8125766789707096,28720726,3147236848,871729,871729,286367810.3666742,2924439.149999596,143878,0,160,0.17632199915340097,3022805036,-683444,-683444,25167980.31665939,3802.9500004015863,-262,0,0,0.6362546798173087,-2994084310,1654.5969709925569,328.5055451484053,1326.0914258441517,0.7627585840613963,0.1650490003200536,-262
395,2018-01-31,2018,188447,188447,312102330.6166664,2919269.5333333346,143014,0,68,0.8087950458219026,28258286,3155179036,883700,883700,286939215.9333369,2915991.149999613,143302,0,68,0.17313341631775891,3028996304,-695253,-695253,25163114.683329463,3278.383333721664,-288,0,0,0.6356616295041437,-3000738018,1656.1809453940173,324.7020662366605,1331.4788791573567,0.7589083402760458,0.16216136697974426,-288
396,2018-02-01,2018,187941,187941,312537117.24999964,2909633.2166666584,144284,0,156,0.816580735443571,27694657,3161098483,438287,438287,287440813.4500001,2907654.566666468,144681,0,156,0.3517740658518227,3007406598,-250346,-250346,25096303.799999535,1978.6500001903623,-397,0,0,0.4648066695917483,-2979711941,1662.953359032886,655.8278330180912,1007.1255260147949,0.767709015063238,0.3301056157266814,-397
397,2018-02-02,2018,188095,188095,312723607.5166668,2881031.183333336,142817,0,181,0.8084797575693133,27839877,3166136977,451434,451434,287690904.7166716,2877055.31666663,143048,0,181,0.3379541638423367,3015544427,-263339,-263339,25032702.799995244,3975.8666667058133,-231,0,0,0.47052559372697667,-2987704550,1662.5833090548224,637.2823152812406,1025.300993773582,0.759281214280018,0.3168746704944687,-231
398,2018-02-03,2018,173167,173167,311832183.5666666,2689807.333333332,134276,0,146,0.8195037160659941,23666921,3160794434,457105,457105,286887670.5000073,2686665.149999993,134389,0,146,0.3109810656194919,3019442853,-283938,-283938,24944513.06665933,3142.1833333391696,-113,0,0,0.5085226504465022,-2995775932,1800.7598651398164,627.618753896823,1173.1411112429932,0.7754133293294911,0.29400028439855175,-113
399,2018-02-04,2018,172624,172624,311744775.1499998,2678918.9333333336,134030,0,160,0.8224117156362953,23481388,3160299850,468045,468045,286856349.9500018,2675161.0999999754,134217,0,160,0.304075462829427,3023618065,-295421,-295421,24888425.19999802,3757.8333333581686,-187,0,0,0.5183362528068683,-3000136677,1805.9179207410314,612.8819877362257,1193.0359330048057,0.7764273797386226,0.2867608883761177,-187
400,2018-02-05,2018,186188,186188,312551860.8166665,2886538.533333336,143877,0,191,0.824687949814167,27997790,3169520572,488406,488406,287727365.94999945,2883896.6999997604,144143,0,191,0.3154834297694954,3031209311,-302218,-302218,24824494.866667032,2641.8333335756324,-266,0,0,0.5092045200446716,-3003211521,1678.689608442362,589.115133618341,1089.5744748240209,0.7727511977141384,0.29512946196402173,-266
401,2018-02-06,2018,188802,188802,312326936.16666675,2903059.5166666643,144465,0,178,0.8145146767513061,28369038,3169649996,500141,500141,287626653.9333336,2900475.983333136,144664,0,178,0.3082870630482186,3035066493,-311339,-311339,24700282.23333317,2583.5333335283212,-199,0,0,0.5062276137030874,-3006697455,1654.2565024028704,575.0911321673959,1079.1653702354745,0.7651666825563288,0.2892464325060333,-199
402,2018-02-07,2018,188204,188204,312626702.41666657,2915972.2499999935,145005,0,123,0.8238454017980491,28508446,3174351304,511780,511780,287960523.1833352,2912430.4166664397,145250,0,123,0.3040701082496447,3040341290,-323576,-323576,24666179.233331382,3541.8333335537463,-245,0,0,0.5197752935484043,-3011832844,1661.1055153804732,562.6646668164742,1098.440848563999,0.7704671526641305,0.28381335730196566,-245
403,2018-02-08,2018,186143,186143,312777484.5833329,2881874.5000000014,142879,0,148,0.8238773416137055,27789508,3177593595,523522,523522,288159976.2500073,2879019.3666664464,143116,0,148,0.29387685713302986,3046285490,-337379,-337379,24617508.333325624,2855.133333554957,-237,0,0,0.5300004844806756,-3018495982,1680.307530142594,550.425724706903,1129.8818054356911,0.7675765406166227,0.2733715106528474,-237
404,2018-02-09,2018,185114,185114,312794282.04999995,2836980.133333333,141749,0,63,0.8173395853366026,28588976,3181613913,536871,536871,288310751.1166743,2834751.816666537,142029,0,63,0.2829785926228116,3057851640,-351757,-351757,24483530.93332565,2228.316666795872,-280,0,0,0.5343609927137909,-3029262664,1689.7386586103696,537.0205340140822,1152.7181245962875,0.7657389500524001,0.26454958453706756,-280
405,2018-02-10,2018,171676,171676,311511492.28333324,2713823.1333333324,132411,0,54,0.8197593140567122,27508205,3171686908,542353,542353,287349160.2333381,2711880.5499998988,132698,0,54,0.26046320385431887,3056028389,-370677,-370677,24162332.049995124,1942.5833334336057,-287,0,0,0.5592961102023933,-3028520184,1814.5313980016615,529.8194353738951,1284.7119626277663,0.771284279689648,0.24467090621790605,-287
406,2018-02-11,2018,165775,165775,311137575.76666665,2643789.066666665,125596,0,62,0.8036977831397992,27714188,3173888109,552392,552392,287013799.0666749,2642360.266666596,125856,0,62,0.24195317817781958,3065513238,-386617,-386617,24123776.699991763,1428.8000000691973,-260,0,0,0.5617446049619796,-3037799050,1876.8666913989844,519.5835549151235,1357.2831364838607,0.7576293168451214,0.22783820185665252,-260
407,2018-02-12,2018,169808,169808,311116988.0500004,2710526.15,129906,0,69,0.8136895788184297,28045849,3177343381,568191,568191,286797819.86667454,2707244.083333286,130134,0,69,0.24383173967908767,3070345590,-398383,-398383,24319168.183325887,3282.0666667139158,-228,0,0,0.5698578391393421,-3042299741,1832.1692031588643,504.7560061082885,1327.413197050576,0.7650169603316687,0.22903213884063633,-228
408,2018-02-13,2018,169455,169455,310937383.0500002,2692274.283333335,128081,0,66,0.8038712342509812,28635701,3179810915,576852,576852,286728653.2666722,2689570.1999999313,128438,0,66,0.2372653644262316,3076307617,-407397,-407397,24208729.783327997,2704.0833334038034,-357,0,0,0.5666058698247496,-3047671916,1834.9259865451015,497.05756982150046,1337.868416723601,0.755840783688885,0.22265329755292518,-357
409,2018-02-14,2018,163656,163656,310411759.6000001,2623014.200000001,121657,0,67,0.78077797330987,26810946,3177577233,585981,585981,286280950.91667193,2621921.899999934,122147,0,67,0.2194849321053069,3083676731,-422325,-422325,24130808.68332815,1092.3000000673346,-490,0,0,0.5612930412045631,-3056865785,1896.7331451336956,488.5498862875621,1408.1832588461334,0.7433702400156426,0.20844873809901687,-490
410,2018-02-15,2018,158353,158353,309860522.6666665,2550243.8166666715,117186,0,57,0.7761583298074556,26401609,3176279184,603751,603751,285881893.1000005,2557660.83333316,118401,0,58,0.20593589078941504,3091273129,-445398,-445398,23978629.566666007,-7417.016666488256,-1215,0,-1,0.5702224390180406,-3064871520,1956.7707758404736,473.50959766526347,1483.26117817521,0.7400301857242995,0.1961089919519802,-1215
411,2018-02-16,2018,155742,155742,309726313.86666673,2546412.8000000026,117587,0,84,0.7914884873701374,26232432,3179008824,616300,616300,285620330.5666734,2545141.999999985,117985,0,84,0.2010968684082411,3095199504,-460558,-460558,24105983.299993336,1270.8000000175089,-398,0,0,0.5903916189618963,-3068967072,1988.7141160808692,463.4436647195739,1525.2704513612953,0.7550114933672356,0.19144085672562064,-398
412,2018-02-17,2018,156015,156015,309870208.8166666,2552152.0666666618,117022,0,51,0.7857577797006693,25916952,3183264383,621471,621471,285785232.7500014,2549796.399999868,117321,0,51,0.19817497517985505,3101053822,-465456,-465456,24084976.066665232,2355.666666793637,-299,0,0,0.5875828045208142,-3075136870,1986.1565158264693,459.8528857340107,1526.3036300924587,0.7500689036310612,0.18877952470831302,-299
413,2018-02-18,2018,162004,162004,310137617.04999965,2603401.083333332,123081,0,91,0.8090787881780686,29092352,3190745226,634938,634938,286128131.1000073,2605240.7666665902,123441,0,91,0.20750214981620044,3112152717,-472934,-472934,24009485.94999236,-1839.6833332581446,-360,0,0,0.6015766383618681,-3083060365,1914.3824661736726,450.63948149269265,1463.74298468098,0.7597405002345621,0.19441425777005,-360
414,2018-02-19,2018,168325,168325,310744866.55,2673334.283333334,128821,0,86,0.8187019159364326,28689739,3200337779,654558,654558,286803911.9333395,2675595.633333271,130616,0,86,0.21371215385038883,3122561121,-486233,-486233,23940954.616660535,-2261.349999936763,-1795,0,0,0.6049897620860438,-3093871382,1846.10049933165,438.1642450834601,1407.93625424819,0.7653111540175256,0.19954839754460263,-1795
415,2018-02-20,2018,167236,167236,311033302.9999994,2666213.8499999996,128610,0,59,0.8188787103255273,28352024,3206293787,658354,658354,283824872.0666735,2664780.1999999434,128889,0,59,0.20889065760973533,3074754672,-491118,-491118,27208430.933325887,1433.6500000562519,-279,0,0,0.6099880527157919,-3046402648,1859.846582075626,431.11285428002793,1428.733727795598,0.7690329833289483,0.19577461365769783,-279
416,2018-02-21,2018,170908,170908,311342281.1500001,2701552.7833333304,131903,0,88,0.8187679921361192,29425589,3213412054,670600,670600,284258735.86667484,2699532.799999899,132167,0,88,0.2095586042350185,3080107010,-499692,-499692,27083545.283325255,2019.9833334311843,-264,0,0,0.6092093879011007,-3050681421,1821.6951877618374,423.88716949996245,1397.8080182618748,0.771777798581693,0.1970876826722338,-264
417,2018-02-22,2018,174924,174924,311879587.2000005,2756436.2333333315,135078,0,69,0.822814479431067,29447265,3221618952,684130,684130,284891935.6833431,2754206.0333332242,135348,0,69,0.2112727113267937,3085241500,-509206,-509206,26987651.516657412,2230.2000001072884,-270,0,0,0.6115417681042733,-3055794235,1782.9433765521055,416.4295319359524,1366.5138446161532,0.7722096453316869,0.19783959189043018,-270
418,2018-02-23,2018,185289,185289,312503013.4000003,2827504.383333333,141860,0,103,0.8197680380378759,29981331,3230171846,702774,702774,285576742.10000646,2825424.9166665934,142176,0,103,0.21702567254907157,3087564394,-517485,-517485,26926271.299993813,2079.466666739434,-316,0,0,0.6027423654888043,-3057583063,1686.570780780296,406.3564419002502,1280.2143388800457,0.7656147963451689,0.20230685825030523,-316
419,2018-02-24,2018,180234,180234,312759928.28333324,2822614.666666662,139367,0,91,0.8281456328994529,29285001,3236682351,709146,709146,285858095.46667403,2821889.5999999773,139791,0,91,0.21176598330950247,3087324348,-528912,-528912,26901832.816659212,725.0666666845791,-424,0,0,0.6163796495899504,-3058039347,1735.2992680811237,403.101893639214,1332.1973744419097,0.7732558784691013,0.19712583868484063,-424
420,2018-02-25,2018,180344,180344,312868761.4499999,2810515.3666666695,138747,0,99,0.824945659406468,29459043,3241925660,720741,720741,286043338.3000084,2809489.8499999065,139091,0,99,0.20758080919498034,3097186462,-540397,-540397,26825423.149991512,1025.5166667629965,-344,0,0,0.6173648502114877,-3067727419,1734.8443056048436,396.8739648500757,1337.970340754768,0.769346360289225,0.19298333243148372,-344
421,2018-02-26,2018,187308,187308,313483024.66666627,2875681.666666662,143922,0,82,0.8283575714865359,29341429,3249876230,737929,737929,286750555.9500071,2874280.0499999104,144309,0,82,0.21142819973195423,3105831751,-550621,-550621,26732468.71665919,1401.616666751448,-387,0,0,0.6169293717545816,-3076490322,1673.6232551021114,388.5882733298286,1285.034981772283,0.7683708117111923,0.19555946439291585,-387
422,2018-02-27,2018,191821,191821,313977251.3166663,2930586.900000002,147968,0,117,0.8322029391985232,30182636,3257264074,749359,749359,287406935.6833306,2929889.2333333446,148417,0,117,0.2143698814586848,3107958509,-557538,-557538,26570315.63333571,697.6666666571982,-449,0,0,0.6178330577398383,-3077775873,1636.8241814851674,383.5370439046313,1253.2871375805362,0.7713858232414594,0.19805860742314432,-449
423,2018-02-28,2018,188603,188603,314195236.5666664,2913841.016666667,145848,0,108,0.831625159727046,29769931,3262728690,758377,758377,287858470.7333341,2915730.266666328,146244,0,109,0.2080363724110756,3115276749,-569774,-569774,26336765.8333323,-1889.2499996609986,-396,0,-1,0.6235887873159704,-3085506818,1665.9079472047974,379.57173112229685,1286.3362160825006,0.7733068933155889,0.19283812668369427,-396
424,2018-03-01,2018,189396,189396,314481731.1499997,2908749.833333336,145815,0,95,0.8265855667490335,30161105,3268705440,441621,441621,288302969.36666775,2909046.099999844,146413,0,95,0.35724523969648414,3097990425,-252225,-252225,26178761.78333193,-296.26666650827974,-598,0,0,0.46934032705254936,-3067829320,1660.4454748252322,652.8289401243776,1007.6165347008546,0.7698948235443198,0.3315354115859527,-598
425,2018-03-02,2018,189800,189800,314889892.46666616,2902991.95,144180,0,122,0.817671232876712,30370191,3275785034,457625,457625,288784053.54999924,2901863.399999712,144543,0,123,0.3409975416552851,3106949600,-267825,-267825,26105838.916666925,1128.550000288058,-363,0,-1,0.47667369122142683,-3076579409,1659.061604144711,631.0495570609106,1028.0120470838006,0.7596417281348788,0.3158546845124283,-363
426,2018-03-03,2018,190926,190926,315279437.3666665,2925299.9000000004,146439,0,146,0.8247436179462205,30679646,3284265310,475584,475584,289182562.21666706,2926107.949999743,146831,0,146,0.33299059682411103,3117454341,-284658,-284658,26096875.14999944,-808.0499997427687,-392,0,0,0.4917530211221095,-3086774695,1651.3174599932252,608.0578030729946,1043.2596569202306,0.7669934948618836,0.3087383091104831,-392
427,2018-03-04,2018,191582,191582,315866548.81666666,2916323.9500000016,146853,0,184,0.8175350502656821,30464300,3293604680,491622,491622,289898747.016677,2917606.9333332255,147333,0,186,0.32048809857980887,3126376528,-300040,-300040,25967801.79998964,-1282.983333223965,-480,0,-2,0.4970469516858732,-3095912228,1648.7276926677175,589.6781409633357,1059.0495517043819,0.7665281707049723,0.2996875648363987,-480
428,2018-03-05,2018,193498,193498,316396930.5333335,2938609.833333333,148412,0,158,0.8198275951172628,30739316,3304167701,509185,509185,290328707.2999969,2936527.3999998113,148795,0,160,0.3133006667517708,3135324360,-315687,-315687,26068223.233336568,2082.433333521709,-383,0,-2,0.506526928365492,-3104585044,1635.1431566906815,570.1831501320678,1064.9600065586137,0.766995007700338,0.2922218839910838,-383
429,2018-03-06,2018,192303,192303,316754802.9000001,2968580.9333333327,149080,0,131,0.8328263209622311,30306487,3310871656,521099,521099,290809573.7500006,2964556.58333314,149505,0,132,0.3095764912233554,3139796025,-328796,-328796,25945229.1499995,4024.350000192877,-425,0,-1,0.5232498297388757,-3109489538,1647.1651659100487,558.0697213965112,1089.0954445135376,0.7752349157319438,0.2869032563869821,-425
430,2018-03-07,2018,193748,193748,317311191.38333356,3006345.700000003,152026,0,145,0.8452422734686291,30886806,3319344059,534271,534271,291454930.06666684,3003254.633333074,152487,0,145,0.3086804262256478,3146645791,-340523,-340523,25856261.316666722,3091.0666669290513,-461,0,0,0.5365618472429814,-3115758985,1637.752087161331,545.5189034528672,1092.233183708464,0.7846584222804881,0.28541133619455294,-461
431,2018-03-08,2018,191643,191643,317562474.86666673,2986247.7000000062,148440,0,165,0.8347604660749424,30122458,3324702655,547034,547034,291799949.46666634,2982626.0999997263,148747,0,168,0.29386656039661047,3155695014,-355391,-355391,25762525.400000393,3621.6000002799556,-307,0,-3,0.540893905678332,-3125572556,1657.0523048933003,533.4219618280881,1123.6303430652122,0.7745652071821042,0.27191545680890034,-307
432,2018-03-09,2018,206785,206785,317972844.4499997,3110408.616666666,159956,0,136,0.8368256885170586,31443114,3330543999,574013,574013,292416919.2333335,3105179.6666663885,160280,0,137,0.3030088168734891,3166847953,-367228,-367228,25555925.216666162,5228.95000027772,-324,0,-1,0.5338168716435696,-3135404839,1537.6978235848815,509.42560400780735,1028.272219577074,0.7735377324274004,0.27922712551806317,-324
433,2018-03-10,2018,206666,206666,318389820.4666665,3108808.816666672,158230,0,172,0.8269913773915398,31060268,3336828970,585987,585987,292954538.90000963,3103947.4666665737,158633,0,173,0.2930252718916968,3175032264,-379321,-379321,25435281.566656888,4861.350000098348,-403,0,-1,0.533966105499843,-3143971996,1540.6008751641127,499.9335120062555,1040.6673631578572,0.7656315020371034,0.2707107836863275,-403
434,2018-03-11,2018,204548,204548,318920563.21666706,3084303.9166666665,156348,0,136,0.8260603868040767,30223894,3344408228,605411,605411,293552702.10001695,3088623.0499999393,157143,0,136,0.2813625784797506,3186765589,-400863,-400863,25367861.116650105,-4319.133333272766,-795,0,0,0.5446978083243261,-3156541695,1559.1477952200319,484.88167889254896,1074.266116327483,0.7643584879832607,0.2595641638490216,-795
435,2018-03-12,2018,209229,209229,319643477.76666707,3144257.2666666647,159409,0,106,0.821520917272462,29187800,3352657795,623249,623249,293692165.30000705,3141334.099999901,159938,0,106,0.27770441669381624,3192859604,-414020,-414020,25951312.466660023,2923.1666667638347,-529,0,0,0.5438165005786457,-3163671804,1527.7207163761575,471.22765588072673,1056.4930604954307,0.7618876924326934,0.2566197458800576,-529
436,2018-03-13,2018,210013,210013,320221775.88333374,3178643.6833333313,160824,0,146,0.8295105541085547,30576308,3357587175,629452,629452,294058204.0000123,3174850.616666556,161464,0,147,0.2794954976709893,3189552986,-419439,-419439,26163571.883321464,3793.066666775383,-640,0,-1,0.5500150564375654,-3158976678,1524.7712088458036,467.1654137249739,1057.6057951208297,0.7657811659278235,0.25651519099152914,-640
437,2018-03-14,2018,213923,213923,320723779.19999975,3170876.000000003,164112,0,112,0.8314300005142031,30196293,3364162870,647009,647009,294644641.3333417,3166617.7833332187,164782,0,112,0.2773500832291331,3197840875,-433086,-433086,26079137.866658032,4258.2166667841375,-670,0,0,0.55407991728507,-3167644582,1499.2486978959707,455.3949656547926,1043.853732241178,0.7671545369128144,0.25468270147710464,-670
438,2018-03-15,2018,207155,207155,320744072.76666677,3090273.56666667,158870,0,97,0.8312760976080712,30429910,3368114309,658861,658861,294721672.0500072,3085112.349999867,159231,0,98,0.26268514906785173,3207567355,-451706,-451706,26022400.716659546,5161.21666680323,-361,0,-1,0.5685909485402194,-3177137445,1548.3288975243986,447.3199537535341,1101.0089437708646,0.7669136636817842,0.2416761653823796,-361
439,2018-03-16,2018,207062,207062,320666661.4333331,3103223.366666668,159323,0,189,0.833354261042586,30392413,3371515252,675905,675905,294767744.8166728,3099193.133333224,159690,0,190,0.2565819160976811,3214720739,-468843,-468843,25898916.616660297,4030.233333444223,-367,0,-1,0.5767723449449049,-3184328326,1548.650459443708,436.10824718957963,1112.5422122541286,0.7694458664554578,0.23626101301218366,-367
440,2018-03-17,2018,205632,205632,320426051.23333377,3098914.9666666626,157591,0,55,0.8292580921257396,31804492,3373740912,687873,687873,294552016.40000755,3095500.8999999873,157973,0,55,0.24939487376303374,3219785217,-482241,-482241,25874034.83332622,3414.066666675266,-382,0,0,0.5798632183627059,-3187980725,1558.2499379149829,428.2069748340283,1130.0429630809545,0.7663739106753813,0.22965431118825713,-382
441,2018-03-18,2018,203769,203769,320567175.1833341,3082330.3499999978,157166,0,105,0.8396763001241604,31509953,3378306588,699952,699952,294856042.816674,3079104.7666665297,157619,0,105,0.24636403639106605,3230346039,-496183,-496183,25711132.366660118,3225.5833334680647,-453,0,0,0.5933122637330943,-3198836086,1573.1891268217153,421.25180414753294,1151.9373226741823,0.771294946728894,0.22518544128740256,-453
442,2018-03-19,2018,209530,209530,321197868.36666656,3101878.2333333283,162270,0,62,0.8416074070538816,30988771,3388004458,719308,719308,295593638.75000614,3099248.766666567,162700,0,62,0.24667041100613163,3239804974,-509778,-509778,25604229.616660416,2629.46666676132,-430,0,0,0.59493699604775,-3208816203,1532.9445347523817,410.9416811018453,1122.0028536505365,0.7744475731398845,0.22618961557496928,-430
443,2018-03-20,2018,203877,203877,321390667.2500001,3098380.183333332,158408,0,116,0.8418458188025135,32454633,3393478858,726579,726579,295905295.51667655,3094177.1499999217,158773,0,116,0.23774014938499902,3242960939,-522702,-522702,25485371.733323574,4203.033333410509,-365,0,0,0.6041056694175145,-3210506306,1576.3949207119986,407.25825480323067,1169.136665908768,0.776978276117463,0.21852131702127367,-365
444,2018-03-21,2018,207958,207958,321930646.11666673,3171883.666666668,161866,0,127,0.8409919310630043,33786889,3402017532,743323,743323,296596856.7666704,3167746.933332811,162196,0,129,0.2366669671192787,3252877507,-535365,-535365,25333789.34999633,4136.733333856799,-330,0,-2,0.6043249639437256,-3219090618,1548.056079192273,399.01477119189155,1149.0413080003814,0.7783590917396782,0.21820393018916406,-330
445,2018-03-22,2018,183765,183765,316806530.8166668,2758481.2333333325,146929,0,47,0.8480341740810267,13641672,3352478403,741002,741002,291687259.9166799,2755118.2499999395,147996,0,47,0.2121681183046749,3242810544,-557237,-557237,25119270.899986863,3362.983333393,-1067,0,0,0.6358660557763518,-3229168872,1723.976441741718,393.6389644247653,1330.3374773169526,0.799548336190243,0.19972415728972392,-1067
446,2018-03-23,2018,219655,219655,317097910.7499998,3279838.1333333314,168626,0,159,0.8321003391682412,33015389,3355979219,780589,780589,292112863.2833319,3275349.6999999443,168990,0,159,0.23542222603700785,3254481807,-560934,-560934,24985047.46666795,4488.433333387133,-364,0,0,0.5966781131312333,-3221466418,1443.6179952653015,374.22108597909,1069.3969092862114,0.7676856889212629,0.21649036817070186,-364
447,2018-03-24,2018,220797,220797,317967540.5166666,3291619.9999999986,168364,0,155,0.8273708429009454,33553245,3366350820,782830,782830,293026879.64999825,3286698.6333332905,168810,0,157,0.23490029763805834,3221073620,-562033,-562033,24940660.866668344,4921.366666708142,-446,0,-2,0.5924705452628871,-3187520375,1440.0899492142855,374.3173864696016,1065.772562744684,0.7625284763832842,0.21564068827203864,-446
448,2018-03-25,2018,179067,179067,315116485.6166669,2736659.4333333317,141479,0,63,0.8343525049283226,12956853,3333706202,772883,772883,290306771.41667336,2732671.466666611,142494,0,63,0.19503987020027871,3214221675,-593816,-593816,24809714.19999355,3987.9666667208076,-1015,0,0,0.6393126347280439,-3201264822,1759.7686096079508,375.61541839666984,1384.153191211281,0.790089742945378,0.1843668446582471,-1015
449,2018-03-26,2018,216887,216887,316173151.23333335,3283619.9666666677,168589,0,173,0.842438689271371,33253133,3346871529,817508,817508,291444931.4500002,3280786.866666228,168898,0,173,0.22466079842643466,3231602044,-600621,-600621,24728219.783333123,2833.1000004396774,-309,0,0,0.6177778908449363,-3198348911,1457.7782496568875,356.50407268185785,1101.2741769750296,0.777312609792196,0.20660103632013388,-309
450,2018-03-27,2018,217323,217323,317237031.3999998,3294506.0166666647,168394,0,330,0.845234972828463,34109494,3359824077,813691,813691,292644409.81666493,3289996.499999958,168792,0,334,0.22720664232491292,3218100325,-596368,-596368,24592621.583334863,4509.516666706651,-398,0,-4,0.6180283305035501,-3183990831,1459.748997575037,359.65054279408884,1100.0984547809483,0.7748558597111213,0.20743992498380834,-398
451,2018-03-28,2018,217385,217385,318119982.29999936,3282695.0666666673,167516,0,116,0.8423902293166495,33772969,3370953764,828085,828085,293577806.4166674,3278466.666666162,167967,0,116,0.22249648284898252,3232060896,-610700,-610700,24542175.883331954,4228.400000505149,-451,0,0,0.619893746467667,-3198287927,1463.3943570163506,354.52617354096185,1108.8681834753888,0.7705959472824712,0.2028378729236733,-451
452,2018-03-29,2018,217780,217780,318964613.4833337,3271930.166666669,167784,0,178,0.8443520984479748,33914965,3382302822,842879,842879,294412888.7833313,3267647.666666641,168178,0,178,0.21922838272160083,3242910696,-625099,-625099,24551724.700002432,4282.50000002794,-394,0,0,0.6251237157263739,-3208995731,1464.6184841736326,349.2943693974239,1115.3241147762087,0.7704288731747635,0.19952804613710864,-394
453,2018-03-30,2018,217929,217929,319801841.0833335,3286445.483333335,168123,0,113,0.8460599553065452,33839805,3395085972,857229,857229,295289332.8166658,3281446.9666666193,168605,0,113,0.21666439189528244,3257116727,-639300,-639300,24512508.266667664,4998.516666715499,-482,0,0,0.6293955634112628,-3223276922,1467.4588562482895,344.4696024243998,1122.9892538238896,0.7714576765827402,0.19668606638366176,-482
454,2018-03-31,2018,216678,216678,320416902.2,3249453.566666665,166229,0,394,0.8438420144177078,33370067,3405824197,870144,870144,295988892.5333422,3245455.3999995287,166664,0,394,0.21160750404531783,3274228922,-653466,-653466,24428009.666657805,3998.1666671363637,-435,0,0,0.63223451037239,-3240858855,1478.769889882683,340.16081537463015,1138.6090745080528,0.7671706403049686,0.19153611356281258,-435
455,2018-04-01,2018,177469,177469,317420253.4499999,2726179.949999998,142461,0,156,0.8631253909133427,13279323,3373535280,484424,484424,293025305.5333326,2721867.6333333147,142935,0,158,0.3186856968275733,3240864439,-306955,-306955,24394947.916667342,4312.316666683182,-474,0,-2,0.5444396940857694,-3227585116,1788.5954924522025,604.8942776025394,1183.701214849663,0.8027373794859948,0.2950617640744472,-474
456,2018-04-02,2018,218365,218365,318364366.9833335,3261128.433333335,168455,0,327,0.8487807111945593,33150519,3386104348,537215,537215,294058379.60000825,3270163.7499998417,170513,0,327,0.3509674897387376,3258370565,-318850,-318850,24305987.38332528,-9035.316666506696,-2058,0,0,0.49781322145582174,-3225220046,1457.9459482212512,547.3755937567049,910.5703544645463,0.7714377304055137,0.31740178513258194,-2058
457,2018-04-03,2018,213763,213763,319004641.5333334,3201159.2500000014,164171,0,182,0.8380168691494785,31920348,3394404968,531817,531817,291502942.7000126,3197383.916666588,164706,0,182,0.33989887498895144,3195139259,-318054,-318054,27501698.833320796,3775.3333334135823,-535,0,0,0.49811799416052704,-3163218911,1492.3286140881885,548.1264094604209,944.2022046277676,0.7680047529273073,0.3097042779753186,-535
458,2018-04-04,2018,211377,211377,319138204.36666644,3164698.9499999997,162558,0,215,0.8397413152802805,32011038,3400241904,544567,544567,291768718.6666775,3161402.716666543,163164,0,217,0.33134214889995395,3205089427,-333190,-333190,27369485.69998896,3296.2333334567957,-606,0,-2,0.5083991663803266,-3173078389,1509.805723265381,535.7811227391257,974.0246005262552,0.7690429895400162,0.29962153417302184,-606
459,2018-04-05,2018,208353,208353,319353827.3000004,3174012.283333333,161438,0,307,0.8452482085691106,32925200,3406437382,557694,557694,292164745.96667546,3169542.7499998324,162276,0,307,0.319497789110159,3213222926,-349341,-349341,27189081.33332497,4469.533333500847,-838,0,0,0.5257504194589516,-3180297726,1532.7536790926956,523.8800237525874,1008.8736553401083,0.7748292561182224,0.2909767722084154,-838
460,2018-04-06,2018,225694,225694,319403661.08333355,3145791.866666661,160864,0,95,0.7760950667718228,33269607,3411998866,590649,590649,291865227.45000696,3141829.9666664214,161229,0,99,0.29800270549852853,3216365990,-364955,-364955,27538433.63332659,3961.9000002397224,-365,0,-4,0.4780923612732943,-3183096383,1415.2067005916574,494.14326859100237,921.063432000655,0.7127526651129406,0.27296922537750845,-365
461,2018-04-07,2018,230751,230751,319425648.4666667,3181926.3500000024,166212,0,86,0.7947094487131158,34134274,3417378359,629532,629531,292094964.6333444,3177101.5166665656,166804,0,86,0.295667257581821,3226344341,-398781,-398780,27330683.833322287,4824.833333436865,-592,0,0,0.4990421911312948,-3192210067,1384.2871687085503,463.98821445384647,920.2989542547039,0.7203089044034479,0.2649650851743835,-592
462,2018-04-08,2018,181811,181811,316289057.9166668,2725579.3166666636,145911,0,49,0.8664162234408256,13592669,3381129791,619183,619183,289117480.15001297,2721394.8666666127,147233,0,49,0.2614267510574429,3215918450,-437372,-437372,27171577.766653836,4184.450000050943,-1322,0,0,0.6049894723833826,-3202325781,1739.658535053802,466.93381463963476,1272.7247204141672,0.8025422004169165,0.2377859211250955,-1322
463,2018-04-09,2018,224207,224207,316904222.6666667,3342106.6166666592,171628,0,155,0.836236156765846,32534490,3387930924,662955,662955,289981187.95000863,3339207.9833327294,172352,0,155,0.28517169340301085,3228756563,-438748,-438748,26923034.716658056,2898.6333339298144,-724,0,0,0.5510644633628351,-3196222073,1413.444819593798,437.4070456516787,976.0377739421193,0.7654890346866958,0.2599754131125039,-724
464,2018-04-10,2018,220203,220203,317877143.4666669,3308558.1999999997,170292,0,324,0.8517322652279935,32589257,3398763845,656816,656816,290600022.2666783,3306665.983333202,170862,0,324,0.28880995590849917,3203763406,-436613,-436613,27277121.199988604,1892.2166667976417,-570,0,0,0.5629223093194944,-3171174149,1443.5640907102395,442.43748974854185,1001.1266009616977,0.7733409626571845,0.2601367810771967,-570
465,2018-04-11,2018,224450,224450,318992461.9166665,3373456.866666671,172423,0,262,0.8564268211182882,33213666,3411351486,671013,671013,291827999.8666788,3369163.7499998966,173031,0,262,0.2908572561187327,3216400192,-446563,-446563,27164462.049987733,4293.1166667742655,-608,0,0,0.5655695649995555,-3183186526,1421.2183645206794,434.90662605147554,986.3117384692039,0.7682022722209846,0.25786534687107404,-608
466,2018-04-12,2018,189614,189614,317001760.81666666,2854111.1833333345,150539,0,85,0.8526374634784345,14198320,3384491588,664857,664857,290021826.00001156,2850226.083333293,151710,0,85,0.2474080892582903,3208556672,-475243,-475243,26979934.8166551,3885.100000041537,-1171,0,0,0.6052293742201442,-3194358352,1671.826768153547,436.21684963836066,1235.6099185151863,0.7939234444713998,0.22818440657163871,-1171
467,2018-04-13,2018,221463,221463,317536550.7333332,3309861.6666666665,171193,0,352,0.8546393754261434,32870293,3390575381,714445,714445,290767954.08335453,3317835.266666577,173569,0,352,0.2698710187628054,3221723519,-492982,-492982,26768596.649978638,-7973.599999910686,-2376,0,0,0.584768356663338,-3188853226,1433.8131007587415,406.98437820035764,1026.8287225583838,0.773009486912035,0.2429424238394838,-2376
468,2018-04-14,2018,215923,215923,317774116.76666665,3225635.1999999983,166959,0,112,0.8519286968039533,32585881,3396593569,711860,711860,287107169.433344,3221243.7166665522,168055,0,112,0.262183575422137,3147626435,-495937,-495937,30666947.333322644,4391.483333446085,-1096,0,0,0.5897451213818163,-3115040554,1471.7011007010215,403.319710945051,1068.3813897559705,0.77323397692696,0.23607872334447785,-1096
469,2018-04-15,2018,210352,210352,318157776.08333343,3220973.966666667,164049,0,102,0.8885772419563396,31963519,3404269683,716939,716939,286709048.46667665,3215656.0333332345,164741,0,102,0.2732310559196847,3139419334,-506587,-506587,31448727.61665678,5317.933333432302,-692,0,0,0.6153461860366549,-3107455815,1512.5017878761953,399.90717266974826,1112.594615206447,0.7798784893892142,0.22978384492962442,-692
470,2018-04-16,2018,217697,217697,318969084.7499997,3302426.249999999,169842,0,160,0.9466138715737921,33450835,3413618228,740064,740064,287702653.966661,3297975.616666629,173648,0,160,0.34217716305617046,3153004313,-522367,-522367,31266430.783338726,4450.6333333700895,-3806,0,0,0.6044367085176217,-3119553478,1465.1974292250225,388.7537482794204,1076.443680945602,0.7801761163451953,0.2346391663423704,-3806
471,2018-04-17,2018,225864,225864,319822600.8999999,3374146.55,174316,0,223,0.9424033931923632,33912821,3424304952,752621,752621,286301633.9166639,3368766.5999999316,175796,0,225,0.3398921900930185,3117426046,-526757,-526757,33520966.98333603,5379.950000068173,-1480,0,-2,0.6025112030993447,-3083513225,1415.9963557716144,380.4061193039576,1035.5902364676567,0.7717741649842383,0.23357838805986014,-1480
472,2018-04-18,2018,194097,194097,318135308.56666625,2923131.950000009,153877,0,111,0.9757956073509636,14497129,3400765979,745902,745902,284826706.06667453,2917409.683333307,155928,0,93,0.318083340706961,3110941198,-551805,-551805,33308602.499991715,5722.266666701995,-2051,0,18,0.6577122666440026,-3096444069,1639.0531979714588,381.8553993241398,1257.197798647319,0.7927840203609535,0.20904622859303232,-2051
473,2018-04-19,2018,232694,232694,319174872.08333355,3468150.0333333337,179865,0,243,0.9386662311877402,33092886,3410859799,788938,788938,286048842.5333338,3463016.6999999294,181647,0,243,0.354176120303498,3126550061,-556244,-556244,33126029.549999774,5133.333333404269,-1782,0,0,0.5844901108842422,-3093457175,1371.6506316593188,362.57455279544627,1009.0760788638726,0.7729679321340472,0.2302424271615767,-1782
474,2018-04-20,2018,232471,232471,320177715.4999999,3423329.200000002,179106,0,124,0.9199470041424523,32500441,3420849467,788078,788078,287177236.6499984,3418526.833333295,180585,0,103,0.32035026989713805,3121937992,-555607,-555607,33000478.850001454,4802.36666670721,-1479,0,21,0.5995967342453143,-3089437551,1377.2802435572603,364.40204732272497,1012.8781962345354,0.7704444855487351,0.22914609975154743,-1479
475,2018-04-21,2018,228395,228395,320659614.3333333,3392882.216666664,176205,0,129,0.9704546947174846,33664602,3430145938,803463,803463,287778696.0833409,3386342.83333285,178192,0,106,0.3684749639996005,3133459859,-575068,-575068,32880918.24999243,6539.383333813865,-1987,0,23,0.601979730717884,-3099795257,1403.9695016674327,358.17292903760455,1045.7965726298282,0.7714923706736136,0.22177996995505705,-1987
476,2018-04-22,2018,228740,228740,321432259.56666696,3369396.4,177367,0,214,1.0301127918160367,33691062,3441348855,818859,818859,288670306.41667587,3364396.3833327927,179637,0,214,0.40114964847427437,3149509631,-590119,-590119,32761953.149991095,5000.016667207237,-2270,0,0,0.6289631433417623,-3115818569,1405.2297786424192,352.5274881471363,1052.7022904952828,0.7754087610387339,0.2193747641535356,-2270
477,2018-04-23,2018,224994,224994,321789932.7166662,3343001.650000002,175280,0,136,0.977083833346668,33592371,3450942596,832552,832552,289194525.44999605,3340282.433333301,176891,0,136,0.3234692848014373,3165947667,-607558,-607558,32595407.266670167,2719.216666700784,-1611,0,0,0.6536145485452307,-3132355296,1430.2156178238806,347.35911444569956,1082.856503378181,0.7790429967021343,0.21246841038157377,-1611
478,2018-04-24,2018,221541,221541,321886441.5999997,3323636.6333333356,173163,0,172,1.0023742783502836,32993211,3455648609,844298,844298,289470796.93334186,3320998.2166661667,175156,0,173,0.3451565679416414,3174349446,-622757,-622757,32415644.666657865,2638.41666716896,-1993,0,-1,0.6572177104086422,-3141356235,1452.942983917197,342.853822860343,1110.089161056854,0.7816295854943329,0.20745755645518527,-1993
479,2018-04-25,2018,231737,231737,322543445.38333327,3410615.183333336,178617,0,185,0.9980667739722193,34080834,3464384797,865980,865980,290265330.983329,3409922.599999938,180781,0,185,0.3385886510081023,3183715300,-634243,-634243,32278114.400004268,692.5833333977498,-2164,0,0,0.659478122964117,-3149634466,1391.8513029137914,335.18710707329154,1056.6641958404998,0.77077462813448,0.20875886279128847,-2164
480,2018-04-26,2018,236195,236195,323332803.8333335,3463209.649999999,180862,0,130,0.9532970638667208,30964370,3468741045,889017,889017,291324322.14999145,3470329.0666666385,186082,0,85,0.3106656003203541,3187835240,-652822,-652822,32008481.68334204,-7119.416666639503,-5220,0,45,0.6426314635463666,-3156870870,1368.9231517743115,327.6926337179058,1041.2305180564058,0.765731704735494,0.2093120828960526,-5220
481,2018-04-27,2018,237482,237482,324185245.48333323,3485217.099999999,183174,0,164,0.9699514068434666,35217217,3478094044,901756,901756,290622616.24999505,3483558.666666599,184970,0,164,0.29518628098954225,3164431182,-664274,-664274,33562629.23333818,1658.4333334001713,-1796,0,0,0.6747651258539243,-3129213965,1365.0939670515374,322.28520381344293,1042.8087632380946,0.7713174051085977,0.2051220063964088,-1796
482,2018-04-28,2018,239424,239424,325039469.55,3526707.450000003,183585,0,181,0.9886811681368628,36259807,3491000357,911204,911203,291536195.6833304,3522519.149999988,185506,0,181,0.3183644935711444,3175513186,-671780,-671779,33503273.866669595,4188.300000015181,-1921,0,0,0.6703166745657184,-3139253379,1357.5893375350843,319.9464835863473,1037.642853948737,0.7667777666399358,0.20358339076650234,-1921
483,2018-04-29,2018,236607,236607,325754633.6166668,3464796.8833333342,181633,0,192,0.9880392380614258,35736059,3501398814,922824,922824,292385644.64999646,3461134.5833333135,183664,0,193,0.3068515773321896,3189937444,-686217,-686217,33368988.966670334,3662.3000000207685,-2031,0,-1,0.6811876607292362,-3154201385,1376.775131829011,316.8379286299408,1059.9372031990702,0.7676569163211571,0.19902386587258242,-2031
484,2018-04-30,2018,239100,239100,326219796.1333335,3434541.483333331,183508,0,163,0.9900125470514429,36383663,3510646015,942510,942509,292957334.2499976,3429804.733333299,185489,0,164,0.3118311742050472,3207154083,-703410,-703409,33262461.88333589,4736.750000032131,-1981,0,-1,0.6781813728463957,-3170770420,1364.3655212602823,310.8270947545303,1053.5384265057519,0.7674947720618988,0.19680321694199532,-1981
485,2018-05-01,2018,220490,220490,325610235.7333335,3235980.333333332,168811,0,142,0.9922626876502343,35136140,3514019540,520513,520513,292529788.6166809,3232809.333333214,171000,0,144,0.5411411434488629,3186919444,-300023,-300023,33080447.116652608,3171.000000118278,-2189,0,-2,0.4511215442013714,-3151783304,1476.7573846130597,562.0028483758924,914.7545362371673,0.7656174883214658,0.32852205420421776,-2189
486,2018-05-02,2018,212669,212669,325340257.1499999,3217324.2666666657,163007,0,135,0.9716178662616559,35150516,3519524347,538202,538202,292284156.5333361,3217859.216666514,165624,0,104,0.505295409530261,3197078405,-325533,-325533,33056100.616663814,-534.9499998483807,-2617,0,31,0.46632245673139494,-3161927889,1529.7963367956775,543.0751958062885,986.7211409893889,0.7664821859321292,0.30773575720640206,-2617
487,2018-05-03,2018,213193,213193,325685534.9166671,3222610.3499999964,163154,0,138,0.9618655396753184,34716552,3529307722,550102,550102,292400333.266672,3218274.1999998465,165063,0,93,0.4980839916960863,3199623219,-336909,-336909,33285201.64999509,4336.15000014985,-1909,0,45,0.4637815479792321,-3164906667,1527.6558560396782,531.5383933646342,996.117462675044,0.7652877908749349,0.3000588981679761,-1909
488,2018-05-04,2018,220968,220968,326249980.94999987,3249312.0333333313,166789,0,134,0.9390635748162633,35934571,3539675024,575887,575887,293100403.4500016,3280717.5499997186,170585,0,88,0.44251215950351397,3213421783,-354919,-354919,33149577.49999827,-31405.516666387208,-3796,0,46,0.4965514153127494,-3177487212,1476.4580434723573,508.95471411926576,967.5033293530915,0.7548106513160276,0.296212625046233,-3796
489,2018-05-05,2018,219625,219625,326610162.0499997,3243632.0666666683,166370,0,127,0.9331724530449624,35309562,3548933387,590767,590767,291804085.1000094,3238249.716666375,168105,0,96,0.44006351065648536,3208249165,-371142,-371142,34806076.94999033,5382.35000029346,-1735,0,31,0.4931089423884771,-3172939603,1487.1265204325541,493.9410716915626,993.1854487409914,0.7575184974388162,0.2845538088620387,-1735
490,2018-05-06,2018,219672,219672,326930499.083333,3209469.0666666683,166882,0,132,0.9297634655304273,35016073,3555879631,602333,602332,292004029.93334466,3205833.2166664824,168314,0,94,0.4223394700273761,3216304315,-382661,-382660,34926469.14998835,3635.850000185892,-1432,0,38,0.5074239955030513,-3181288242,1488.266593299706,484.78916931749376,1003.4774239822123,0.7596871699624895,0.27943678994841725,-1432
491,2018-05-07,2018,217021,217021,325430285.08333266,3153712.4333333345,167124,0,139,0.9342045239861582,33570648,3540205628,618445,618445,290728543.4166788,3150069.4833332403,168726,0,99,0.40353790555345026,3206121560,-401424,-401424,34701741.66665387,3642.95000009425,-1602,0,40,0.5306666184327079,-3172550912,1499.5336169464367,470.09603669959137,1029.4375802468453,0.7700821579478484,0.2728229672808415,-1602
492,2018-05-08,2018,214017,214017,324045106.51666635,3221531.033333329,164057,0,135,0.9424718597120788,33143360,3523197125,628047,628047,289700545.83334255,3217941.1499998383,165471,0,96,0.3999732504096007,3190752622,-414030,-414030,34344560.6833238,3589.883333490696,-1414,0,39,0.5424986093024782,-3157609262,1514.1091900020388,461.2720796904412,1052.8371103115976,0.7665606003261423,0.2634691352717233,-1414
493,2018-05-09,2018,215426,215426,324306441.9166669,3230575.683333333,165877,0,136,0.9568668591534913,31784805,3527537012,640326,640326,290194307.56667864,3228658.8333332087,167346,0,101,0.401668837435927,3199392230,-424900,-424900,34112134.34998828,1916.8500001244247,-1469,0,35,0.5551980217175643,-3167607425,1505.4192247763358,453.19775796497197,1052.2214668113638,0.7699952651954731,0.2613450023894079,-1469
494,2018-05-10,2018,216502,216502,324714769.0999998,3250668.95,166661,0,132,1.017704224441345,31933631,3532183832,655531,655531,290795977.2166785,3246269.7333331774,168676,0,106,0.456802195472071,3207080388,-439029,-439029,33918791.883321285,4399.216666822787,-2015,0,26,0.560902028969274,-3175146757,1499.8234154880777,443.6037002318403,1056.2197152562374,0.7697896555228128,0.2573120111787238,-2015
495,2018-05-11,2018,220648,220648,325226630.95000017,3280165.0000000047,169694,0,135,0.9732107247743015,33766808,3540964562,670869,670869,291516369.4333472,3276868.916666478,171634,0,88,0.43008396572206975,3216582885,-450221,-450221,33710261.51665294,3296.083333526738,-1940,0,47,0.5431267590522317,-3182816077,1473.9613817029847,434.5354598786756,1039.4259218243092,0.7690710996700627,0.2558383231301491,-1940
496,2018-05-12,2018,217271,217271,325287491.99999946,3246148.0999999987,167495,0,142,1.0121000961932347,33183086,3543265981,681872,681872,291729236.0000101,3241754.683333177,169491,0,92,0.4389445526433132,3225470489,-464601,-464601,33558255.99998939,4393.416666821577,-1996,0,50,0.5731555435499215,-3192287403,1497.1509865559576,427.8357756294584,1069.3152109264993,0.7709036180622356,0.24856717976394396,-1996
497,2018-05-13,2018,218663,218663,325829276.18333304,3230648.3666666634,166109,0,145,0.9890699386727536,34504694,3552833629,696169,696169,292422238.40001214,3227067.8833331587,168109,0,104,0.41577260693882445,3237368167,-477506,-477506,33407037.783320904,3580.483333504759,-2000,0,41,0.5732973317339292,-3202863473,1490.097895772641,420.0449005916841,1070.052995180957,0.7596575552333957,0.2414772849695979,-2000
498,2018-05-14,2018,220607,220607,326479240.93333364,3270234.366666667,167354,0,139,0.9791575063347945,34602245,3563782509,727599,727599,293203537.3999918,3308972.116666601,173797,0,99,0.4135464727136743,3248702371,-506992,-506992,33275703.533341825,-38737.749999933876,-6443,0,40,0.5656110336211202,-3214100126,1479.9133342701439,402.97407967849296,1076.939254591651,0.7586069345034382,0.23886371476596313,-6443
499,2018-05-15,2018,218310,218310,326840010.73333323,3265505.833333328,166842,0,138,0.9722916952956822,34280718,3569179276,733321,733321,290810807.8166792,3261603.549999522,168606,0,95,0.370843055087737,3207716555,-515011,-515011,36029202.91665405,3902.2833338058554,-1764,0,43,0.6014486402079451,-3173435837,1497.1371477867858,396.56686201087814,1100.5702857759077,0.7642435069396729,0.22992113958280208,-1764
500,2018-05-16,2018,219263,219263,327260211.233333,3260236.7499999995,166190,0,139,0.9644354040581407,34336731,3576262378,739427,739427,291083748.1166628,3255561.4666666696,168298,0,105,0.40591430932330486,3211352010,-520164,-520164,36176463.11667019,4675.2833333299495,-2108,0,34,0.5585210947348358,-3177015279,1492.5464452886852,393.6612378458763,1098.885207442809,0.7579482174375065,0.22760597056910284,-2108
501,2018-05-17,2018,220038,220038,327635904.90000063,3263707.6833333294,167417,0,141,0.9875248820658242,34423109,3580870296,755759,755759,291513863.5666647,3259499.533333306,169715,0,102,0.4120665450229487,3218138712,-535721,-535721,36122041.333335936,4208.15000002319,-2298,0,39,0.5754583370428755,-3183715603,1488.9969228042457,385.7233106938385,1103.2736121104072,0.7608549432370773,0.22456232740860513,-2298
502,2018-05-18,2018,219014,219014,328017718.4500005,3262345.6833333336,168282,0,155,0.9878500917749553,33542556,3586882309,767566,767565,292030345.6166618,3258717.8333333377,170569,0,155,0.39494063051255845,3226675452,-548552,-548551,35987372.83333874,3627.849999995902,-2287,0,0,0.5929094612623969,-3193132896,1497.7020576310215,380.4633426702127,1117.238714960809,0.7683618398823819,0.22222062988720187,-2287
503,2018-05-19,2018,222060,222060,328140344.98333323,3277253.1666666716,168174,0,142,0.9816085742592092,35739762,3594674034,782754,782754,292317507.74999654,3274752.8333332953,170229,0,114,0.3880235680686442,3238246674,-560694,-560694,35822837.23333669,2500.3333333763294,-2055,0,28,0.593585006190565,-3202506912,1477.7102809300784,373.4474787097818,1104.2628022202966,0.7573358551742773,0.2174744555760814,-2055
504,2018-05-20,2018,218306,218306,328448257.5500006,3259781.983333333,167426,0,146,1.0334530429763715,34343998,3600097022,794503,794503,292843618.116663,3256626.083333332,169895,0,105,0.4079959421172758,3250173379,-576197,-576197,35604639.43333763,3155.900000000838,-2469,0,41,0.6254571008590957,-3215829381,1504.5315179152226,368.5871772877673,1135.9443406274554,0.7669326541643381,0.2138380849411519,-2469
505,2018-05-21,2018,222216,222216,329048691.5500003,3285049.083333336,169493,0,149,1.0270907585412379,34724283,3608636315,810334,810334,293540012.66666824,3279686.899999477,171756,0,108,0.3935118111790809,3262233062,-588118,-588118,35508678.88333207,5362.183333858848,-2263,0,41,0.6335789473621569,-3227508779,1480.760573271053,362.2457069142702,1118.514866356783,0.7627398567159881,0.2119570448728549,-2263
506,2018-05-22,2018,218979,218979,328640382.1333332,3258661.3666666625,166793,0,141,0.985674425401523,33739529,3608729343,820485,820485,293332997.866665,3253669.6166666513,168693,0,114,0.34652918700525104,3267857069,-601506,-601506,35307384.2666682,4991.750000011176,-1900,0,27,0.6391452383962719,-3234117540,1500.784925190695,357.51171303151796,1143.273212159177,0.7616849104252006,0.20560156492806084,-1900
507,2018-05-23,2018,219828,219828,329022646.84999996,3299691.150000002,168071,0,142,0.9934357770620666,33967766,3614812822,833944,833944,293991254.23333985,3295990.366666157,170188,0,101,0.35761633874695486,3273570776,-614116,-614116,35031392.61666012,3700.783333844971,-2117,0,41,0.6358194383151118,-3239603010,1496.727654575395,352.5311702384571,1144.1964843369378,0.7645568353439962,0.20407605306831153,-2117
508,2018-05-24,2018,225467,225467,329871704.8833331,3352092.999999996,170824,0,281,0.996074813609086,33341141,3624376068,849255,849254,294931291.133344,3347420.833332795,172799,0,281,0.3544082754885227,3282160557,-623788,-623787,34940413.74998909,4672.166667200625,-1975,0,0,0.6416665381205633,-3248819416,1463.0598042433398,347.2827812802106,1115.7770229631292,0.7576452429845609,0.203471277766984,-1975
509,2018-05-25,2018,222138,222138,330368437.28333324,3320532.4000000022,170420,0,243,1.0443823208996212,33293410,3632514429,861528,861528,295539732.1833393,3315988.599999454,173005,0,243,0.38838435895292495,3292160101,-639390,-639390,34828705.099993944,4543.800000548363,-2585,0,0,0.6559979619466962,-3258866691,1487.2216247707877,343.0413546435395,1144.1802701272481,0.7671807615086118,0.20081181342916307,-2585
510,2018-05-26,2018,219280,219280,330512650.6499995,3311731.083333328,168803,0,212,1.0976924480116748,32636739,3636601874,874490,874490,295825279.5666636,3306855.4833333213,172076,0,212,0.47665267756063323,3302426112,-655210,-655210,34687371.08333588,4875.600000006612,-3273,0,0,0.6210397704510415,-3269789373,1507.26309125319,338.28320457256643,1168.9798866806236,0.769805727836556,0.19677297624901371,-3273
511,2018-05-27,2018,218463,218463,330804295.2333339,3264605.316666668,166524,0,147,1.0520271167199942,32046394,3639956507,884473,884473,296364197.79999757,3259774.6833332945,168922,0,123,0.3694606844980021,3311409836,-666010,-666010,34440097.43333632,4830.633333373349,-2398,0,24,0.682566432221992,-3279363442,1514.234882947382,335.07432991170737,1179.1605530356746,0.7622526469013059,0.19098604479729736,-2398
512,2018-05-28,2018,217617,217617,331388063.4166665,3315893.2999999966,167909,0,139,1.0318357481262928,32371445,3648216539,898251,898251,297032167.18332815,3311519.5833333237,170015,0,139,0.35070820962069504,3322223211,-680634,-680634,34355896.233338356,4373.716666672844,-2106,0,0,0.6811275385055977,-3289851766,1522.8041164829333,330.67835959361935,1192.1257568893138,0.7715803452855245,0.18927337681783823,-2106
513,2018-05-29,2018,217918,217918,331808803.54999954,3316592.4166666665,168048,0,135,1.0163914867060058,32309917,3652995925,906259,906258,297619034.16666293,3312037.566666688,169794,0,137,0.3170120241564507,3327212352,-688341,-688340,34189769.3833366,4554.849999978673,-1746,0,-2,0.6993794625495551,-3294902435,1522.6314648170392,328.40431109757145,1194.2271537194677,0.7711524518396828,0.18735703590254,-1746
514,2018-05-30,2018,215944,215944,332405616.0333325,3272988.8833333305,167371,0,133,0.9779155707035155,29021111,3656636634,915855,915855,298328290.1333285,3270286.5333333337,169264,0,95,0.2993858198077238,3332799028,-699911,-699911,34077325.90000403,2702.3499999968335,-1893,0,38,0.6785297508957917,-3303777917,1539.3139704429507,325.7374695048108,1213.5765009381398,0.7750666839550995,0.1848152818950598,-1893
515,2018-05-31,2018,211653,211653,332426272.19999987,3147195.9999999995,164388,0,156,1.0166498939301576,27914492,3656025188,926468,926468,298508174.8333297,3142688.1166666737,166436,0,104,0.3045383110911525,3335768389,-714815,-714815,33918097.36667019,4507.883333325852,-2048,0,52,0.7121115828390051,-3307853897,1570.6192314779373,322.2001999349461,1248.4190315429912,0.7766863687261697,0.17964570821658168,-2048
516,2018-06-01,2018,215080,215080,332767802.5166664,3163112.1666666665,167028,0,151,1.0103589362097825,30073144,3659094550,501551,501550,298907687.81666636,3158892.783333093,169291,0,103,0.5933913001868002,3308872000,-286471,-286470,33860114.70000005,4219.3833335735835,-2263,0,48,0.41696763602298226,-3278798856,1547.1815255563808,595.9678752201503,951.2136503362306,0.7765854565742979,0.3375349665338121,-2263
517,2018-06-02,2018,217609,217609,333023213.5333331,3302188.583333334,168314,0,138,0.9798721560229589,29250069,3660842162,519028,519028,299261703.60000914,3297190.316666605,170198,0,94,0.5455890626324604,3312207440,-301419,-301419,33761509.93332398,4998.266666729003,-1884,0,44,0.4342830933904984,-3282957371,1530.3742654638968,576.5810391732414,953.7932262906554,0.7734698472949189,0.3279167983230192,-1884
518,2018-06-03,2018,218767,218767,333596335.4500001,3304268.6833333317,169159,0,145,0.955528027536146,31274079,3667394540,529394,529394,299960226.28333247,3299647.033333116,170864,0,101,0.5090764156752734,3321013692,-310627,-310627,33636109.16666764,4621.650000215508,-1705,0,44,0.44645161186087257,-3289739613,1524.8933132053742,566.6105514670217,958.2827617383525,0.7732381940603473,0.32275394129891916,-1705
519,2018-06-04,2018,214829,214829,334302276.1333336,3300688.749999998,167044,0,130,0.9492619711491466,31828851,3675757779,541929,541929,300833553.6500023,3298047.8499997584,168694,0,101,0.48203177907069733,3331979786,-327100,-327100,33468722.483331323,2640.9000002397224,-1650,0,29,0.46723019207844924,-3300150935,1556.1319753540427,555.1161750893609,1001.0158002646817,0.7775672744368777,0.3112843195326325,-1650
520,2018-06-05,2018,215863,215863,334827622.83333325,3311204.383333335,167242,0,122,0.9599190227134803,32524701,3680217580,553254,553254,301479293.1500132,3309286.1166665126,168769,0,95,0.46447020717427984,3337495957,-337391,-337391,33348329.683320045,1918.266666822601,-1527,0,27,0.49544881553920045,-3304971256,1551.1116904394605,544.9202231705748,1006.1914672688857,0.7747599171696863,0.30504795265827267,-1527
521,2018-06-06,2018,218041,218041,335370338.8833334,3322134.566666667,168612,0,124,0.9504450997748134,32346801,3686846291,569131,569131,302107880.58334506,3317954.8666665335,170055,0,105,0.45981856549722405,3346604961,-351090,-351090,33262458.29998833,4179.700000133365,-1443,0,19,0.49062653427758934,-3314258160,1538.1067729616605,530.8230979921057,1007.2836749695548,0.7733041033567082,0.29879764061349673,-1443
522,2018-06-07,2018,217183,217183,335805459.83333355,3317974.916666665,168545,0,112,0.9057062477265702,32510147,3690647258,588221,588221,302686979.6666686,3320328.2833330566,171671,0,75,0.3732984711528586,3356445946,-371038,-371038,33118480.166664958,-2353.366666391492,-3126,0,37,0.5324077765737116,-3323935799,1546.1866713017757,514.5803697363212,1031.6063015654545,0.7760506116961272,0.2918477919013432,-3126
523,2018-06-08,2018,221595,221595,336285228.23333377,3329771.766666669,169855,0,134,0.931541776664636,31796725,3696566880,600981,600981,299930524.55000854,3325377.399999911,171204,0,100,0.4199350728225968,3312452943,-379386,-379386,36354703.68332523,4394.366666757967,-1349,0,34,0.5116067038420392,-3280656218,1517.5668595109717,499.06823102562066,1018.498628485351,0.7665109772332408,0.28487423063291517,-1349
524,2018-06-09,2018,217311,217311,336529965.2499996,3295321.166666664,167801,0,128,0.9581705482005052,32651401,3702336476,610589,610589,300320237.5333456,3290943.9666665075,169445,0,89,0.4464083041129132,3321792491,-393278,-393278,36209727.716654,4377.2000001566485,-1644,0,39,0.511762244087592,-3289141090,1548.609896645819,491.85333756970005,1056.756559076119,0.7721698395387256,0.27751073144128047,-1644
525,2018-06-10,2018,211919,211919,336521523.8166665,3250333.650000003,166282,0,140,0.9261746233230626,31485845,3701400886,619505,619505,300566591.1666738,3246372.8166665696,167550,0,85,0.3755692044454852,3333589924,-407586,-407586,35954932.649992704,3960.8333334336057,-1268,0,55,0.5506054188775773,-3302104079,1587.9724036856842,485.1721796703397,1102.8002240153446,0.7846488516838981,0.27045786555395035,-1268
526,2018-06-11,2018,214431,214431,336776357.56666696,3280771.7166666654,165308,0,138,0.9108058069961888,30727782,3704546101,635044,635044,301013677.8333422,3276891.1999998996,166406,0,109,0.36124898432233965,3341268532,-420613,-420613,35762679.733324766,3880.5166667657904,-1098,0,29,0.5495568226738492,-3310540750,1570.558163542897,474.00444352413723,1096.5537200187598,0.7709146531984647,0.2620385359124722,-1098
527,2018-06-12,2018,214695,214695,337261587.69999963,3279154.2166666677,165443,0,129,0.8972542443932089,30707420,3709100642,646242,646242,301702074.8333519,3280406.4666664787,168331,0,94,0.34678340312142664,3342457664,-431547,-431547,35559512.86664772,-1252.2499998109415,-2888,0,35,0.5504708412717823,-3311750244,1570.8870150678854,466.8561851958739,1104.0308298720115,0.7705954959360954,0.2604767254372201,-2888
528,2018-06-13,2018,210361,210361,337629549.1499994,3235892.6000000006,163432,0,133,0.8941058466160555,30369490,3712915021,656145,656145,301536972.76667464,3233663.3166665416,164282,0,90,0.32407470909631325,3339688973,-445784,-445784,36092576.38332474,2229.2833334589377,-850,0,43,0.5700311375197422,-3309319483,1605.00068525059,459.5584402329891,1145.442245017601,0.776912070203127,0.25037453611625476,-850
529,2018-06-14,2018,209899,209899,337634554.4000003,3230134.3833333296,162391,0,128,0.927250725348859,29599817,3714231231,665716,665716,301648595.78334224,3230389.9666665397,163560,0,101,0.34864717086565805,3337580064,-455817,-455817,35985958.61665803,-255.5833332100883,-1169,0,27,0.5786035544832009,-3307980247,1608.5572318114916,453.1190414280898,1155.438190383402,0.7736625710460745,0.24569035444543919,-1169
530,2018-06-15,2018,212509,212509,337813289.4666663,3248974.633333333,164652,0,126,0.9120225496331908,30706095,3716649179,678892,678892,302005564.16667837,3244257.5833332073,165611,0,89,0.32356251067916436,3342352807,-466383,-466383,35807725.29998791,4717.050000125542,-959,0,37,0.5884600389540264,-3311646712,1589.6422714645794,444.8506745795773,1144.791596885002,0.7748001261123059,0.24394307194664247,-959
531,2018-06-16,2018,212667,212667,338201106.9666666,3271740.8333333335,165335,0,121,0.9263449430330045,30559121,3720706022,691001,691001,302531214.48334205,3267186.266666504,166627,0,87,0.3418041363181801,3349336262,-478334,-478334,35669892.48332453,4554.5666668294,-1292,0,34,0.5845408067148244,-3318777141,1590.2848442243817,437.81588519168866,1152.468959032693,0.777436085523377,0.24113858011782907,-1292
532,2018-06-17,2018,215340,215340,338539624.59999967,3258246.899999997,165507,0,135,0.931526887712455,31291638,3724693884,703246,703246,303001427.2666745,3252806.216666552,167028,0,86,0.35387759048753265,3360667963,-487906,-487906,35538197.33332515,5440.68333344534,-1521,0,49,0.5776492972249223,-3329376325,1572.1167669731572,430.8612167956512,1141.255550177506,0.7685845639453887,0.23751006049092352,-1521
533,2018-06-18,2018,210278,210278,338931616.7833333,3253317.4000000004,162810,0,132,0.9358325645098402,31363350,3729732812,714088,714088,303555982.416671,3248585.5833326504,164220,0,91,0.3407283135972065,3369339255,-503810,-503810,35375634.36666232,4731.816667350009,-1410,0,41,0.5951042509126336,-3337975905,1611.826328875742,425.09604196775604,1186.730286907986,0.774260740543471,0.22997165615442355,-1410
534,2018-06-19,2018,212851,212851,339293536.1000004,3279004.1666666674,165422,0,136,0.9435473641185617,31202382,3732725113,725065,725065,304136327.5833347,3274035.116666476,166729,0,96,0.33203505892575014,3372913618,-512214,-512214,35157208.5166657,4969.050000191666,-1307,0,40,0.6115123051928115,-3341711236,1594.04248089039,419.46077604536794,1174.581704845022,0.7771727640462107,0.22995041823836485,-1307
535,2018-06-20,2018,215209,215209,340015247.8999995,3342694.3166666636,168414,0,123,0.9448861339442113,31702232,3740358690,736490,736490,304998058.00000477,3336530.133332717,170013,0,82,0.345768442205583,3380121993,-521281,-521281,35017189.89999473,6164.183333946392,-1599,0,41,0.5991176917386283,-3348419761,1579.9304299541352,414.12382788633215,1165.806602067803,0.782560208913196,0.23084223818381783,-1599
536,2018-06-21,2018,215418,215418,340507541.75,3334586.3166666673,167771,0,115,0.9333667567241365,30091915,3744464234,745565,745565,305645257.1833268,3328684.9333333075,169257,0,89,0.32886602777759005,3386634917,-530147,-530147,34862284.56667322,5901.383333359845,-1486,0,26,0.6045007289465465,-3356543002,1580.6828665663966,409.95118760044636,1170.7316789659503,0.7788160692235561,0.2270184356830055,-1486
537,2018-06-22,2018,221190,221190,340906348.4666664,3352765.483333334,170607,0,871,0.9401690854016902,32486790,3749530525,760960,760960,306220996.7999988,3347426.599999942,172268,0,871,0.3452835891505438,3395794361,-539770,-539770,34685351.66666758,5338.883333391976,-1661,0,0,0.5948854962511464,-3363307571,1541.237616830175,402.41405172413636,1138.8235651060386,0.7713142547131425,0.22638246425567704,-1661
538,2018-06-23,2018,221717,221717,341079682.9500002,3373432.0666666673,170405,0,225,0.9295182597635717,32618376,3753543653,774629,774629,306492289.48333687,3363022.66666596,171446,0,225,0.31014201637170147,3403755062,-552912,-552912,34587393.46666336,10409.400000707246,-1041,0,0,0.6193762433918703,-3371136686,1538.3560256994288,395.6633297789482,1142.6926959204807,0.7685698435392866,0.22132659634483087,-1041
539,2018-06-24,2018,221877,221877,341247491.49999994,3348552.633333335,170954,0,122,0.9162869517795899,33215758,3758216170,786161,786161,306877821.3833306,3343590.949999923,172294,0,92,0.3051003547619375,3412513677,-564284,-564284,34369670.11666936,4961.683333412278,-1340,0,30,0.6111865970176524,-3379297919,1538.0029994095826,390.3498410418866,1147.653158367696,0.7704899561468742,0.21915867106101677,-1340
540,2018-06-25,2018,216129,216129,341351708.0000002,3333949.2166666645,169235,0,634,0.9341735722647131,30572288,3758962609,794247,794247,307161545.43332934,3329574.8833332723,170409,0,634,0.28606718061257896,3418894927,-578118,-578118,34190162.566670835,4374.333333392162,-1174,0,0,0.6481063916521341,-3388322639,1579.3887354311553,386.73302566245684,1192.6557097686984,0.7830277288101087,0.21455416262195515,-1174
541,2018-06-26,2018,218873,218873,341254464.3000002,3346104.9333333313,169025,0,229,0.8993891434758975,33047499,3760909205,804367,804367,307311993.5000024,3342126.383333142,170119,0,229,0.26954735835756727,3422668257,-585494,-585494,33942470.79999781,3978.550000189338,-1094,0,0,0.6298417851183302,-3389620758,1559.1437239860568,382.05445213441425,1177.0892718516425,0.772251488306004,0.21149425573152553,-1094
542,2018-06-27,2018,221038,221038,342001057.05000037,3364335.1666666637,171200,0,114,0.921533853907473,32596638,3769063594,817608,817608,308193591.11666274,3360515.9166666805,172623,0,84,0.29785422843220727,3431218460,-596570,-596570,33807465.93333763,3819.249999983236,-1423,0,30,0.6236796254752657,-3398621822,1547.2500522534604,376.9454201972862,1170.3046320561741,0.7745274568173798,0.2111317403939296,-1423
543,2018-06-28,2018,222206,222206,342655076.2166665,3364600.6333333333,171661,0,111,0.9176349873540771,32582938,3774869150,829684,829684,309001374.00000244,3361681.516666276,172936,0,85,0.2854809783001779,3440416416,-607478,-607478,33653702.216664076,2919.1166670573875,-1275,0,26,0.6321540090538993,-3407833478,1542.0604133851764,372.4326056667387,1169.6278077184377,0.7725308947553171,0.20843598285612353,-1275
544,2018-06-29,2018,222156,222156,343010556.36666673,3368407.716666667,173871,0,103,0.9156718702173249,32241600,3779523409,841576,841576,309494433.7333455,3364009.83333273,175004,0,72,0.2743412359668058,3450455000,-619420,-619420,33516122.633321226,4397.883333936799,-1133,0,31,0.6413306342505191,-3418213400,1544.0076179201405,367.7557745626604,1176.25184335748,0.7826527305136931,0.20794794528361074,-1133
545,2018-06-30,2018,221451,221451,343204621.4499997,3359731.3333333335,172426,0,107,0.8932179127662554,32958590,3784371548,851309,851309,309774525.866663,3355178.4333333243,173450,0,75,0.25938995123980046,3458153374,-629858,-629858,33430095.58333671,4552.90000000922,-1024,0,32,0.6338279615264549,-3425194784,1549.7993752568275,363.8802430923002,1185.9191321645274,0.7786191979264036,0.20374505614295163,-1024
546,2018-07-01,2018,218197,218197,343197087.2333334,3316759.350000002,170109,0,123,0.9084130395926616,33432572,3787191259,493302,493302,309931701.8000065,3312464.016666482,171319,0,82,0.46928453563942035,3445858220,-275105,-275105,33265385.4333269,4295.333333519753,-1210,0,41,0.43912850395324127,-3412425648,1572.8772037806816,628.279840341224,944.5973634394576,0.7796120019981942,0.3472903008704607,-1210
547,2018-07-02,2018,218378,218378,343460536.6166663,3319999.9833333353,169345,0,107,0.90716097775417,34184873,3794593491,515408,515408,310253656.7000004,3317319.8833330227,171836,0,82,0.4451677117933788,3455378032,-297030,-297030,33206879.91666591,2680.100000312552,-2491,0,25,0.46199326596079127,-3421193159,1572.779934868285,601.9573943361383,970.8225405321466,0.7754673089780106,0.3333980070158011,-2491
548,2018-07-03,2018,221888,221888,343546953.2499998,3344451.3000000017,172376,0,119,0.8950416426305161,34035347,3795812480,527358,527358,308139365.0333446,3340272.4999998305,173587,0,80,0.42262372050864366,3418121181,-305470,-305470,35407588.216655195,4178.800000171177,-1211,0,39,0.47241792212187245,-3384085834,1548.2899176611616,584.3077473620285,963.982170299133,0.7768603980386501,0.32916349045619864,-1211
549,2018-07-04,2018,222608,222608,340772798.9000001,3370950.9333333373,172385,0,119,0.9075325235391377,34603598,3763115918,544321,544321,305680275.18334144,3382654.0166665176,174736,0,91,0.4342566243080754,3393217021,-321713,-321713,35092523.71665865,-11703.083333180286,-2351,0,28,0.47327589923106234,-3358613423,1530.8200913713797,561.5808965359438,969.2391948354359,0.7743881621505068,0.3210164590379574,-2351
550,2018-07-05,2018,221219,221219,341315693.3333329,3356708.5999999973,171878,0,128,0.9427128772845018,35154943,3772110026,554934,554933,305802951.13334477,3352066.7166665224,173501,0,89,0.4523060399975487,3393779563,-333715,-333714,35512742.19998813,4641.883333474863,-1623,0,39,0.4904068372869531,-3358624620,1542.8859787510698,551.0628330507373,991.8231457003326,0.7769585795071852,0.312651594604043,-1623
551,2018-07-06,2018,216713,216713,341208963.7000002,3301330.116666668,169731,0,125,0.9346924273116978,34293909,3774758138,562827,562827,305953341.60000813,3297285.4166665324,171221,0,89,0.42432932322011246,3403980860,-346114,-346114,35255622.0999921,4044.7000001356937,-1490,0,36,0.5103631040915853,-3369686951,1574.473906503072,543.6010383297321,1030.8728681733398,0.7832063604859884,0.30421603796548496,-1490
552,2018-07-07,2018,217237,217237,341122598.5500001,3306927.3166666697,169911,0,125,0.929362861759277,33902090,3778233525,578683,578683,305926030.2333478,3304040.033333189,171854,0,85,0.39994262834747235,3412950072,-361446,-361446,35196568.3166523,2887.283333480824,-1943,0,40,0.5294202334118046,-3379047982,1570.2785370355882,528.6590935509558,1041.6194434846325,0.782145767065463,0.29697433655386457,-1943
553,2018-07-08,2018,216126,216126,341434210.2000005,3301295.233333333,171723,0,116,0.9229939942440982,33564706,3783697692,587891,587891,306082089.00000876,3296587.149999871,172803,0,79,0.38140233478655144,3417862804,-371765,-371765,35352121.19999176,4708.083333462011,-1080,0,37,0.5415916594575467,-3384298098,1579.7923905499595,520.644284399674,1059.1481061502855,0.7945504011548818,0.2939371414088666,-1080
554,2018-07-09,2018,217535,217535,341836885.53333354,3318728.8666666667,170692,0,125,0.9123221550555075,34502292,3792128068,599120,599120,306659735.6166785,3314085.966666504,171750,0,125,0.3643610628922425,3426371889,-381585,-381585,35177149.91665506,4642.900000162888,-1058,0,0,0.5479610921632649,-3391869597,1571.4109708016344,511.85027309500344,1059.560697706631,0.7846645367412141,0.28667044999332353,-1058
555,2018-07-10,2018,215272,215272,342005653.8000001,3324737.2666666647,169766,0,119,0.9151817235869043,34216651,3797567535,608242,608242,306994618.50001264,3320604.5166664524,170889,0,76,0.36263855504881604,3431706327,-392970,-392970,35011035.299987435,4132.750000212342,-1123,0,43,0.5525431685380883,-3397489676,1588.7140631387272,504.72446575542733,1083.9895973833,0.7886116169311382,0.2809556064855765,-1123
556,2018-07-11,2018,215529,215529,342359006.34999967,3326667.816666671,169656,0,109,0.9110050155663509,33081297,3803368605,618994,618994,307492510.95001036,3322038.149999855,170510,0,88,0.358257107500228,3439151511,-403465,-403465,34866495.39998931,4629.666666815989,-854,0,21,0.552747908066123,-3406070214,1588.4591231342401,496.7616987402307,1091.6974243940094,0.7871608925017051,0.27546309011072806,-854
557,2018-07-12,2018,221802,221802,342992942.19999975,3361389.0500000035,174115,0,113,0.9015112577884778,31078645,3808422643,634843,634843,308337382.55001366,3358325.8499998786,175075,0,73,0.35512087240467227,3446423918,-413041,-413041,34655559.64998609,3063.2000001249835,-960,0,40,0.5463903853838056,-3415345273,1546.392468057095,485.6907653546053,1060.7017027024897,0.7850019386660174,0.27577684561379745,-960
558,2018-07-13,2018,226899,226899,343575475.53333324,3416231.7000000016,177971,0,114,0.9079634551055756,35828842,3816818032,649503,649503,309104195.3833422,3412080.1166665694,179100,0,79,0.36013690467942194,3458721297,-422604,-422604,34471280.149991035,4151.583333432209,-1129,0,35,0.5478265504261537,-3422892455,1514.2220791335935,475.90880316694796,1038.3132759666455,0.7843622052102477,0.2757493036983663,-1129
559,2018-07-14,2018,225275,225275,344034648.933333,3420498.766666665,176465,0,94,0.8791787814892911,36066782,3825308115,660655,660655,309707532.7333424,3418039.8833331624,177275,0,72,0.3208770084234593,3468840725,-435380,-435380,34327116.19999057,2458.883333502803,-810,0,22,0.5583017730658317,-3432773943,1527.1763352938985,468.78860030324813,1058.3877349906504,0.783331483742093,0.26833218548258925,-810
560,2018-07-15,2018,222999,222999,344853134.58333266,3391816.383333333,175140,0,105,0.8996497742142343,36148078,3837341951,671333,671333,310693999.9166749,3388500.949999848,176091,0,76,0.32871019300406223,3485373642,-448334,-448334,34159134.666657746,3315.4333334849216,-951,0,29,0.5709395812101721,-3449225564,1546.433547160896,462.8016199362685,1083.6319272246276,0.7853846878237122,0.2623005274580573,-951
561,2018-07-16,2018,226068,226068,345611069.5666665,3402336.950000001,175649,0,119,0.9187501105861953,36033392,3850703347,690119,690119,311647863.5666779,3399335.44999984,177179,0,82,0.3590105474563067,3502206041,-464051,-464051,33963205.999988556,3001.500000161119,-1530,0,37,0.5597395631298886,-3466172649,1528.7925295338857,451.58568821707263,1077.206841316813,0.7769741847585682,0.256736881610273,-1530
562,2018-07-17,2018,224565,224565,346091768.15000015,3423072.6833333317,175768,0,113,0.9327544363547293,36139556,3858272647,700813,700813,312249855.2166766,3420023.6666665017,177143,0,87,0.3511592964171659,3508221973,-476248,-476248,33841912.93332356,3049.0166668300517,-1375,0,26,0.5815951399375634,-3472082417,1541.1652223187057,445.5537428910089,1095.6114794276968,0.7827043395008126,0.252767856760648,-1375
563,2018-07-18,2018,224563,224563,346793219.8166668,3450617.1500000004,177192,0,126,0.949359422522854,35963805,3867474839,717013,717013,313152943.6166702,3460092.0499995346,179897,0,85,0.3654215474475309,3519715889,-492450,-492450,33640276.19999659,-9474.899999534246,-2705,0,41,0.583937875075323,-3483752084,1544.302577969954,436.74653544171474,1107.5560425282392,0.7890525153297738,0.2508978219362829,-2705
564,2018-07-19,2018,231380,231380,347227461.11666644,3482438.750000001,180236,0,127,0.9488417322154031,35992829,3876680785,730988,730988,312839805.7333298,3476855.4999999823,181920,0,87,0.36740958811908836,3521205122,-499608,-499608,34387655.38333666,5583.250000018626,-1684,0,40,0.5814321440963148,-3485212293,1500.6805303685126,427.968456025721,1072.7120743427915,0.7789610165096378,0.2488686544785961,-1684
565,2018-07-20,2018,232531,232531,347761454.01666635,3483192.883333334,182666,0,122,0.9325982342139325,36007579,3883859658,743402,743402,313542845.5666594,3483941.499999939,184504,0,84,0.3318742752911545,3530963329,-510871,-510871,34218608.45000696,-748.6166666052304,-1838,0,38,0.600723958922778,-3494955750,1495.5487828146197,421.76755721219394,1073.7812256024258,0.7855554743238536,0.24818873234131736,-1838
566,2018-07-21,2018,224152,224152,347711080.7333334,3434609.0999999978,177180,0,122,0.9215487704771762,34716492,3887641191,749861,749861,313194783.8333303,3429114.9999999716,178497,0,72,0.3156585020423785,3533537890,-525709,-525709,34516296.900003135,5494.10000002617,-1317,0,50,0.6058902684347978,-3498821398,1551.2289907443762,417.6704533684647,1133.5585373759116,0.7904457689425033,0.23804011676830772,-1317
567,2018-07-22,2018,219832,219832,347408648.2333333,3349964.0000000056,172432,0,237,0.9059509079660828,34519279,3889406571,756467,756467,313074357.0999971,3344730.5833332925,173366,0,237,0.2946143057132698,3546235420,-536635,-536635,34334291.13333619,5233.416666713078,-934,0,0,0.611336602252813,-3511716141,1580.3370220592692,413.8638659716777,1166.4731560875916,0.7843807998835475,0.22917853653893694,-934
568,2018-07-23,2018,224183,224183,347828437.2499999,3413332.9666666654,176814,0,300,0.9110191227702367,34334286,3895163041,774471,774471,313684306.40001345,3408071.616665908,177799,0,300,0.2899269307695149,3554852158,-550288,-550288,34144130.849986434,5261.350000757258,-985,0,0,0.6210921920007217,-3520517872,1551.5379723261794,405.0304096602887,1146.5075626658909,0.7887038713907835,0.22957476780925304,-985
569,2018-07-24,2018,228091,228091,348105113.8833338,3458647.5166666647,180109,0,112,0.9259374547877817,35635817,3901466574,783111,783111,314113111.1833298,3454436.8333332874,181302,0,75,0.31307183783652565,3558299173,-555020,-555020,33992002.70000398,4210.683333377354,-1193,0,37,0.6128656169512561,-3522663356,1526.1676869465862,401.1093078546079,1125.0583790919782,0.7896365924126774,0.23151507257591836,-1193
570,2018-07-25,2018,231988,231988,348883900.6333332,3521561.149999998,183596,0,117,0.9330827456592581,35637196,3910400831,794749,794749,315061355.8666705,3517843.9666660116,184932,0,81,0.32490509582270705,3566823964,-562761,-562761,33822544.76666272,3717.183333986439,-1336,0,36,0.608177649836551,-3531186768,1503.887703818013,396.42875406785095,1107.458949750162,0.7914030036036347,0.23269233430932282,-1336
571,2018-07-26,2018,231059,231059,349563143.0833338,3510405.5000000056,182142,0,111,0.9107457402654726,34183709,3916939429,803367,803367,315962975.3333286,3509861.9166666493,183279,0,91,0.28556935995628235,3575664898,-572308,-572308,33600167.750005186,543.583333356306,-1137,0,20,0.6251763803091903,-3541481189,1512.87395463208,393.298424422871,1119.575530209209,0.7882921678012975,0.2281385717859957,-1137
572,2018-07-27,2018,232077,232077,350072620.76666677,3511302.649999996,182804,0,120,0.9143258487484766,32994301,3919628565,815292,815291,316511096.98333144,3507511.3833332704,183922,0,93,0.29395725703184067,3578725986,-583215,-583214,33561523.78333533,3791.2666667257436,-1118,0,27,0.6203685917166359,-3545731685,1508.4330664678826,388.21855875182166,1120.2145077160608,0.7876868453142707,0.2255903406386914,-1118
573,2018-07-28,2018,225872,225872,350090973.61666644,3479319.399999999,178931,0,121,0.9393019055040018,33747107,3923164834,822658,822658,316640305.2166637,3472468.399999977,180063,0,77,0.3010169475043065,3589206523,-596786,-596786,33450668.400002718,6851.000000021886,-1132,0,44,0.6382849579996953,-3555459416,1549.9529539591736,384.89907740113597,1165.0538765580377,0.792178756109655,0.21887953438731525,-1132
574,2018-07-29,2018,223713,223713,350193961.63333315,3434842.733333335,177831,0,122,0.9274874504387317,32636292,3926124982,832646,832645,316929514.3166618,3429078.9499999853,178984,0,74,0.2760909197906472,3598914333,-608933,-608932,33264447.31667137,5763.783333349507,-1153,0,48,0.6513965306480844,-3566278041,1565.3715324247278,380.6298174091741,1184.7417150155536,0.7949068672808465,0.2149580974387675,-1153
575,2018-07-30,2018,225116,225116,350617738.98333335,3475048.4499999955,180166,0,108,0.9308401002149995,31782551,3930316499,843518,843518,317459843.31667656,3468523.216666192,181212,0,103,0.27929694446355513,3604875290,-618402,-618402,33157895.666656792,6525.233333803713,-1046,0,5,0.6515431557514444,-3573092739,1557.498085357475,376.35218610234347,1181.1458992551316,0.8003251656923541,0.2148288477542862,-1046
576,2018-07-31,2018,231257,231257,350980542.1166663,3510993.3999999994,183532,0,152,0.9509117561846783,32641171,3933459890,854117,854117,318050210.4333426,3506554.3166661863,184795,0,152,0.30202419574835837,3607097976,-622860,-622860,32930331.68332374,4439.08333381312,-1263,0,0,0.6488875604363199,-3574456805,1517.7077542157267,372.37311800765303,1145.3346362080738,0.7936278685618166,0.21635794627668106,-1263
577,2018-08-01,2018,242043,242043,351384626.23333323,3602122.7166666673,189180,0,247,0.909536735208207,33088847,3935176797,519255,519255,318703107.28334534,3596982.883333182,190616,0,250,0.4855109724509144,3590916203,-277212,-277212,32681518.94998789,5139.833333485294,-1436,0,-3,0.4240257627572926,-3557827356,1451.7446331161539,613.7699343932082,837.9746987229456,0.781596658444987,0.3670951651885875,-1436
578,2018-08-02,2018,242172,242172,350910908.166666,3598296.216666672,190072,0,209,0.8921303866673278,33976581,3926594785,533506,533506,318249077.20000994,3591228.1999998093,191146,0,209,0.4351122574066625,3589556973,-291334,-291334,32661830.96665603,7068.016666862648,-1074,0,0,0.4570181292606653,-3555580392,1449.0151964994548,596.5238951389674,852.4913013604873,0.784863650628479,0.35828275595775866,-1074
579,2018-08-03,2018,240844,240844,348982238.9833334,3538929.4333333303,188976,0,208,0.9099084884821718,34586776,3902904225,551304,551304,316481851.20001733,3533470.0833332017,190086,0,208,0.4460243350311234,3574846663,-310460,-310460,32500387.783316076,5459.350000128616,-1110,0,0,0.4638841534510484,-3540259887,1448.9970229000241,574.0605023725882,874.936520527436,0.7846406802743685,0.3447934352009055,-1110
580,2018-08-04,2018,231470,231470,348647008.36666685,3516502.03333333,184461,0,153,0.9192076727005662,34007432,3902106114,561433,561433,316371452.50001097,3513667.7666665027,185914,0,153,0.42001806092622873,3577838914,-329963,-329963,32275555.866655886,2834.2666668272577,-1453,0,0,0.4991896117743375,-3543831482,1506.2297851413439,563.5070480360274,942.7227371053165,0.7969110467879207,0.33114191720116204,-1453
581,2018-08-05,2018,233076,233076,348463579.84999985,3513954.849999996,184109,0,91,0.8957679040313038,34039510,3903157945,589655,589655,316016409.93335104,3533764.933333224,191670,0,92,0.389027482171779,3572070341,-356579,-356579,32447169.916648805,-19810.08333322825,-7561,0,-1,0.5067404218595248,-3538030831,1495.0641844291126,535.9344191660396,959.1297652630731,0.7899097290154284,0.32505448101008216,-7561
582,2018-08-06,2018,236228,236228,348416313.24999976,3501230.7833333323,186247,0,107,0.9105059518769999,33998803,3903411373,599576,599576,307197875.9500176,3501623.083333212,190637,0,107,0.41027325977024026,3394455036,-363348,-363348,41218437.29998219,-392.2999998796731,-4390,0,0,0.5002326921067597,-3360456233,1474.91539212117,512.3585266088329,962.5568655123371,0.7884205089997799,0.3179530201342282,-4390
583,2018-08-07,2018,234070,234070,346872035.0333332,3421123.0833333298,183122,0,111,0.9102405263382753,33337765,3886550763,609395,609395,303049693.4000209,3419595.1666666474,189039,0,68,0.4099426480361704,3327601331,-375325,-375325,43822341.633312285,1527.916666682344,-5917,0,43,0.5002978783021049,-3294263566,1481.9158159240108,497.2959958647854,984.6198200592253,0.782338616653138,0.31020766497920066,-5917
584,2018-08-08,2018,234493,234493,346783551.7166671,3510234.883333338,184404,0,107,0.9185135590401418,33917895,3884752863,613587,613587,300921298.4166804,3506372.0499999053,185730,0,70,0.3908133646899214,3288474082,-379094,-379094,45862253.29998672,3862.8333334326744,-1326,0,37,0.5277001943502204,-3254556187,1478.8652612942267,490.42971643251957,988.4355448617071,0.786394476594184,0.30269546127932956,-1326
585,2018-08-09,2018,234296,234296,347322591.2333334,3518681.950000002,184105,0,113,0.9172585106019735,33954395,3891583310,621210,621210,301596210.26667714,3514557.933333177,185456,0,66,0.3821718903430363,3295954129,-386914,-386914,45726380.96665627,4124.016666824929,-1351,0,47,0.5350866202589373,-3261999734,1482.4093933884208,485.49799627610173,996.911397112319,0.7857795267524841,0.29853994623396274,-1351
586,2018-08-10,2018,236037,236037,347176900.28333336,3513019.633333332,184318,0,115,0.9356372094205572,34160744,3892468921,635283,635283,301704790.5500122,3508967.733333162,186263,0,79,0.42736071955332305,3305507465,-399246,-399246,45472109.73332119,4051.9000001698732,-1945,0,36,0.5082764898672341,-3271346721,1470.8579599102402,474.9139998237198,995.9439600865204,0.7808860475264471,0.29319689020483786,-1945
587,2018-08-11,2018,237669,237669,346926568.31666607,3539064.0166666666,186777,0,108,0.9331675565597535,34926184,3892546520,651487,651487,301765939.16667944,3533472.099999343,188261,0,76,0.38910523157023597,3314338210,-413818,-413818,45160629.149986625,5591.9166673235595,-1484,0,32,0.5440623249895176,-3279412026,1459.704750374117,463.1956419186867,996.5091084554304,0.7858702649483105,0.2889712304313056,-1484
588,2018-08-12,2018,227754,227754,346621954.9499999,3464066.000000001,180101,0,120,0.9613706016140224,33392765,3891810780,654348,654348,301646199.73335034,3458334.0666665444,181899,0,79,0.4071931143672824,3322800537,-426594,-426594,44975755.21664959,5731.933333456516,-1798,0,41,0.55417748724674,-3289407772,1521.9137971232117,460.9874252436782,1060.9263718795335,0.7907698657323252,0.27798510884116706,-1798
589,2018-08-13,2018,230867,230867,346873943.6666668,3464667.716666667,182309,0,133,0.9584392745606782,33625834,3895788613,672469,672469,302118098.3833463,3460503.566666557,184090,0,82,0.40023406283412255,3331031308,-441602,-441602,44755845.28332049,4164.150000109803,-1781,0,51,0.5582052117265557,-3297405474,1502.4838702225386,449.26695265260753,1053.216917569931,0.7896711093400096,0.27375239602122925,-1781
590,2018-08-14,2018,231141,231141,346835249.7333331,3469038.299999997,181594,0,122,0.9373196447190244,33680047,3897301258,681404,681404,302316182.48334366,3464402.1999998693,183035,0,79,0.36804744322017896,3331745832,-450263,-450263,44519067.24998945,4636.100000127684,-1441,0,43,0.5692722014988454,-3298065785,1500.5353863370544,443.66658030088416,1056.8688060361703,0.785641664611644,0.2686145076929399,-1441
591,2018-08-15,2018,234893,234893,347025244.316666,3493511.316666668,184599,0,123,0.944489618677441,34898491,3901193809,696938,696938,302715003.1500096,3488277.933333213,186285,0,81,0.37397444248984996,3339352652,-462045,-462045,44310241.166656435,5233.38333345484,-1686,0,42,0.5705151761875911,-3304454161,1477.3758448172828,434.34997539237287,1043.0258694249098,0.7858854882861558,0.2672906341740585,-1686
592,2018-08-16,2018,234928,234928,347289549.5666662,3513322.199999999,185393,0,131,0.9626694136075732,34060686,3903730937,707689,707689,303267627.58332825,3509052.633333281,187191,0,114,0.38589973844442976,3347177489,-472761,-472761,44021921.98333794,4269.566666717641,-1798,0,17,0.5767696751631435,-3313116803,1478.2807905684558,428.53234624719084,1049.748444321265,0.7891481645440305,0.2645102580370756,-1798
593,2018-08-17,2018,235781,235781,347204077.26666677,3497577.3166666655,186376,0,126,0.9538597257624649,33923440,3904549546,721590,721590,303502603.1333472,3491358.283332739,187816,0,124,0.3488615418728096,3353757286,-485809,-485809,43701474.13331956,6219.033333926462,-1440,0,2,0.6049981838896553,-3319833846,1472.5702124711777,420.60256258172535,1051.9676498894523,0.7904623358116218,0.26028076885766155,-1440
594,2018-08-18,2018,236010,236010,347032318.58333313,3521349.249999994,186671,0,135,0.9617304351510525,35155729,3904933809,733649,733649,303487747.7833292,3515978.4666666267,188272,0,114,0.3591254128336583,3361201830,-497639,-497639,43544570.800003946,5370.783333367202,-1601,0,21,0.6026050223173942,-3326046101,1470.413620538677,413.66886315299166,1056.7447573856853,0.7909452989280116,0.2566240804526415,-1601
595,2018-08-19,2018,230009,230009,347238344.1833337,3484902.9999999986,182671,0,128,0.9480150776708737,34692334,3906111758,738270,738270,303905707.2166653,3479212.3666666304,184021,0,86,0.33301773064055346,3371821583,-508261,-508261,43332636.96666837,5690.633333368227,-1350,0,42,0.6149973470303203,-3337129249,1509.6728570766088,411.6457491387505,1098.0271079378583,0.7941906621045264,0.24925975591585733,-1350
596,2018-08-20,2018,235883,235883,347737014.8666663,3537443.983333335,186105,0,169,0.9109770521826499,34930262,3912022090,755053,755052,304666376.8833461,3533127.0333327237,187135,0,169,0.30159604690001135,3381373629,-519170,-519169,43070637.983320236,4316.950000611134,-1030,0,0,0.6093810052826385,-3346443367,1474.1927772101692,403.50383401851275,1070.6889431916566,0.7889716511999593,0.24784352886486113,-1030
597,2018-08-21,2018,244839,244839,348469868.1833335,3629750.9,194940,0,116,0.9126732260791787,36123540,3920917420,767350,767350,305576587.14999723,3629396.133333276,196129,0,108,0.31306704893464615,3385161366,-522511,-522511,42893281.03333628,354.7666667238809,-1189,0,8,0.5996061771445325,-3349037826,1423.2612785680938,398.22321906561183,1025.038059502482,0.7961966843517577,0.2555926239655959,-1189
598,2018-08-22,2018,240868,240868,349073337.48333395,3631789.0333333407,190795,0,143,0.9007838318082935,35944663,3929899403,773322,773322,306354067.6666621,3630412.11666659,191869,0,144,0.29476466465456547,3396586131,-532454,-532454,42719269.81667185,1376.9166667507961,-1074,0,-1,0.6060191671537281,-3360641468,1449.2308545897918,396.15330698811374,1053.077547601678,0.792114353089659,0.24811010161355812,-1074
599,2018-08-23,2018,246004,246004,349834982.23333365,3591784.366666663,192162,0,76,0.8874002048747175,36238211,3940601807,791320,791320,307313354.35000736,3588379.0166660706,193182,0,71,0.289550371531103,3409486537,-545316,-545316,42521627.88332629,3405.3500005924143,-1020,0,5,0.5978498333436144,-3373248326,1422.0703006184194,388.35534846839124,1033.7149521500282,0.7811336401034129,0.2441262700298236,-1020
600,2018-08-24,2018,238090,238090,350235936.8833332,3538075.2666666685,187044,0,69,0.8722079885757494,35586734,3949387481,801340,801340,307867124.3833256,3532978.5999999996,187815,0,58,0.2664162527765964,3416754629,-563250,-563250,42368812.50000763,5096.66666666884,-771,0,11,0.605791735799153,-3381167895,1471.0232974225428,384.1903865816327,1086.83291084091,0.7856020832458314,0.23437616991539173,-771
601,2018-08-25,2018,242928,242928,349931508.5999991,3602799.016666668,189314,0,194,0.8773916551406185,36595225,3949905004,815393,815393,307875452.28332806,3597208.083333277,190262,0,194,0.271527962589821,3428456920,-572465,-572465,42056056.31667107,5590.933333390858,-948,0,0,0.6058636925507974,-3391861695,1440.47416765461,377.5792192026766,1062.8949484519335,0.7793008628070869,0.2333377892623557,-948
602,2018-08-26,2018,237619,237619,350206757.16666615,3570985.916666666,186907,0,81,0.8792436631750831,36298585,3954336959,820766,820766,308411540.96666527,3564840.8666666453,187652,0,82,0.2609635389380227,3439773169,-583147,-583147,41795216.20000088,6145.0500000207685,-745,0,-1,0.6182801242370604,-3403474584,1473.8163074782158,375.7606199168402,1098.0556875613756,0.7865827227620686,0.22863032825433802,-745
603,2018-08-27,2018,236352,236352,350727720.98333347,3556563.950000002,185483,0,89,0.8769674045491481,36381119,3963393861,835995,835995,309173239.0833432,3553364.549999433,186851,0,73,0.25781733144336233,3452232562,-599643,-599643,41554481.89999026,3199.400000568945,-1368,0,16,0.6191500731057857,-3415851443,1483.9211048915747,369.8266605462272,1114.0944443453475,0.7847744042783644,0.22350731762749776,-1368
604,2018-08-28,2018,237606,237606,351361816.4333335,3565719.749999998,187015,0,72,0.8768507529271141,35783192,3971236203,857382,857382,309119221.8166593,3567626.416666683,192588,0,61,0.25475692281853685,3444425321,-619776,-619776,42242594.616674244,-1906.6666666846722,-5573,0,11,0.6220938301085772,-3408642129,1478.7581813309996,360.53850187741205,1118.2196794535876,0.7870802925852041,0.22462333009090463,-5573
605,2018-08-29,2018,239147,239147,351824819.7000002,3558264.3833333324,186942,0,128,0.8680393230941632,36194004,3978677963,873332,873331,307823214.19999325,3562500.2833333137,193984,0,128,0.2512664141472014,3415322383,-634185,-634184,44001605.500006974,-4235.89999998128,-7042,0,0,0.6167729089469618,-3379128379,1471.1655161887886,352.47027095109786,1118.6952452376909,0.7817033038256804,0.22211942308308869,-7042
606,2018-08-30,2018,236551,236551,352480349.2166667,3569458.2333333287,187083,0,86,0.8900237158160392,36239642,3988228162,868414,868414,306655405.0333307,3564440.149999957,187834,0,78,0.2504876706271451,3396572559,-631863,-631863,45824944.18333602,5018.083333371673,-751,0,8,0.6395360451888941,-3360332917,1490.0818395046595,353.1212129621709,1136.9606265424886,0.7908780770320143,0.2162954535509561,-751
607,2018-08-31,2018,250946,250946,353014299.3833327,3664234.050000003,197033,0,92,0.8869358348011127,36238140,3993495371,888293,888293,307437925.8166611,3658833.0333332745,198037,0,58,0.25993675510220293,3409185015,-637347,-637347,45576373.56667161,5401.0166667285375,-1004,0,34,0.6269990796989098,-3372946875,1406.7341156397501,346.09968311881454,1060.6344325209357,0.7851609509615615,0.22294107912591904,-1004
608,2018-09-01,2018,253065,253065,353064031.2999996,3696508.7499999967,196968,0,75,0.8781656886570645,37310278,3995587096,553786,553786,307729893.3166778,3690557.133333181,198213,0,73,0.4160903309220598,3392824940,-300721,-300721,45334137.983321786,5951.616666815709,-1245,0,2,0.46207535773500463,-3355514662,1395.1515669887167,555.6837719203407,839.467795068376,0.7783296781459309,0.35792345779777746,-1245
609,2018-09-02,2018,242267,242267,353114611.20000046,3622905.0666666604,191685,0,80,0.8826212402019261,34796306,3992605378,562751,562750,307995948.8000108,3617937.233333163,192723,0,61,0.3921201383915872,3401748835,-320484,-320483,45118662.399989665,4967.833333497401,-1038,0,19,0.4905011018103389,-3366952529,1457.543170138733,547.3051067081489,910.2380634305842,0.7912138260679333,0.3424658507936903,-1038
610,2018-09-03,2018,248522,248522,353914973.2833333,3703187.1166666676,195365,0,192,0.8864969700871548,35789097,4002068753,584156,584156,309019846.7500101,3700712.3333331873,196335,0,192,0.3881788426379355,3414866783,-335634,-335634,44895126.53332323,2474.783333480358,-970,0,0,0.4983181274492193,-3379077686,1424.0790484678753,529.0022643780259,895.0767840898494,0.7861074673469552,0.33610028827915833,-970
611,2018-09-04,2018,248941,248941,354510391.2333339,3724366.3999999966,196846,0,165,0.8913115959203175,36690236,4011103882,593449,593449,309844439.48334205,3720137.433333186,197945,0,168,0.38353422113779234,3420365521,-344508,-344508,44665951.749991834,4228.96666681068,-1099,0,-3,0.5077773747825252,-3383675285,1424.0739421522926,522.107947748403,901.9659944038896,0.7907335473063899,0.33355014499982305,-1099
612,2018-09-05,2018,251993,251993,355227054.19999975,3758300.5500000003,198323,0,96,0.9035568448329906,35632711,4018944438,606669,606669,310707878.8166745,3753519.049999849,199428,0,85,0.3878622444858734,3430016943,-354676,-354676,44519175.38332528,4781.50000015134,-1105,0,11,0.5156946003471172,-3394384232,1409.6703249693435,512.1538743807158,897.5164505886277,0.7870178933541805,0.32872620819590254,-1105
613,2018-09-06,2018,245760,245760,355512200.7999999,3660755.950000002,194319,0,74,0.8958943684895821,34099865,4021570967,613855,613855,311279604.91668236,3655102.1833331664,195270,0,62,0.36874669099380286,3443374630,-368095,-368095,44232595.88331753,5653.76666683564,-951,0,12,0.5271476774957793,-3409274765,1446.5828483072912,507.08979305647483,939.4930552508164,0.79068603515625,0.3181044383445602,-951
614,2018-09-07,2018,244498,244498,355226673.6500001,3598678.4833333385,194278,0,94,0.8951606966110152,35226610,4022825354,628605,628605,311267550.38334846,3593073.1666665617,195175,0,68,0.3564448262422336,3456030057,-384107,-384107,43959123.26665163,5605.31666677678,-897,0,26,0.5387158703687815,-3420803447,1452.8817153923553,495.17192892730486,957.7097864650505,0.7945995468265589,0.31048909887767356,-897
615,2018-09-08,2018,235705,235705,354625560.5333334,3579986.9499999997,188203,0,219,0.8998748435544434,35361025,4022924763,633965,633965,310915693.4666792,3576560.3833331494,189132,0,219,0.34581404336201416,3465264006,-398260,-398260,43709867.066654205,3426.5666668503545,-929,0,0,0.5540608001924292,-3429902981,1504.5313444064973,490.430376230043,1014.1009681764542,0.7984684245136929,0.29833192684138715,-929
616,2018-09-09,2018,235090,235090,354592717.4499999,3555702.95,186557,0,184,0.8867540091028964,34780021,4024889920,643719,643719,311112878.6000113,3550542.8833331466,187333,0,184,0.32919177467186256,3474925304,-408629,-408629,43479838.84998864,5160.066666853614,-776,0,0,0.5575622344310338,-3440145283,1508.3275232889528,483.3054152510821,1025.0221080378706,0.7935556595346464,0.29101673245624254,-776
617,2018-09-10,2018,240261,240261,354751959.90000063,3591461.083333335,187861,0,71,0.8774707505587668,35479179,4026648700,661390,661389,311492666.5666779,3586633.6166664683,188818,0,56,0.32776727800541283,3484073731,-421129,-421128,43259293.333322704,4827.4666668665595,-957,0,15,0.549703472553354,-3448594552,1476.527442656114,470.967413378024,1005.56002927809,0.7819038462338873,0.28548662664993424,-957
618,2018-09-11,2018,244569,244569,355009036.7500002,3641946.5999999996,192887,0,70,0.8940748827529252,36282147,4030816065,675340,675340,311978808.45001054,3636066.9333331822,194052,0,50,0.3389803654455483,3487878535,-430771,-430771,43030228.29998964,5879.666666817386,-1165,0,20,0.5550945173073769,-3451596388,1451.5700548720408,461.9581373086305,989.6119175634103,0.7886813128401392,0.2873397103681109,-1165
619,2018-09-12,2018,244858,244858,355354528.43333304,3676161.7666666647,191731,0,87,0.8872530201177832,36027680,4035851186,685536,685536,312549193.9500108,3670689.6166665135,192732,0,52,0.32838538019884883,3494456875,-440678,-440678,42805334.48332226,5472.150000151247,-1001,0,35,0.5588676399189343,-3458429195,1451.2677896304513,455.9194468999597,995.3483427304916,0.7830293476218869,0.2811405965551043,-1001
620,2018-09-13,2018,245168,245168,355516439.3333335,3686262.5166666606,192489,0,79,0.8944519676303596,35661132,4035871478,696048,696048,313072237.8166613,3680025.933333328,193485,0,78,0.3248181159919997,3501993995,-450880,-450880,42444201.516672194,6236.583333332557,-996,0,1,0.5696338516383599,-3466332863,1450.093157889013,449.78541396090685,1000.307743928106,0.7851310122038765,0.27797651886076824,-996
621,2018-09-14,2018,242427,242427,355766059.9499998,3623577.049999996,191064,0,92,0.8961543062447669,35902536,4040805004,705180,705180,313555385.3833289,3618151.299999928,191983,0,77,0.31942057347060365,3511895373,-462753,-462753,42210674.566670895,5425.750000067987,-919,0,15,0.5767337327741633,-3475992837,1467.5183042730382,444.64588528223845,1022.8724189907998,0.7881300350208517,0.2722468022348904,-919
622,2018-09-15,2018,231626,231626,355193485.5666668,3528901.533333331,183992,0,195,0.9027742999490558,35456618,4039998220,712496,712496,313169452.11667347,3527395.3499994283,184902,0,195,0.3055638207091657,3522438805,-480870,-480870,42024033.44999331,1506.1833339026198,-910,0,0,0.59721047923989,-3486982187,1533.478476365636,439.5385407309984,1093.9399356346375,0.7943495117128474,0.25951303586265745,-910
623,2018-09-16,2018,238753,238753,354724904.966667,3522315.299999997,188921,0,141,0.8944264574685968,34807948,4039864667,742213,742213,312906904.79998916,3563579.716666673,191211,0,131,0.29837930620994313,3533396375,-503460,-503460,41818000.16667783,-41264.416666675825,-2290,0,10,0.5960471512586537,-3498588427,1485.7400952728008,421.5863974357619,1064.1536978370389,0.7912822037838269,0.25762281178044577,-2290
624,2018-09-17,2018,250727,250727,354930956.2666667,3659954.5666666627,194574,0,99,0.8923610141707916,36030696,4046943901,761823,761823,308456574.05001193,3659299.983332679,196432,0,69,0.3059542702176094,3486657682,-511096,-511096,46474382.21665478,654.5833339835517,-1858,0,30,0.5864067439531822,-3450626986,1415.6072392150295,404.8927034888838,1010.7145357261456,0.7760392777802151,0.2578446699561447,-1858
625,2018-09-18,2018,252447,252447,355490563.2499995,3719921.9333333294,195401,0,103,0.8956573062860714,37110341,4054989688,761380,761380,308156305.78334194,3712929.1833326193,196646,0,103,0.3146300139220851,3455227515,-508933,-508933,47334257.46665758,6992.7500007101335,-1245,0,0,0.5810272923639863,-3418117174,1408.1789969775816,404.73391182240397,1003.4450851551776,0.7740278157395414,0.2582757624313746,-1245
626,2018-09-19,2018,245077,245077,355949733.1833339,3670170.9500000007,191627,0,206,0.9077514413837283,36601476,4060189002,764531,764530,308886479.98332924,3663934.633333295,192737,0,206,0.30891880119969306,3463584753,-519454,-519453,47063253.20000464,6236.316666705534,-1110,0,0,0.5988326401840353,-3426983277,1452.3995853684103,404.0213987460652,1048.378186622345,0.7819052787491279,0.2520983452600352,-1110
627,2018-09-20,2018,244949,244949,356472374.50000024,3656609.9333333313,192831,0,95,0.9183136081388372,35794435,4066768542,775685,775685,309657137.7999961,3650569.833333267,193997,0,93,0.30785692645855195,3475661634,-530736,-530736,46815236.70000416,6040.100000064354,-1166,0,2,0.6104566816802852,-3439867199,1455.2922220543878,399.20475167109856,1056.0874703832892,0.787229178318752,0.25009765562051606,-1166
628,2018-09-21,2018,245429,245429,356874703.8500003,3658785.1166666704,194146,0,92,0.9245036242660803,35773946,4070255513,786321,786321,310322238.48332894,3652698.766666579,195310,0,70,0.30837406097509795,3486960074,-540892,-540892,46552465.36667138,6086.350000091363,-1164,0,22,0.6161295632909825,-3451186128,1454.0853112305406,394.6508340529236,1059.434477177617,0.7910475127226204,0.24838456559089736,-1164
629,2018-09-22,2018,242858,242858,356387663.7999998,3621280.0999999978,192263,0,105,0.9328002371756339,35977505,4068232060,795465,795465,310137505.0333295,3615051.8333333232,193437,0,105,0.30457153991690866,3493580133,-552607,-552607,46250158.76667029,6228.266666674521,-1174,0,0,0.6282286972587252,-3457602628,1467.4734363290472,389.88202502099966,1077.5914113080476,0.7916683823468859,0.24317474684618431,-1174
630,2018-09-23,2018,237115,237115,356613290.13333285,3512441.3166666664,187414,0,102,0.9179132488454967,35401415,4071724398,802673,802673,310524981.7999977,3507271.7499999967,188521,0,64,0.2882743034834845,3504435759,-565558,-565558,46088308.33333516,5169.566666669678,-1107,0,38,0.6296389453620123,-3469034344,1503.9676533890006,386.8636191824039,1117.1040342065967,0.7903928473525504,0.23486650229919281,-1107
631,2018-09-24,2018,227907,227907,356390794.2333332,3476844.1666666637,181692,0,72,0.8998231734874318,34510593,4075222124,811113,811113,310528241.2833321,3472271.100000003,182540,0,58,0.2611929533862728,3516956603,-583206,-583206,45862552.95000106,4573.06666666083,-848,0,14,0.638630220101159,-3482446010,1563.7553661508123,382.8421456484264,1180.913220502386,0.7972199186510287,0.22504879098226757,-848
632,2018-09-25,2018,229691,229691,356489411.7833338,3508171.433333335,182984,0,82,0.9069097178383132,35083237,4077192327,819860,819860,310903547.13332856,3503453.2833333304,184034,0,61,0.2682336008586882,3525765166,-590169,-590169,45585864.65000522,4718.1500000045635,-1050,0,21,0.638676116979625,-3490681929,1552.0390950595965,379.2154113303839,1172.8236837292127,0.7966528945409267,0.22447003146878736,-1050
633,2018-09-26,2018,234841,234841,356669044.3333337,3565166.716666667,185377,0,79,0.8932809858585169,36273250,4081814510,832510,832510,311357525.68333066,3558503.0833327738,186367,0,64,0.26456378902356126,3533835949,-597669,-597669,45311518.650003016,6663.633333893027,-990,0,15,0.6287171968349556,-3497562699,1518.768206289931,373.9985413788791,1144.769664911052,0.7893723838682343,0.2238615752363335,-990
634,2018-09-27,2018,239992,239992,357034136.2999997,3607315.7666666647,188250,0,74,0.8752583419447312,36624856,4086418442,845452,845452,311972050.550014,3601840.999999388,189156,0,61,0.25366431210760665,3542402470,-605460,-605460,45062085.749985695,5474.766667276621,-906,0,13,0.6215940298371245,-3505777614,1487.6918243108091,369.0003105439623,1118.6915137668468,0.7844011467048901,0.22373357683227432,-906
635,2018-09-28,2018,241837,241837,357424255.71666676,3631065.683333332,190653,0,72,0.892886531010556,36688364,4091816440,857998,857998,312637961.0833288,3629087.2666666675,191797,0,64,0.26013463900849,3549825634,-616161,-616161,44786294.633337975,1978.4166666646488,-1144,0,8,0.632751892002066,-3513137270,1477.9552165990594,364.38075739492257,1113.574459204137,0.7883533123550159,0.22354014811223336,-1144
636,2018-09-29,2018,246684,246684,357650031.6833331,3668212.0999999973,194339,0,74,0.8963248528481791,36543516,4095233079,871090,871090,313126041.6166605,3661222.0333332904,195268,0,59,0.26258480753997704,3559505685,-624406,-624406,44523990.06667262,6990.066666706931,-929,0,15,0.633740045308202,-3522962169,1449.8306808845855,359.4646266363527,1090.3660542482328,0.7878054515088129,0.22416512645076858,-929
637,2018-09-30,2018,246011,246011,357234234.0500002,3583190.0833333316,195817,0,75,0.9114185951034701,35654106,4094641632,893261,893261,312955575.3833321,3583491.0499999486,201385,0,64,0.27121412442724385,3571200326,-647250,-647250,44278658.66666812,-300.9666666169651,-5568,0,11,0.6402044706762262,-3535546220,1452.1067515273714,350.35177331522596,1101.7549782121455,0.7959684729544614,0.22544922480663546,-5568
638,2018-10-01,2018,241099,241099,357102652.44999945,3578770.500000002,191141,0,90,0.8957731056536952,35246021,4096066773,561713,561713,310071018.2500142,3573228.6333331764,192988,0,64,0.40073845540338043,3492980464,-320614,-320614,47031634.199985266,5541.866666825488,-1847,0,26,0.49503465025031473,-3457734443,1481.1453073218863,552.0096886666576,929.1356186552288,0.7927905134405369,0.34357047104126126,-1847
639,2018-10-02,2018,238889,238889,357282061.2500002,3628571.883333339,189026,0,74,0.8999158605042512,35538402,4098707645,567863,567863,310235490.43333334,3635666.7499998016,191888,0,54,0.39894481591511466,3490378016,-328974,-328974,47046570.81666684,-7094.866666462738,-2862,0,20,0.5009710445891365,-3454839614,1495.5986305355214,546.3210148104971,949.2776157250242,0.7912712598738326,0.3379124894560836,-2862
640,2018-10-03,2018,248486,248486,357761618.5833333,3679436.15,197328,0,83,0.8990244923255231,35446381,4102417821,584869,584869,310003195.0500101,3673541.4333331627,198445,0,56,0.3991885362363083,3486488512,-336383,-336383,47758423.53332323,5894.716666837223,-1117,0,27,0.4998359560892148,-3451042131,1439.7656953845824,530.0386839617249,909.7270114228575,0.7941211979749362,0.3392982018195528,-1117
641,2018-10-04,2018,248072,248072,357458595.6166667,3674326.9999999967,195904,0,76,0.8992913347737752,36395174,4102665984,591138,591138,310084843.6000129,3668470.0499998317,196759,0,59,0.39203197899642833,3495829210,-343066,-343066,47373752.016653776,5856.95000016503,-855,0,17,0.5072593557773468,-3459434036,1440.9469654643276,524.5557612605058,916.3912042038218,0.7897062143248734,0.33284782910251076,-855
642,2018-10-05,2018,246424,246424,357479902.2833337,3650918.533333332,195568,0,81,0.9035199493555821,35937759,4105645791,603659,603659,310471877.9500138,3645293.4666665196,196347,0,64,0.3811340508465864,3502699500,-357235,-357235,47008024.3333199,5625.06666681217,-779,0,17,0.5223858985089957,-3466761741,1450.6699927090451,514.3166555124893,936.3533371965558,0.7936239976625653,0.3252614472740405,-779
643,2018-10-06,2018,248466,248466,357202322.31666684,3556602.566666669,198491,0,67,0.8919369249716259,34674968,4106789333,619242,619242,310473134.13334703,3551023.1999998586,199391,0,54,0.3655226874146095,3511799732,-370776,-370776,46729188.18331981,5579.366666810587,-900,0,13,0.5264142375570164,-3477124764,1437.6305905704073,501.37609227627814,936.2544982941292,0.7988658407991436,0.3219920483429742,-900
644,2018-10-07,2018,235529,235529,356992523.09999996,3501770.516666666,185611,0,62,0.8826726220550335,34304005,4107272635,621481,621481,310418652.08334005,3495998.466666514,186440,0,48,0.34256719030830873,3519822836,-385952,-385952,46573871.016659915,5772.050000152085,-829,0,14,0.5401054317467248,-3485518831,1515.7051704885596,499.48212750404286,1016.2230429845167,0.7880600690360847,0.29999308104350736,-829
645,2018-10-08,2018,237043,237043,357530922.4666663,3552172.666666663,186706,0,63,0.8857295933649169,34060229,4114622580,633124,633123,311174895.2999996,3547062.183332735,187514,0,51,0.3390868139574636,3530378755,-396081,-396080,46356027.16666669,5110.483333927579,-808,0,12,0.5466427794074533,-3496318526,1508.2956360941528,491.49200913566494,1016.8036269584878,0.7876461232772113,0.29617262969023445,-808
646,2018-10-09,2018,239297,239297,357619687.65000105,3545608.2333333325,187878,0,80,0.8939769407890621,34253829,4115605243,643025,643025,311583037.81667805,3539793.766666471,188752,0,60,0.342775164262662,3535845471,-403728,-403728,46036649.833323,5814.466666861437,-874,0,20,0.5512017765264001,-3501591642,1494.4595529822816,484.558201962098,1009.9013510201836,0.7851247612799157,0.2935375762995218,-874
647,2018-10-10,2018,238200,238200,357803257.93333375,3500246.5333333383,186565,0,85,0.8826238455079766,33377286,4118553552,654319,654319,311994612.7500153,3496172.1999993552,187324,0,61,0.3296450202424187,3542083827,-416119,-416119,45808645.183318436,4074.333333983086,-759,0,24,0.5529788252655579,-3508706541,1502.11275370837,476.8234037984765,1025.2893499098936,0.7832283795130143,0.2862884923103257,-759
648,2018-10-11,2018,233066,233066,357991514.1833336,3509931.1000000024,183740,0,82,0.8911939107377307,34437862,4122853984,662654,662654,312318930.66667855,3505200.7666665213,184698,0,74,0.3261068370522184,3549176398,-429588,-429588,45672583.51665503,4730.333333481103,-958,0,8,0.5650870736855123,-3514738536,1536.0091741538172,471.31524244429,1064.693931709527,0.7883603786052019,0.27872464363000904,-958
649,2018-10-12,2018,235703,235703,358187714.5999998,3538515.46666667,186096,0,86,0.9021734980038435,34540123,4125361820,676436,676436,312792815.1000078,3534288.3833332,187221,0,65,0.3312804167726088,3555693746,-440733,-440733,45394899.49999201,4227.083333469927,-1125,0,21,0.5708930812312347,-3521153623,1519.6570030928744,462.4130222223651,1057.2439808705094,0.789535983844075,0.27677562991916455,-1125
650,2018-10-13,2018,236702,236702,358358528.10000014,3562533.3333333256,187899,0,77,0.9028567565969018,35797335,4128724256,686045,686045,313254623.5500129,3557217.233333169,188722,0,65,0.3212908774205726,3565856617,-449343,-449343,45103904.54998726,5316.100000156555,-823,0,12,0.5815658791763292,-3530059282,1513.9649352350218,456.609440415735,1057.3554948192868,0.7938209225101605,0.2750869112084484,-823
651,2018-10-14,2018,237992,237992,358433831.99999994,3565056.4166666674,187991,0,82,0.8953284144004833,35452331,4130303755,697039,697039,313600358.6999982,3559132.4499994004,189036,0,62,0.3173294464154911,3578523007,-459047,-459047,44833473.30000174,5923.966667267028,-1045,0,20,0.5779989679849922,-3543070676,1506.07512857575,449.9036046763498,1056.1715238994002,0.7899047026790816,0.2711985986436914,-1045
652,2018-10-15,2018,242090,242090,358916702.4999994,3601989.9833333315,190434,0,98,0.9046511627906983,36356411,4137941138,713161,713161,314263317.7000073,3595947.133332705,191752,0,66,0.3237585902762555,3593396381,-471071,-471071,44653384.799992085,6042.850000626408,-1318,0,32,0.5808925725144429,-3557039970,1482.5754987814425,440.66251197136035,1041.9129868100822,0.7866248089553471,0.26887617242109424,-1318
653,2018-10-16,2018,237370,237370,358938274.15000045,3549972.5499999984,188387,0,88,0.9058305598854113,35525349,4141432580,732059,732059,314565363.3333243,3582570.0500000077,193957,0,64,0.31332037445068767,3597840315,-494689,-494689,44372910.81667614,-32597.500000009313,-5570,0,24,0.5925101854347237,-3562314966,1512.1467504318173,429.69946866758596,1082.4472817642313,0.7936428360786957,0.2649472241991424,-5570
654,2018-10-17,2018,233558,233558,358427056.7833335,3502178.083333331,184551,0,88,0.8899374031289884,34830829,4140480139,734672,734672,309354205.7833303,3496593.1333333342,185389,0,58,0.29642752139729733,3518893778,-501114,-501114,49072851.00000316,5584.949999996927,-838,0,30,0.5935098817316911,-3484062949,1534.6383201745755,421.0779855273242,1113.5603346472512,0.790172034355492,0.25234254197791667,-838
655,2018-10-18,2018,233365,233365,358475369.16666657,3501430.6666666605,186285,0,83,0.914653011377027,34970452,4142555489,739226,739225,309518679.1666622,3495801.8499999978,187530,0,65,0.31018795334579685,3523480955,-505861,-505860,48956690.00000435,5628.816666662693,-1245,0,18,0.6044650580312302,-3488510503,1536.1145380269816,418.70699606569343,1117.4075419612882,0.7982559509780816,0.2536842589411087,-1245
656,2018-10-19,2018,239640,239640,358417088.16666687,3543970.6333333324,188189,0,87,0.9122684026039054,35302764,4142095633,752522,752522,309811428.03332835,3537973.216666649,189675,0,63,0.31327721980221024,3524144695,-512882,-512882,48605660.13333851,5997.416666683275,-1486,0,24,0.5989911828016952,-3488841931,1495.6480060368337,411.69750257577635,1083.9505034610575,0.7852987815055917,0.25205243168970476,-1486
657,2018-10-20,2018,240285,240285,358476031.01666605,3597686.449999998,190230,0,125,0.9413945939197208,35877557,4143264342,765070,765070,310211583.29999256,3591713.63333331,191794,0,125,0.3311252565124772,3526279807,-524785,-524785,48264447.71667349,5972.816666687839,-1564,0,0,0.6102693374072437,-3490402250,1491.878523489465,405.4682359783975,1086.4102875110675,0.7916848742118734,0.25068817232410107,-1564
658,2018-10-21,2018,240842,240842,358770906.9333339,3609861.266666662,189514,0,97,0.9329352853738131,36532966,4146472681,772551,772551,310810263.4666615,3603504.6166666327,191097,0,79,0.3262166510689885,3538682118,-531709,-531709,47960643.46667236,6356.6500000292435,-1583,0,18,0.6067186343048245,-3502149152,1489.6525810835894,402.3168224061085,1087.335758677481,0.7868810257347141,0.24735842682230688,-1583
659,2018-10-22,2018,239334,239334,359288011.65000015,3591206.533333336,189016,0,86,0.9177759950529389,36269683,4154000945,783032,783032,311508517.43332756,3584551.1166666285,190309,0,70,0.30069013782323256,3551849716,-543698,-543698,47779494.2166726,6655.41666670749,-1293,0,16,0.6170858572297064,-3515580033,1501.1992096818678,397.8234828631877,1103.37572681868,0.7897582457987582,0.2430411528519907,-1293
660,2018-10-23,2018,238440,238440,359322811.7333333,3566445.4833333343,188470,0,85,0.8934490857238719,36471492,4156835216,791456,791456,311807122.88334894,3560444.883332752,189499,0,67,0.27935981280070327,3557988173,-553016,-553016,47515688.84998435,6000.60000058217,-1029,0,18,0.6140892729231686,-3521516681,1506.9737113459707,393.9664654552482,1113.0072458907225,0.7904294581446066,0.23943087170986133,-1029
661,2018-10-24,2018,245122,245122,359886473.1000004,3617571.366666665,190653,0,100,0.9060386256639549,36433640,4163647218,806257,806257,312573228.91666245,3611475.616666622,192100,0,64,0.29775121332279975,3569296830,-561135,-561135,47313244.18333793,6095.750000042841,-1447,0,36,0.6082874123411551,-3532863190,1468.1932796729807,387.68435984637955,1080.5089198266012,0.7777882034252331,0.23826149726451987,-1447
662,2018-10-25,2018,246131,246131,359930486.8499998,3584031.483333329,193344,0,93,0.9074801630026293,37052056,4165503316,818149,818147,312931385.6166768,3577921.599999433,194700,0,64,0.2891368198213381,3579137025,-572018,-572016,46999101.23332298,6109.883333896287,-1356,0,29,0.6183433431812912,-3542084969,1462.3533274963324,382.4879705195726,1079.8653569767598,0.7855329072729563,0.2379762121569543,-1356
663,2018-10-26,2018,232650,232650,359488428.5500003,3465577.9333333345,183609,0,91,0.9055791962174934,35978787,4165675594,821352,821352,312779956.966669,3459741.899999483,184799,0,69,0.2704613856178439,3590490795,-588702,-588702,46708471.58333129,5836.03333385149,-1190,0,22,0.6351178105996496,-3554512008,1545.1898927573623,380.8110980026457,1164.3787947547166,0.7892069632495164,0.22499366897505577,-1190
664,2018-10-27,2018,222755,222755,358894811.9499999,3397623.1500000004,176456,0,94,0.9124643666808833,35075550,4166572006,829320,829320,312420783.7833403,3392413.0999994962,177669,0,66,0.2622039743404163,3599704858,-606565,-606565,46474028.16665965,5210.050000504125,-1213,0,28,0.650260392340467,-3564629308,1611.1638883526741,376.7192203049972,1234.444668047677,0.7921528136293237,0.21423455361018665,-1213
665,2018-10-28,2018,227922,227922,358802253.0166669,3436698.716666667,178333,0,91,0.9052044120356948,35174283,4170384644,842986,842985,312498917.9333314,3431350.6999999722,179494,0,73,0.2599307699060241,3612798030,-615064,-615063,46303335.08333552,5348.016666694544,-1161,0,18,0.6452736421296708,-3577623747,1574.2326454518077,370.7051939635123,1203.5274514882954,0.7824299541071068,0.2129264305694282,-1161
666,2018-10-29,2018,235437,235437,359369137.4166663,3527125.6333333277,185158,0,100,0.914635337691187,35705687,4177146616,856078,856078,313333411.28332645,3522088.1666666027,186525,0,77,0.2703328435025798,3622806466,-620641,-620641,46035726.13333988,5037.4666667249985,-1367,0,23,0.6443024941886072,-3587100779,1526.3919325198092,366.0103533595379,1160.3815791602713,0.7864439319223402,0.21788318354168662,-1367
667,2018-10-30,2018,229251,229251,359473213.0833337,3498292.08333333,181249,0,88,0.930133347291833,35294370,4181099491,859564,859564,313696717.59999645,3494221.2833332755,182800,0,74,0.2741075708149715,3627172748,-630313,-630313,45776495.48333722,4070.8000000547618,-1551,0,14,0.6560257764768614,-3591878378,1568.0333480915401,364.9486455924125,1203.0847024991276,0.7906137814011717,0.2126659562289719,-1551
668,2018-10-31,2018,229183,229183,359472771.583333,3486377.716666667,179783,0,99,0.9271237395443819,34720785,4182190222,869851,869851,313971327.38332796,3482067.1666666493,181218,0,73,0.2735169586515371,3636529397,-640668,-640668,45501444.200005054,4310.550000017509,-1435,0,26,0.6536067808928447,-3601808612,1568.4966667830206,360.9484007989046,1207.548265984116,0.7844517263496856,0.2083322316120807,-1435
669,2018-11-01,2018,229120,229120,359425501.8833335,3482414.9333333327,179344,0,98,0.910714909217878,34441140,4183070993,529373,529373,314119671.800007,3477088.549999853,180853,0,77,0.4301787208641136,3591542468,-300253,-300253,45305830.08332652,5326.38333347952,-1509,0,21,0.48053618835376444,-3557101328,1568.7216388064487,593.3806064910885,975.3410323153602,0.7827513966480447,0.34163623758672995,-1509
670,2018-11-02,2018,236986,236986,359820393.3833329,3515707.7000000007,183741,0,88,0.8935844311478321,35936572,4189275594,549242,549242,314739387.08334386,3509615.249999842,185102,0,60,0.41663965974925393,3600191146,-312256,-312256,45081006.299989045,6092.450000158511,-1361,0,28,0.4769447713985782,-3564254574,1518.3191976881878,573.0431887644132,945.2760089237746,0.775324280759201,0.33701355686564394,-1361
671,2018-11-03,2018,243520,243520,360155493.43333316,3562278.5166666633,187426,0,95,0.9016959592641266,36606802,4194283311,566076,566076,315246882.6666793,3555175.266666505,189363,0,71,0.44221270642104626,3611017914,-322556,-322556,44908610.766653836,7103.250000158325,-1937,0,24,0.45948325284308034,-3574411112,1478.9565269108623,556.8985130383187,922.0580138725436,0.7696534165571617,0.3345186865367901,-1937
672,2018-11-04,2018,234969,234969,360613213.3999998,3489963.2166666626,180631,0,79,0.8912835310189847,35509554,4201626321,570427,570427,315828893.4166724,3482984.0666665183,182149,0,64,0.40238452948404896,3623058400,-335458,-335458,44784319.98332739,6979.150000144262,-1518,0,15,0.48889900153493576,-3587548846,1534.7267656584477,553.6710103425546,981.0557553158931,0.7687439619694513,0.3193204388992807,-1518
673,2018-11-05,2018,233941,233941,360957495.4333335,3488420.616666667,180944,0,83,0.8876426107437339,35252005,4208797511,584631,584631,316403166.40001047,3481945.1833331445,182235,0,67,0.38399948001388484,3633674490,-350690,-350690,44554329.03332305,6475.43333352264,-1291,0,16,0.503643130729849,-3598422485,1542.9424317812334,541.2014867497797,1001.7409450314536,0.7734599749509492,0.31170943723476857,-1291
674,2018-11-06,2018,234282,234282,361036448.0666665,3488037.333333336,181441,0,80,0.8891506816571483,35190114,4212597819,593755,593755,316672960.65001506,3482188.5499998424,182661,0,59,0.37894922990121793,3639074486,-359473,-359473,44363487.41665143,5848.783333493397,-1220,0,21,0.5102014517559303,-3603884372,1541.033660574293,533.3394424468258,1007.6942181274671,0.7744555706370955,0.30763698832009834,-1220
675,2018-11-07,2018,233457,233457,361134347.5999997,3465407.3833333356,181547,0,86,0.8998102434281264,35008329,4214833200,604623,604623,316998229.983345,3459569.099999798,182788,0,65,0.37965145222725616,3650520725,-371166,-371166,44136117.61665475,5838.2833335376345,-1241,0,21,0.5201587912008703,-3615512396,1546.8987762200309,524.2907232826819,1022.6080529373489,0.7776464188265934,0.30231731177940635,-1241
676,2018-11-08,2018,227872,227872,361224090.45000005,3402748.649999999,179426,0,84,0.9221448883583766,34254425,4219169275,613669,613669,317251222.0166817,3397397.2999998396,180956,0,66,0.3858529598203626,3659047161,-385797,-385797,43972868.43331838,5351.350000159349,-1530,0,18,0.536291928538014,-3624792736,1585.2061264657355,516.9744960502838,1068.2316304154515,0.7873981884566774,0.29487557624712996,-1530
677,2018-11-09,2018,231854,231854,361033190.30000037,3391079.133333331,181740,0,89,0.9111725482415651,34645261,4219700676,635604,635604,317340246.45002025,3390901.216666526,184328,0,70,0.3710281873619398,3670203240,-403750,-403750,43692943.849980116,177.91666680481285,-2588,0,19,0.5401443608796253,-3635557979,1557.1574797070587,499.2735200691315,1057.883959637927,0.7838553572506837,0.29000446819088616,-2588
678,2018-11-10,2018,226725,226725,360871682.7166665,3387268.6499999985,176031,0,87,0.9125504465762488,34907765,4219037784,639679,639679,316854318.9166826,3382015.24999988,177391,0,68,0.36267409122387756,3666544421,-412954,-412954,44017363.79998392,5253.4000001186505,-1360,0,19,0.5498763553523713,-3631636656,1591.6713318631228,495.3333139225809,1096.338017940542,0.7764075421766458,0.2773125270643557,-1360
679,2018-11-11,2018,230842,230842,360922992.94999945,3419679.3333333367,179405,0,81,0.9029292763015393,35274774,4220126938,652288,652288,317080108.1333456,3415263.4666664964,180497,0,64,0.347504476550237,3672987841,-421446,-421446,43842884.81665385,4415.866666840389,-1092,0,17,0.5554247997513023,-3637713067,1563.506610365529,486.10446326368964,1077.4021471018393,0.7771765969797524,0.27671366022370486,-1092
680,2018-11-12,2018,236809,236809,361551626.2666666,3483923.783333333,182963,0,91,0.8975292324193767,35179429,4226730348,676061,676061,317959154.3833553,3536638.633333214,189644,0,72,0.358781234237737,3684273486,-439252,-439252,43592471.88331127,-52714.849999880884,-6681,0,19,0.5387479981816397,-3649094057,1526.7647186832705,470.3113393367689,1056.4533793465016,0.7726184393329646,0.2805131489614103,-6681
681,2018-11-13,2018,193753,193753,348864057.88333356,2839155.400000006,138893,0,48,0.7564269972593967,24129881,4162257998,661049,661049,302531403.7666711,2834981.8166665845,139330,0,35,0.22256897748880813,3631519101,-467296,-467296,46332654.11666244,4173.5833334214985,-437,0,13,0.5338580197705886,-3607389220,1800.5608061982707,457.6535230620894,1342.9072831361814,0.7168559970684325,0.21077106235695084,-437
682,2018-11-14,2018,234212,234212,349138348.28333336,3444253.483333334,181802,0,75,0.8746904513859244,35135114,4164050199,701618,701618,302454222.3333471,3439900.2166660875,182650,0,64,0.3037393567439825,3607607947,-467406,-467406,46684125.94998628,4353.266667246353,-848,0,11,0.5709510946419418,-3572472833,1490.6936804405127,431.08104742658696,1059.6126330139257,0.7762283742933752,0.26032684452223287,-848
683,2018-11-15,2018,239672,239672,349776408.16666675,3464033.599999998,185821,0,76,0.8762225040889214,35718418,4168980645,697680,697680,303280438.29999495,3457745.249999946,187236,0,69,0.31736039445017794,3564535687,-458008,-458008,46495969.8666718,6288.350000052247,-1415,0,7,0.5588621096387435,-3528817269,1459.396208846535,434.6984839754543,1024.6977248710807,0.7753137621415935,0.26836945304437565,-1415
684,2018-11-16,2018,236514,236514,350008403.6999997,3455916.5666666683,183440,0,85,0.8751913205983584,35515719,4171322544,709191,709191,303320075.4166603,3454769.9499999597,184848,0,61,0.30082587060467425,3566580787,-472677,-472677,46688328.28333938,1146.6166667086072,-1408,0,24,0.5743654499936841,-3531065068,1479.863364113751,427.6987093979764,1052.1646547157745,0.7755989074642516,0.26064628569736503,-1408
685,2018-11-17,2018,229897,229897,350176518.73333335,3398930.283333332,179442,0,95,0.8858793285688815,33168310,4172774537,724294,724294,303701711.9333353,3446219.3166661444,183384,0,67,0.2972605047121821,3573960344,-494397,-494397,46474806.799998045,-47289.0333328126,-3942,0,28,0.5886188238566994,-3540792034,1523.1887268356409,419.30723150175936,1103.8814953338815,0.7805321513547371,0.2531900029546013,-3942
686,2018-11-18,2018,223493,223493,350337069.83333373,3375585.933333332,174595,0,91,0.8857011181558262,35207310,4175879777,725976,725976,301177225.4333428,3370212.383332731,175499,0,84,0.28053268978588786,3554252961,-502483,-502483,49159844.399990916,5373.5500006009825,-904,0,7,0.6051684283699383,-3519045651,1567.5527637703808,414.85837745785375,1152.694386312527,0.7812101497586054,0.2417421512556889,-904
687,2018-11-19,2018,228561,228561,350837095.85000026,3402367.433333336,177939,0,93,0.8747511605216981,35322719,4184125542,737626,737626,301821549.86666226,3397058.7499999385,178762,0,66,0.2789137042349395,3561807662,-509065,-509065,49015545.983338,5308.683333397377,-823,0,27,0.5958374562867585,-3526484943,1534.982327912462,409.1796518380077,1125.8026760744544,0.7785186449131741,0.2423477480457576,-823
688,2018-11-20,2018,231375,231375,351337435.8666664,3407893.133333335,180635,0,99,0.8955937331172344,35185783,4189092466,747476,747476,302588125.64999443,3403232.19999996,181784,0,68,0.29165618695449613,3568181944,-516101,-516101,48749310.21667194,4660.9333333750255,-1149,0,31,0.6039375461627383,-3532996161,1518.4762220061216,404.813165439418,1113.6630565667035,0.7807023230686115,0.2431971059940386,-1149
689,2018-11-21,2018,229621,229621,351558522.45,3418577.8333333354,178698,0,85,0.9021300316608665,34921600,4191541019,754288,754288,303105260.83332855,3414043.8166666115,179957,0,63,0.29293718049339595,3576964688,-524667,-524667,48453261.61667144,4534.016666723881,-1259,0,22,0.6091928511674705,-3542043088,1531.0381996855688,401.84287809607014,1129.1953215894987,0.7782302141354667,0.23857863309505123,-1259
690,2018-11-22,2018,225167,225167,351758501.10000014,3392714.7333333325,177485,0,79,0.8994257595473577,34720181,4198407902,763745,763745,303586415.5166613,3388467.06666665,178460,0,67,0.27743815016792683,3584676796,-538578,-538578,48172085.58333886,4247.666666682344,-975,0,12,0.6219876093794309,-3549956615,1562.2116078288566,397.4970906737999,1164.7145171550567,0.7882371750745003,0.23366437750819974,-975
691,2018-11-23,2018,225062,225062,352005041.30000025,3379690.966666669,177371,0,81,0.880730643111676,34115147,4200053998,771958,771958,304143269.34999883,3374430.599999488,178117,0,61,0.261715015583745,3594411673,-546896,-546896,47861771.95000142,5260.366667181253,-746,0,20,0.619015627527931,-3560296526,1564.0358714487575,393.9894001357572,1170.0464713130002,0.7880983906656832,0.23073405547970227,-746
692,2018-11-24,2018,225780,225780,352163838.6166667,3380046.733333333,176784,0,94,0.8874169545575343,33571226,4202180461,783623,783623,304604197.11666185,3374751.2166666994,177784,0,77,0.2665490931225797,3604414918,-557843,-557843,47559641.50000483,5295.516666633543,-1000,0,17,0.6208678614349546,-3570843692,1559.765429252665,388.7126808639637,1171.0527483887013,0.7829922933829392,0.22687440261452255,-1000
693,2018-11-25,2018,221762,221762,352689221.8000002,3355571.0499999966,173732,0,79,0.9055879726914445,32991395,4207476264,788528,788528,305344382.33332944,3349933.733333338,174833,0,64,0.2743846762575364,3616831075,-566766,-566766,47344839.46667075,5637.316666658502,-1101,0,15,0.6312032964339082,-3583839680,1590.395206572813,387.23340494355233,1203.1618016292607,0.7834164554792976,0.22172072519935881,-1101
694,2018-11-26,2018,226859,226859,353121415.93333304,3299607.8999999976,176802,0,93,0.8903019055889329,33695840,4213857481,804739,804739,306079162.64999384,3293835.80000004,177830,0,77,0.26451060530184334,3628514189,-577880,-577880,47042253.2833392,5772.099999957718,-1028,0,16,0.6257913002870895,-3594818349,1556.5678061409644,380.3458794093412,1176.2219267316232,0.7793475242331139,0.22097847873658416,-1028
695,2018-11-27,2018,225453,225453,353290550.3166668,3305836.9999999995,174984,0,90,0.8820330623234118,33683659,4214471455,812799,812799,306445507.98333603,3300476.166666181,175853,0,79,0.2535780678864194,3632659918,-587346,-587346,46845042.33333075,5360.833333818708,-869,0,11,0.6284549944369924,-3598976259,1567.0252794004373,377.02495694917934,1190.000322451258,0.7761440300195607,0.21635484295625362,-869
696,2018-11-28,2018,230344,230344,353944899.1166668,3413117.366666668,178970,0,89,0.8937936303962769,34778305,4221682748,824310,824310,307294917.56666225,3407611.7166666277,180054,0,74,0.26387038856741457,3639024733,-593966,-593966,46649981.55000454,5505.650000040419,-1084,0,15,0.6299232418288623,-3604246428,1536.592657575916,372.7904763579991,1163.802181217917,0.7769683603653665,0.2184299596025767,-1084
697,2018-11-29,2018,230324,230324,354405474.5666667,3423469.516666664,178937,0,88,0.8952996648199927,34276418,4226571203,834880,834880,308037009.21667343,3418106.049999562,180035,0,69,0.26345822154082554,3649964967,-604556,-604556,46368465.34999329,5363.4666671017185,-1098,0,19,0.6318414432791671,-3615688549,1538.7257713771328,368.9596220015732,1169.7661493755595,0.7768925513624286,0.21564176887696435,-1098
698,2018-11-30,2018,230747,230747,355061460.16666687,3425496.4333333303,180025,0,84,0.8820526377374351,34722610,4234170988,844396,844396,308808952.58332574,3420675.9333333606,180868,0,66,0.24677876257111447,3660120168,-613649,-613649,46252507.58334112,4820.499999969732,-843,0,18,0.6352738751663207,-3625397558,1538.7478934359574,365.7157928073152,1173.0321006286422,0.7801834910096339,0.2141980776791932,-843
699,2018-12-01,2018,224999,224999,355101449.9666664,3403555.049999999,175893,0,88,0.8926039671287429,34653840,4236515475,510312,510312,309106500.78334135,3399135.8333331943,177120,0,65,0.4086715577920908,3623724351,-285313,-285313,45994949.18332505,4419.216666804627,-1227,0,23,0.4839324093366521,-3589070511,1578.2356808993213,605.7206195099103,972.515061389411,0.7817501411117382,0.34708178526078165,-1227
700,2018-12-02,2018,226930,226930,355370387.98333335,3401904.1333333347,176653,0,93,0.8955316617459128,34970785,4242777306,525413,525413,309468098.6833429,3397301.016666531,177882,0,74,0.4080066538132824,3634176695,-298483,-298483,45902289.299990475,4603.116666803602,-1229,0,19,0.4875250079326304,-3599205910,1565.9912218892757,588.9996986814998,976.9915232077759,0.778447098224122,0.33855652600906333,-1229
701,2018-12-03,2018,233040,233040,356213587.0666667,3475726.95,182165,0,90,0.8953613113628566,35176725,4254230881,542555,542555,310469492.45001006,3470971.0333332173,183442,0,71,0.4044364165844903,3647789256,-309515,-309515,45744094.61665666,4755.916666782927,-1277,0,19,0.49092489477836626,-3612612531,1528.5512661631767,572.2359805918479,956.3152855713288,0.7816898386543083,0.3381076572882012,-1277
702,2018-12-04,2018,228423,228423,356357498.0166663,3430886.5666666664,179420,0,127,0.9019056749977009,34665485,4257180705,550273,550273,310873420.5166764,3426355.033333255,180533,0,127,0.39370457936333425,3653453204,-321850,-321850,45484077.49998987,4531.53333341144,-1113,0,0,0.5082010956343667,-3618787719,1560.0771289085,564.9439832895243,995.1331456189757,0.7854725662477071,0.32807897171040556,-1113
703,2018-12-05,2018,226805,226805,356672248.1999998,3404253.6833333373,178290,0,189,0.8915720552897867,34690746,4262432694,562591,562591,311516674.0000124,3399656.6833331687,179296,0,189,0.3724517455842756,3663305135,-335786,-335786,45155574.19998741,4597.000000168569,-1006,0,0,0.519120309705511,-3628614389,1572.594291131147,553.7178412026008,1018.8764499285462,0.7860937810013007,0.31869688637038274,-1006
704,2018-12-06,2018,218315,218315,356746839.6166665,3316280.0500000003,171902,0,203,0.8994480452557081,34042705,4267742369,567349,567349,311806992.4166771,3310873.5666665295,172823,0,203,0.3580089151474713,3674887176,-349034,-349034,44939847.19998938,5406.4833334707655,-921,0,0,0.5414391301082369,-3640844471,1634.0922044599156,549.585867634696,1084.5063368252195,0.7874035224331815,0.3046149724420066,-921
705,2018-12-07,2018,207612,207612,356356524.7333329,3239252.2833333327,163219,0,215,0.8959983045296034,33340804,4265312565,574138,574137,311619707.7166801,3234034.1333332295,164066,0,215,0.3368980976699005,3685319532,-366526,-366525,44736817.01665276,5218.150000103284,-847,0,0,0.5591002068597029,-3651978728,1716.4543703318348,542.7619326339883,1173.6924376978463,0.7861732462478084,0.28576056627500707,-847
706,2018-12-08,2018,209198,209198,355885952.95,3240062.5333333313,163375,0,206,0.8959837092132817,32924491,4262784313,588524,588524,311329397.78334445,3235606.4499998437,164240,0,206,0.3336771312639719,3690671290,-379326,-379326,44556555.16665554,4456.083333487622,-865,0,0,0.5623065779493098,-3657746799,1701.1919471027447,529.0003428634082,1172.1916042393366,0.7809587089742732,0.2790710319375251,-865
707,2018-12-09,2018,207958,207958,355596427.9333337,3246257.816666667,162408,0,225,0.8986189519037493,32519892,4263640603,596686,596686,311452756.16667783,3243480.0333332177,163423,0,225,0.33034125151252114,3699123647,-388728,-388728,44143671.76665586,2777.783333449159,-1015,0,0,0.5682777003912282,-3666603755,1709.9434882684661,521.9709464721442,1187.9725417963218,0.7809653872416545,0.2738844216220927,-1015
708,2018-12-10,2018,217057,217057,356178882.94999975,3323003.433333333,169542,0,224,0.8926641389128214,33390665,4271085053,612918,612918,312262130.0833392,3318202.499999848,170477,0,224,0.3336384312420296,3708466561,-395861,-395861,43916752.866660535,4800.933333484922,-935,0,0,0.5590257076707918,-3675075896,1640.946308803677,509.46803664330173,1131.4782721603754,0.7810943669174456,0.278139979573124,-935
709,2018-12-11,2018,211955,211955,356491780.5333331,3280607.833333331,166300,0,233,0.9005921068151256,33509547,4276035829,615174,615174,312765178.3166803,3275295.049999837,167255,0,233,0.32994892501958906,3710685391,-403219,-403219,43726602.21665281,5312.783333494328,-955,0,0,0.5706431817955365,-3677175844,1681.9220142640331,508.41742062681504,1173.504593637218,0.7846005048241372,0.2718824267605588,-955
710,2018-12-12,2018,217569,217569,356640581.76666695,3281806.1833333364,171958,0,236,0.9022838731620771,32236066,4277202527,648784,648784,313184242.0500169,3353374.533333131,177456,0,236,0.3332958272707113,3716269396,-431215,-431215,43456339.71665007,-71568.34999979474,-5498,0,0,0.5689880458913659,-3684033330,1639.2067884977498,482.7249778817247,1156.481810616025,0.790360759115499,0.273520925300254,-5498
711,2018-12-13,2018,214384,214384,356555496.8333333,3282473.1,168934,0,135,0.9120969848496159,32775770,4276865211,670212,670212,310347464.8000102,3396545.833333224,178350,0,135,0.3245898312772673,3676391719,-455828,-455828,46208032.03332311,-114072.73333322397,-9416,0,0,0.5875071535723486,-3643615949,1663.1628145446177,463.0586512924421,1200.1041632521756,0.7879972385998956,0.26610982793504145,-9416
712,2018-12-14,2018,215627,215627,356298381.5999999,3285198.6166666616,169023,0,173,0.8931163537033856,32032351,4272974922,664199,664199,302072953.4000181,3283329.8166665398,170701,0,173,0.3093063976308297,3553683814,-448572,-448572,54225428.19998181,1868.800000121817,-1678,0,0,0.5838099560725559,-3521651463,1652.3829650275702,454.7928458188255,1197.5901192087447,0.7838675119535123,0.25700279584883445,-1678
713,2018-12-15,2018,218282,218282,356328618.1833333,3297531.6333333356,169878,0,165,0.8807918197560947,33169105,4271284698,674221,674221,301593479.5500101,3295033.0166665483,174658,0,165,0.30112233229163593,3541243652,-455939,-455939,54735138.63332319,2498.616666787304,-4780,0,0,0.5796694874644588,-3508074547,1632.4232789846772,447.32139691586303,1185.1018820688141,0.7782501534711979,0.25905155727869644,-4780
714,2018-12-16,2018,214587,214587,356318593.93333364,3292097.9000000004,167201,0,168,0.8851281764505762,33010502,4273033334,668472,668472,299041692.26667905,3287324.5166665195,168009,0,168,0.293711628908911,3491388169,-453885,-453885,57276901.66665459,4773.383333480917,-808,0,0,0.5914165475416652,-3458377667,1660.485462462002,447.3511115898333,1213.1343508721689,0.7791758121414625,0.2513328905324382,-808
715,2018-12-17,2018,222418,222418,357051940.01666665,3336013.7833333327,174307,0,153,0.8879721964948883,32973100,4280673074,685867,685867,300048124.9333476,3332648.433333201,175335,0,153,0.30224081345217596,3501759590,-463449,-463449,57003815.08331907,3365.3500001318753,-1028,0,0,0.5857313830427124,-3468786490,1605.3194436451486,437.4727533666842,1167.8466902784644,0.7836910681689432,0.25563994185461614,-1028
716,2018-12-18,2018,223134,223134,357636235.85,3377405.0499999993,174389,0,149,0.8831733397868534,33872977,4285783757,692513,692513,300995420.4833448,3375414.0166665046,175436,0,149,0.29714243631527193,3506030246,-469379,-469379,56640815.36665523,1991.0333334947936,-1047,0,0,0.5860309034715815,-3472157269,1602.786826973926,434.64226734132757,1168.1445596325984,0.7815438256832218,0.2533324284165063,-1047
717,2018-12-19,2018,226353,226353,358190008.1166656,3426055.4333333336,176868,0,181,0.8938913997163727,34351462,4291585868,703915,703915,301942546.01667833,3425206.89999987,177922,0,181,0.30110169551721505,3518292001,-477562,-477562,56247462.09998727,848.5333334635943,-1054,0,0,0.5927897041991577,-3483940539,1582.4398533117105,428.94745248599384,1153.4924008257167,0.7813812938198301,0.2527606316103507,-1054
718,2018-12-20,2018,224361,224361,358568883.3333335,3382183.583333331,175887,0,222,0.900762610257576,33625857,4295742293,710434,710434,302744878.0166631,3381184.366666626,176968,0,225,0.3024292193222771,3528413349,-486073,-486073,55824005.31667042,999.2166667049751,-1081,0,-3,0.5983333909352988,-3494787492,1598.1783078758497,426.14075060690095,1172.0375572689486,0.7839464077981467,0.2490984384193324,-1081
719,2018-12-21,2018,222357,222357,358653823.23333293,3350329.8500000034,173304,0,93,0.8975566319027503,33968492,4296619349,724771,724771,303137651.86666095,3353311.8166666673,176420,0,89,0.29860190322184627,3540819720,-502414,-502414,55516171.36667198,-2981.966666663997,-3116,0,4,0.598954728680904,-3506851228,1612.9639419192242,418.25300938732505,1194.7109325318993,0.7793952967525196,0.2434148165420526,-3116
720,2018-12-22,2018,215834,215834,358370454.24999946,3275140.05,169503,0,93,0.9132388780266313,33955283,4295461919,732797,732797,302906479.5166734,3272383.649999528,171262,0,67,0.2977345704199088,3548497292,-516963,-516963,55463974.73332608,2756.4000004716218,-1759,0,26,0.6155043076067225,-3514542009,1660.3985203906682,413.35660423920046,1247.0419161514678,0.7853396591825199,0.23371001791764978,-1759
721,2018-12-23,2018,208387,208387,357703508.1166667,3199849.400000001,161834,0,87,0.8994323062379125,33739970,4292344360,734756,734756,302377844.73333967,3197024.733332892,163061,0,68,0.27747034389647074,3552696816,-526369,-526369,55325663.38332701,2824.6666671088897,-1227,0,19,0.6219619623414417,-3518956846,1716.534659631679,411.5350466458793,1304.9996129857998,0.7766031470293252,0.22192537386560982,-1227
722,2018-12-24,2018,207937,207937,357961595.233333,3195089.35,161903,0,146,0.8973390978998438,34059484,4297226611,746904,746904,302953480.3666597,3192382.949999995,163116,0,146,0.2676916979959975,3564763072,-538967,-538967,55008114.86667329,2706.400000005029,-1213,0,0,0.6296473999038463,-3530703588,1721.4906208771552,405.6123415682065,1315.8782793089485,0.778615638390474,0.21838951190514444,-1213
723,2018-12-25,2018,211057,211057,357839063.49999994,3221581.816666668,164291,0,121,0.8997758899254704,34065953,4296377708,759145,759145,303114724.89999604,3217198.7000000086,165685,0,121,0.27737520500036034,3576270267,-548088,-548088,54724338.6000039,4383.116666659247,-1394,0,0,0.62240068492511,-3542204314,1695.4617165031245,399.2843592462521,1296.1773572568725,0.7784200476648488,0.2182521125740142,-1394
724,2018-12-26,2018,213911,213911,358169922.05,3261944.6999999946,168167,0,105,0.90181430594967,34381620,4302241700,769029,769029,303727004.566665,3256432.8500000164,169384,0,105,0.26862836121914974,3586801918,-555118,-555118,54442917.48333502,5511.849999978207,-1217,0,0,0.6331859447305204,-3552420298,1674.3875819850311,394.9487009809318,1279.4388810040994,0.7861540547236935,0.2202569734041239,-1217
725,2018-12-27,2018,205294,205294,358556513.04999983,3220797.4499999993,161223,0,110,0.9025641275439129,33718457,4310279395,770670,770670,304423367.9333285,3215766.2999999877,162503,0,107,0.2611364137698425,3592933839,-565376,-565376,54133145.116671324,5031.150000011548,-1280,0,3,0.6414277137740705,-3559215382,1746.5513509893121,395.0113121482976,1351.5400388410146,0.7853273841417674,0.2108593820960982,-1280
726,2018-12-28,2018,201371,201371,358810710.4166664,3194578.833333332,158126,0,144,0.8938228444016262,33329085,4315587231,777882,777882,304913259.34999686,3190405.166666684,159225,0,144,0.24792063577765971,3601743577,-576511,-576511,53897451.06666952,4173.666666647885,-1099,0,0,0.6459022086239665,-3568414492,1781.8390454269304,391.97880828968516,1389.8602371372453,0.7852471309175602,0.20469042862542133,-1099
727,2018-12-29,2018,201459,201459,358934445.2333325,3177999.7999999984,159030,0,145,0.8983713807772292,32459233,4318795489,790214,790214,305281120.3666624,3174089.5333333323,160164,0,145,0.24554867415662557,3610422031,-588755,-588755,53653324.86667013,3910.266666666139,-1134,0,0,0.6528227066206036,-3577962798,1781.6749077148825,386.3271472875226,1395.3477604273598,0.7893913898113264,0.20268433614185524,-1134
728,2018-12-30,2018,201373,201373,358833996.0499992,3156176.1500000036,158768,0,82,0.8883018080874796,32062228,4319221908,798607,798607,305491443.2666814,3152718.8333329167,159981,0,61,0.2414491733731456,3620273371,-597234,-597234,53342552.783317804,3457.3166670869105,-1213,0,21,0.646852634714334,-3588211143,1781.9369828626438,382.5303851164357,1399.4065977462083,0.7884274455860517,0.20032506602120942,-1213
729,2018-12-31,2018,201371,201371,358960429.63333285,3154162.5333333346,158002,0,85,0.8861752685341986,31998599,4320094449,808124,808124,305944531.1499962,3151270.983333321,159285,0,56,0.24220911642272963,3631663786,-606753,-606753,53015898.48333663,2891.5500000137836,-1283,0,29,0.643966152111469,-3599665187,1782.58254482191,378.5861218699064,1403.9964229520037,0.7846313520814815,0.1971046522563369,-1283
730,2019-01-01,2019,196978,196978,358760914.8999999,3127184.883333332,154284,0,77,0.8794992334169297,31883536,4320198876,480306,480306,306087116.10001063,3128082.0499998434,156834,0,52,0.3947920700553378,3600181826,-283328,-283328,52673798.79998928,-897.1666665114462,-2550,0,25,0.4847071633615919,-3568298290,1821.324792108763,637.2752289165878,1184.0495631921751,0.7832549827899562,0.3265293375473136,-2550
731,2019-01-02,2019,205598,205598,359440854.43333346,3184824.733333337,161886,0,82,0.898807381394761,32356403,4327033755,503387,503387,306744579.4500159,3189968.933333203,164443,0,60,0.4001414418727465,3607673176,-297789,-297789,52696274.983317554,-5144.199999866076,-2557,0,22,0.49866593952201455,-3575316773,1748.2701895608589,609.3613451479993,1138.9088444128597,0.7873909279273145,0.32667311631011525,-2557
732,2019-01-03,2019,211555,211555,359812078.19999903,3236433.0500000026,166549,0,85,0.8988537259814235,32687830,4330232878,521543,521543,307208783.36668277,3287721.6499998746,172601,0,68,0.4025880895726713,3602549700,-309988,-309988,52603294.83331627,-51288.599999872036,-6052,0,17,0.49626563640875226,-3569861870,1700.7968528278652,589.0382640869167,1111.7585887409487,0.7872609959584977,0.3309429903191108,-6052
733,2019-01-04,2019,210773,210773,360089253.5833333,3227422.5833333335,165394,0,87,0.9008411893363953,32654835,4334764319,528307,528307,306010059.73334384,3236351.7833331972,168009,0,54,0.390131116945263,3580856187,-317534,-317534,54079193.849989474,-8929.199999863748,-2615,0,33,0.5107100723911324,-3548201352,1708.4221109123716,579.2277212555273,1129.1943896568444,0.7847020254017355,0.3180139577934799,-2615
734,2019-01-05,2019,205567,205567,360256651.3666668,3195881.999999997,161911,0,92,0.9058749702043626,32693680,4338100542,543289,543289,305985481.5666721,3259633.316666493,168601,0,61,0.39425609574277676,3579895953,-337722,-337722,54271169.79999471,-63751.316666495986,-6690,0,31,0.5116188744615858,-3547202273,1752.5023538148964,563.2094181304464,1189.2929356844502,0.787631283231258,0.3103339106810556,-6690
735,2019-01-06,2019,204915,204915,360587076.25000006,3181487.8333333335,161393,0,89,0.9054681209281902,32788224,4341939485,556714,556714,305068004.433346,3227719.716666567,167905,0,64,0.37607999798819686,3566520974,-351799,-351799,55519071.816654086,-46231.88333323365,-6512,0,25,0.5293881229399933,-3533732750,1759.690975526438,547.9797605832546,1211.7112149431834,0.78760949662055,0.3016001034642563,-6512
736,2019-01-07,2019,211297,211297,361413986.366667,3237659.6000000047,165648,0,140,0.9005759665305232,33459477,4350647231,564919,564919,303755013.6166767,3273110.6666665967,169616,0,140,0.367558888973467,3533769070,-353622,-353622,57658972.749990284,-35451.06666659191,-3968,0,0,0.5330170775570562,-3500309593,1710.4548875122077,537.6965788310832,1172.7583086811246,0.7839581252928343,0.3002483541888306,-3968
737,2019-01-08,2019,210126,210126,361641702.8166663,3226414.633333337,163712,0,158,0.893116511045753,33106802,4354067169,570667,570667,303656137.4833388,3285927.1166665303,170639,0,158,0.36039056051953294,3524366677,-360541,-360541,57985565.33332753,-59512.48333319323,-6927,0,0,0.5327259505262201,-3491259875,1721.070704323436,532.1074067421785,1188.9632975812576,0.7791134842903782,0.29901676459301135,-6927
738,2019-01-09,2019,213805,213805,362122062.4,3227292.0333333355,167168,0,149,0.8894880849372091,33559747,4359031428,587278,587278,303048569.85001755,3263905.8833332653,173334,0,149,0.35236804375440045,3507476905,-373473,-373473,59073492.54998243,-36613.84999992978,-6166,0,0,0.5371200411828086,-3473917158,1693.70249713524,516.0223435068528,1177.6801536283872,0.781871331353336,0.2951481240570905,-6166
739,2019-01-10,2019,216026,216026,362434186.4166669,3275888.0833333293,168687,0,131,0.8962717450677233,34000854,4361529737,591803,591803,301839298.866675,3271140.6666665142,169984,0,131,0.35568930877335814,3481695617,-375777,-375777,60594887.549991906,4747.416666815057,-1297,0,0,0.5405824362943652,-3447694763,1677.7340987504601,510.0334044718851,1167.7006942785752,0.78086434040347,0.287230716978454,-1297
740,2019-01-11,2019,215170,215170,362659662.71666634,3281689.3833333333,168222,0,147,0.8949017056281078,33744686,4362479096,594809,594809,302239575.8833454,3277657.966666545,169359,0,147,0.34651291422961095,3485443561,-379639,-379639,60420086.833320916,4031.4166667885147,-1137,0,0,0.5483887913984968,-3451698875,1685.4564424253676,508.12878736425546,1177.3276550611122,0.7818097318399405,0.2847283749909635,-1137
741,2019-01-12,2019,210603,210603,362626679.1166671,3237365.966666663,165185,0,161,0.8932208942892556,32918020,4363656821,605949,605949,302553058.76667714,3234859.9999999166,167046,0,161,0.32690209902154144,3492975974,-395346,-395346,60073620.34998995,2505.966666746419,-1861,0,0,0.5663187952677141,-3460057954,1721.8495421084556,499.30449388756665,1222.545048220889,0.7843430530429291,0.27567666585801776,-1861
742,2019-01-13,2019,207396,207396,362769188.8833337,3207025.683333339,163088,0,168,0.8941059615421704,33016397,4366547733,614577,614577,303073236.80001235,3203890.766666555,164171,0,168,0.3157293553126762,3506380539,-407181,-407181,59695952.08332133,3134.9166667843238,-1083,0,0,0.5783766062294942,-3473364142,1749.1619360225543,493.1411959770905,1256.0207400454638,0.7863603926787401,0.26712844769654576,-1083
743,2019-01-14,2019,212991,212991,363652432.71666634,3275655.566666663,168369,0,170,0.8984558032968532,33625651,4376486066,627697,627697,304197641.6166785,3272477.9833331606,169419,0,170,0.31762458638483315,3518512772,-414706,-414706,59454791.099987864,3177.5833335025236,-1050,0,0,0.58083121691202,-3484887121,1707.3605585056005,484.6249729036119,1222.7355856019885,0.7904981900643689,0.2699057029107993,-1050
744,2019-01-15,2019,209657,209657,363770112.116667,3239040.1666666707,164774,0,183,0.8876593674430147,33390112,4377303490,632266,632265,304589424.3166778,3234735.933333174,165744,0,183,0.3051959143778057,3525182137,-422609,-422608,59180687.799989164,4304.2333334968425,-970,0,0,0.582463453065209,-3491792025,1735.0725810093008,481.7432948473786,1253.3292861619223,0.7859217674582771,0.2621428322889417,-970
745,2019-01-16,2019,209009,209009,364076204.0500002,3231947.8999999953,164038,0,199,0.8849618915931857,33398175,4380706694,643616,643616,305237710.2166753,3227737.3333332124,165057,0,199,0.30190206582806806,3536463077,-434607,-434607,58838493.83332491,4210.566666782834,-1019,0,0,0.5830598257651176,-3503064902,1741.9163961838974,474.25438493865175,1267.6620112452456,0.7848370165878025,0.25645260528016706,-1019
746,2019-01-17,2019,210808,210808,364387911.4833333,3244218.65,165969,0,134,0.8906587985275697,33352456,4385501744,655123,655123,305833595.1166762,3240199.649999897,167144,0,136,0.30791469693477097,3547893412,-444315,-444315,58554316.36665708,4019.000000102911,-1175,0,-2,0.5827441015927988,-3514540956,1728.529806664516,466.8338542787785,1261.6959523857374,0.7872993434784259,0.2551337687731922,-1175
747,2019-01-18,2019,215645,215645,364618088.2833332,3271018.6666666684,168094,0,99,0.8788935519024319,33584865,4387761483,669479,669479,306389395.55000776,3266294.9166661478,169156,0,99,0.2954357044806417,3557970758,-453834,-453834,58228692.73332542,4723.750000520609,-1062,0,0,0.5834578474217902,-3524385893,1690.8256082141165,457.6534821107275,1233.172126103389,0.7794940759117995,0.2526681195377301,-1062
748,2019-01-19,2019,212622,212622,364946052.06666684,3250565.816666666,165523,0,83,0.8788319176754998,33331785,4389749024,675558,675558,307000319.20001024,3246708.899999519,166511,0,83,0.285153902403643,3569024202,-462936,-462936,57945732.8666566,3856.916667147074,-988,0,0,0.5936780152718568,-3535692417,1716.4077662079505,454.43961761981984,1261.9681485881306,0.7784848228311275,0.24647920681865954,-988
749,2019-01-20,2019,204202,204202,364671537.5666661,3180282.466666665,159285,0,80,0.8744870275511505,32198651,4384155817,680631,680631,307165728.3333409,3176233.7333332407,160212,0,76,0.2707810840235019,3578892581,-476429,-476429,57505809.23332524,4048.7333334241994,-927,0,4,0.6037059435276486,-3546693930,1785.8372472682252,451.29553066689715,1334.541716601328,0.7800364345109254,0.2353874566395007,-927
750,2019-01-21,2019,211366,211366,365314553.8666668,3221394.83333333,163602,0,156,0.8610656396960717,32471781,4391598832,699367,699367,308044022.53334653,3218519.83333319,164437,0,157,0.26828117426186043,3590583299,-488001,-488001,57270531.33332026,2875.000000140164,-835,0,-1,0.5927844654342114,-3558111518,1728.3506044806961,440.46119209706285,1287.8894123836333,0.7740223120085539,0.2351226180245851,-835
751,2019-01-22,2019,211168,211168,361903561.7333339,3252894.7833333346,163597,0,80,0.8638761554781034,32539800,4323513360,710988,710988,307343838.03334343,3252951.9499998535,164836,0,56,0.2642435596662688,3571837776,-499820,-499820,54559723.69999045,-57.16666651889682,-1239,0,24,0.5996325958118346,-3539297976,1713.8182003586428,432.27711020909413,1281.5410901495486,0.7747243900590999,0.23184076243199603,-1239
752,2019-01-23,2019,211580,211580,362448795.8500003,3269593.750000001,163970,0,82,0.8748227620758101,33422086,4329570271,717956,717956,307919789.5500116,3265094.6999998814,164964,0,82,0.2697853350344627,3580980199,-506376,-506376,54529006.29998875,4499.050000119489,-994,0,0,0.6050374270413474,-3547558113,1713.0579253710196,428.8839281933873,1284.1739971776324,0.7749787314490972,0.22976895520059726,-994
753,2019-01-24,2019,210923,210923,362870626.68333346,3261027.4499999974,164940,0,82,0.8771779274901275,32979214,4332709494,723397,723397,308527771.1833365,3257593.76666624,165893,0,67,0.26647331962947113,3588068963,-512474,-512474,54342855.49999696,3433.6833337573335,-953,0,15,0.6107046078606564,-3555089749,1720.3938246816774,426.4985494594759,1293.8952752222015,0.7819915324549718,0.22932497646520514,-953
754,2019-01-25,2019,211680,211680,363257910.0333333,3223681.4166666646,165293,0,86,0.878547808012094,32668594,4337046115,734262,734262,309196379.8333413,3220074.2499995194,166215,0,86,0.263612988279384,3598837457,-522582,-522582,54061530.199992,3607.1666671452112,-922,0,0,0.61493481973271,-3566168863,1716.0710035588309,421.09816364368754,1294.9728399151434,0.7808626228269085,0.22637015125391208,-922
755,2019-01-26,2019,199417,199417,362523815.4166665,3152146.449999999,156002,0,89,0.8775229794852,32272541,4330716344,738950,738950,308841120.66666216,3148726.466666651,156935,0,91,0.24534000947289952,3608483729,-539533,-539533,53682694.75000435,3419.983333347831,-933,0,-2,0.6321829700123005,-3576211188,1817.9183089539333,417.94589710624825,1399.9724118476852,0.782290376447344,0.2123756681778199,-933
756,2019-01-27,2019,200104,200104,362708365.30000025,3120450.8499999996,156026,0,143,0.8747651221364902,32154336,4335702605,751093,751093,309164368.91667384,3117229.0499995444,156951,0,143,0.2410180896373612,3620453939,-550989,-550989,53543996.38332641,3221.8000004552305,-925,0,0,0.633747032499129,-3588299603,1812.5992748770652,411.61929204063125,1400.979982836434,0.7797245432375165,0.20896347056889095,-925
757,2019-01-28,2019,203686,203686,362979277.1833334,3150571.849999999,157888,0,147,0.8668489734198719,32377654,4340502613,763541,763541,309654615.8499938,3146556.6499999985,158735,0,148,0.23805008506419764,3635093812,-559855,-559855,53324661.33333957,4015.200000000652,-847,0,-1,0.6287988883556742,-3602716158,1782.0531464279989,405.55073774688435,1376.5024086811145,0.7751539133764717,0.20789322380854466,-847
758,2019-01-29,2019,197356,197356,362895703.0166674,3086599.816666668,153164,0,168,0.8676604714323355,31871628,4340988063,767912,767912,309884488.2166638,3082368.4333333196,154084,0,168,0.23260347539822745,3636237542,-570556,-570556,53011214.80000365,4231.383333348203,-920,0,0,0.635056996034108,-3604365914,1838.7872829641228,403.54166651473577,1435.245616449387,0.7760797746204828,0.20065319984581567,-920
759,2019-01-30,2019,195348,195348,362414586.40000004,3038306.4999999977,151903,0,153,0.8593484448266686,31611753,4337841650,777727,777727,309659163.41666365,3034752.4000000176,152736,0,153,0.22195063306276086,3643504633,-582379,-582379,52755422.98333639,3554.0999999800697,-833,0,0,0.6373978117639078,-3611892880,1855.225476585376,398.1592042151856,1457.0662723701905,0.7776020230562893,0.19638767845272184,-833
760,2019-01-31,2019,184380,184380,362034953.666666,2931738.5833333326,143137,0,157,0.8411921032649972,30120234,4336167760,782064,782064,309510974.14999545,2930968.550000019,144457,0,157,0.2013748235438505,3651504832,-597684,-597684,52523979.516670525,770.0333333136514,-1320,0,0,0.6398172797211467,-3621384598,1963.5261615504176,395.76169488685764,1567.76446666356,0.7763152185703438,0.18471250434747027,-1320
761,2019-02-01,2019,179734,179734,361375266.03333336,2881433.0833333354,139439,0,179,0.860555042451623,30576273,4332796962,446863,446863,309183716.9666683,2879483.633333112,141147,0,179,0.356711117277556,3625548972,-267129,-267129,52191549.06666505,1949.450000223238,-1708,0,0,0.503843925174067,-3594972699,2010.6116039999854,691.8982260036483,1318.713377996337,0.7758075823160894,0.31586190845963974,-1708
762,2019-02-02,2019,173597,173597,360525817.5833343,2817134.266666667,134145,0,199,0.8644216201892887,29765208,4326077035,451777,451777,308272707.86666906,2813029.083333062,134938,0,199,0.3423968019620252,3626954746,-278180,-278180,52253109.71666527,4105.183333605062,-793,0,0,0.5220248182272635,-3597189538,2076.797511381731,682.3559142379295,1394.4415971438016,0.772738008145302,0.29868275720100845,-793
763,2019-02-03,2019,166520,166520,359640437.05000025,2704396.6500000004,126697,0,171,0.848204419889503,28797294,4320932817,457985,457985,307592356.0500013,2700786.316666431,127415,0,171,0.31744489448344104,3636875472,-291465,-291465,52048080.99999893,3610.333333569579,-718,0,0,0.530759525406062,-3608078178,2159.743196312757,671.6210269987038,1488.1221693140533,0.7608515493634398,0.27820780156555347,-718
764,2019-02-04,2019,161198,161198,359036358.8166668,2686073.999999997,124118,0,180,0.8418838943411219,28513674,4320046481,467113,467112,307102239.6166699,2682913.3499999,124672,0,180,0.29847167601843255,3647284795,-305915,-305914,51934119.19999689,3160.65000009723,-554,0,0,0.5434122183226893,-3618771121,2227.300331373012,657.448833720114,1569.851497652898,0.76997233216293,0.2668990158698217,-554
765,2019-02-05,2019,163556,163556,358689006.55,2717570.3666666658,126691,0,186,0.8604881508474161,28389676,4318053383,481885,481885,306985805.450001,2722034.116666398,127972,0,186,0.30638637849279526,3654221365,-318329,-318329,51703201.09999901,-4463.749999732245,-1281,0,0,0.5541017723546209,-3625831689,2193.0654121524126,637.052005042699,1556.0134071097136,0.7746031940130598,0.2655654357367422,-1281
766,2019-02-06,2019,167886,167886,358952040.4666666,2763381.066666668,130699,0,198,0.8835459776276765,28512186,4319536540,497408,497408,307344716.5333328,2778288.2166664237,133932,0,198,0.32364577972207736,3658548521,-329522,-329522,51607323.933333755,-14907.1499997559,-3233,0,0,0.5599001979055991,-3630036335,2138.0701217889914,617.8925882441232,1520.1775335448683,0.7784985049378745,0.26925984302624806,-3233
767,2019-02-07,2019,168288,168288,359205670.2666669,2750485.23333334,131126,0,216,0.8675306617227628,28537233,4323165771,500231,500230,305556502.53333277,2747685.2666664375,131992,0,218,0.30833954712922756,3627177621,-331943,-331942,53649167.733334124,2799.9666669024155,-866,0,-2,0.5591911145935353,-3598640388,2134.469898428093,610.8320223363908,1523.6378760917023,0.7791761741776003,0.26386209571178115,-866
768,2019-02-08,2019,168371,168371,359189925.0000002,2742930.7666666647,130187,0,230,0.8658735768036064,28651803,4323100048,507264,507264,305784277.58333397,2741758.5333330743,130965,0,230,0.3045751324753927,3631400151,-338893,-338893,53405647.41666621,1172.2333335904405,-778,0,0,0.5612984443282137,-3602748348,2133.324176966343,602.8109181478164,1530.5132588185268,0.7732151023632335,0.2581791729750189,-778
769,2019-02-09,2019,167893,167893,358659006.3333336,2736369.7,130063,0,217,0.8621562542809996,28079808,4320419205,517635,517635,305660396.16667247,2737740.8666665927,130855,0,220,0.2894201512648886,3634376352,-349742,-349742,52998610.16666114,-1371.1666665924713,-792,0,-3,0.572736103016111,-3606296544,2136.2356163350087,590.4940666042143,1545.7415497307943,0.7746779198656287,0.2527939571319559,-792
770,2019-02-10,2019,174721,174721,358865304.98333424,2794161.000000003,135070,0,218,0.8484669845067282,29005912,4322725326,532171,532171,306142788.21667516,2795092.3499999363,135693,0,218,0.2831721382788508,3637351201,-357450,-357450,52722516.76665908,-931.3499999335036,-623,0,0,0.5652948462278774,-3608345289,2053.933442364308,575.2714601447188,1478.6619822195894,0.7730610516194389,0.25498007219483965,-623
771,2019-02-11,2019,181744,181744,359231538.30000013,2875671.433333334,140620,0,211,0.8734043489743822,30013823,4327080441,546124,546124,306753865.80000675,2874403.999999913,141664,0,211,0.30726904512528275,3638484596,-364380,-364380,52477672.499993384,1267.433333421126,-1044,0,0,0.5661353038490995,-3608470773,1976.5799052513432,561.6927031223802,1414.887202128963,0.7737256800774716,0.25939896433776943,-1044
772,2019-02-12,2019,187759,187759,359647419.95000005,2942644.6166666658,142286,0,88,0.8634632694038636,25868101,4326852240,557842,557842,307479035.43333614,2940442.1333331903,143828,0,74,0.31647133059182325,3631534150,-370083,-370083,52168384.51666391,2202.483333475422,-1542,0,14,0.5469919388120403,-3605666049,1915.4736654434678,551.1937706973232,1364.2798947461447,0.7578118758621424,0.2578292778241868,-1542
773,2019-02-13,2019,192167,192167,360048759.48333305,2999687.4166666656,148208,0,169,0.8719915490172601,30815901,4329818686,566540,566540,307951540.4000082,2995664.733333201,149008,0,169,0.3083683411586058,3629860428,-374373,-374373,52097219.08332485,4022.6833334644325,-800,0,0,0.5636232078586543,-3599044527,1873.624292845978,543.5653976771423,1330.0588951688358,0.7712458434590747,0.26301408550146504,-800
774,2019-02-14,2019,197753,197753,360589603.33333373,3060945.8500000006,152697,0,134,0.8541564476897959,31170727,4333304730,579380,579380,308872536.33333695,3055939.599999872,153441,0,134,0.29680002761573426,3631959639,-381627,-381627,51717066.99999678,5006.2500001285225,-744,0,0,0.5573564200740617,-3600788912,1823.43430103884,533.1087305970813,1290.3255704417588,0.7721602200725147,0.26483654941489176,-744
775,2019-02-15,2019,201753,201753,361379590.9999999,3082751.7999999966,155970,0,170,0.8505647995321002,32250479,4341401686,591877,591877,309890770.58334243,3078575.083333198,156616,0,173,0.2934646894540537,3638652147,-390124,-390124,51488820.41665745,4176.716666798573,-646,0,-3,0.5571001100780465,-3606401668,1791.1981036217546,523.5729223864797,1267.6251812352748,0.7730740063344783,0.26460903194413704,-646
776,2019-02-16,2019,195743,195743,361594871.51666665,3052743.683333333,151300,0,131,0.858906831917362,31499639,4345591623,601035,601034,310320437.2500088,3049369.9666665373,152145,0,131,0.2872661325879498,3646058245,-405292,-405291,51274434.26665783,3373.716666795779,-845,0,0,0.5716406993294121,-3614558606,1847.2940105989314,516.3109528745608,1330.9830577243706,0.7729522894816162,0.2531383363697622,-845
777,2019-02-17,2019,194736,194736,362030467.74999994,3054132.3000000035,151093,0,99,0.8664756388135731,31482167,4350863193,611144,611144,310932377.1000089,3049897.566666535,151849,0,99,0.28482158051130735,3657995533,-416408,-416408,51098090.649991035,4234.733333468437,-756,0,0,0.5816540583022658,-3626513366,1859.0834142120611,508.7710541214655,1350.3123600905956,0.7758863281570947,0.24846680978623695,-756
778,2019-02-18,2019,202105,202105,362777620.86666644,3112229.5333333374,155989,0,102,0.8565696049083403,32265278,4359004897,627230,627229,311890589.23334515,3108332.3499998953,156648,0,102,0.2797394895014603,3669027720,-425125,-425124,50887031.633321285,3897.1833334420808,-659,0,0,0.57683011540688,-3636762442,1794.9957738139406,497.25154486375015,1297.7442289501905,0.7718215778926796,0.24974570731629545,-659
779,2019-02-19,2019,202468,202468,363502975.2333331,3134777.899999999,156490,0,64,0.8622498370112819,31786229,4365994407,635264,635264,312782175.7666741,3129313.2333332393,157221,0,62,0.284266068909935,3671395907,-432796,-432796,50720799.46665901,5464.666666759644,-731,0,2,0.5779837681013469,-3639609678,1795.360132136106,492.3656554860249,1302.994476650081,0.7729122626785467,0.24748923282288937,-731
780,2019-02-20,2019,209014,209014,364063262.5999999,3196845.499999993,161412,0,134,0.8655066167816515,32116401,4367477753,650483,650483,313730716.8000101,3191216.116666562,162522,0,134,0.29666109644679634,3682253002,-441469,-441469,50332545.79998982,5629.383333431091,-1110,0,0,0.5688455203348552,-3650136601,1741.8128096682515,482.3042520711688,1259.5085575970827,0.7722544901298478,0.2498481897297854,-1110
781,2019-02-21,2019,208106,208106,364847028.6666658,3202108.0500000045,161432,0,185,0.8722477967958636,32082428,4372903234,659858,659858,314736716.1166743,3196773.266666543,162350,0,185,0.2875285288652983,3690444644,-451752,-451752,50110312.54999149,5334.783333461266,-918,0,0,0.5847192679305653,-3658362216,1753.178806313445,476.97643450056574,1276.2023718128792,0.7757200657357308,0.24603778388683625,-918
782,2019-02-22,2019,207408,207408,365491485.8999996,3191422.0666666706,160607,0,77,0.86651913137391,32436485,4381006452,675174,675174,315589360.1833421,3195984.149999913,162383,0,80,0.28070393705918234,3699389544,-467766,-467766,49902125.71665752,-4562.083333242219,-1776,0,-3,0.5858151943147276,-3666953059,1762.1860579148326,467.41930255510744,1294.7667553597253,0.7743529661343824,0.24050541045715623,-1776
783,2019-02-23,2019,206172,206172,365440660.3333333,3179781.7333333394,160426,0,73,0.8809295151620976,32441007,4381433694,689640,689640,315858379.4500097,3176413.1333332215,162258,0,55,0.2769415927150418,3706979384,-483468,-483468,49582280.88332361,3368.6000001179054,-1832,0,18,0.6039879224470558,-3674538377,1772.5038333689022,458.0047263064928,1314.4991070624094,0.7781173001183478,0.23527927614407518,-1832
784,2019-02-24,2019,212256,212256,365949531.7666663,3242065.966666669,163567,0,65,0.8649649479873349,32987651,4385293267,702417,702417,315622520.8833425,3237720.549999846,164516,0,54,0.26691979265878035,3708110020,-490161,-490161,50327010.88332379,4345.416666822974,-949,0,11,0.5980451553285546,-3675122369,1724.095110464092,449.33781625920574,1274.7572942048862,0.7706119026081713,0.23421414914502353,-949
785,2019-02-25,2019,215847,215847,366861689.6333335,3290097.4666666654,167467,0,120,0.8658308894726355,33180392,4395071144,714168,714168,316640316.6999981,3287020.8333332455,168258,0,120,0.26647231463745585,3716626933,-498321,-498321,50221372.93333542,3076.6333334199153,-791,0,0,0.5993585748351797,-3683446541,1699.6376583104397,443.3695106753566,1256.268147635083,0.7758597525098797,0.23560002688443055,-791
786,2019-02-26,2019,219974,219974,367455831.31666654,3329747.6999999965,170420,0,178,0.8716211915953704,33236411,4401375356,726345,726345,317460937.65000296,3326206.066666213,171314,0,178,0.2728042459161953,3720768158,-506371,-506371,49994893.66666359,3541.6333337835968,-894,0,0,0.5988169456791752,-3687531747,1670.4511956716092,437.0663219957499,1233.3848736758594,0.774727922390828,0.23585761587124576,-894
787,2019-02-27,2019,219206,219206,368188482.19999987,3347137.800000004,170676,0,131,0.8767734459823187,33783372,4409296545,734438,734438,318408443.6000035,3342595.399999569,171621,0,132,0.26903019723926413,3731171413,-515232,-515232,49780038.59999639,4542.4000004348345,-945,0,-1,0.6077432487430545,-3697388041,1679.6460051275963,433.54026289489855,1246.1057422326976,0.7786100745417552,0.2336766343789401,-945
788,2019-02-28,2019,217245,217245,368760848.9833338,3303421.28333333,169445,0,79,0.8759096872194988,32991968,4415524115,745146,745146,319146970.2499932,3300462.5499999933,170371,0,79,0.2643629570580816,3742169651,-527901,-527901,49613878.73334062,2958.733333336655,-926,0,0,0.6115467301614173,-3709177683,1697.4422839804545,428.3012594176084,1269.141024562846,0.7799719211029023,0.228641098522974,-926
789,2019-03-01,2019,215615,215615,369071776.81666696,3288486.400000001,168510,0,68,0.8735013797741354,32383343,4420081212,470384,470384,319614820.8833449,3286666.3499998627,169498,0,65,0.41139579577536295,3724563766,-254769,-254769,49456955.93332207,1820.0500001381151,-988,0,3,0.4621055839987725,-3692180423,1711.7166097751408,679.4763871291219,1032.240222646019,0.7815318971314612,0.36033963740263275,-988
790,2019-03-02,2019,209721,209721,369073351.8833333,3253823.349999994,164178,0,74,0.8879034526823739,31927441,4422048880,479499,479499,319833024.16667753,3251117.899999846,165116,0,66,0.4039674743847299,3732349106,-269778,-269778,49240327.71665579,2705.4500001482666,-938,0,8,0.483935978297644,-3700421665,1759.8302119641492,667.0149972506252,1092.8152147135238,0.7828400589354428,0.3443510831096624,-938
791,2019-03-03,2019,208732,208732,369152009.4500004,3224116.8333333298,162594,0,71,0.8673897629496196,32361112,4425690365,491365,491365,320035965.2666775,3220599.7666665334,163300,0,66,0.37437953456187467,3746005551,-282633,-282633,49116044.18332291,3517.066666796338,-706,0,5,0.4930102283877449,-3713644439,1768.545356964914,651.320230921367,1117.2251260435469,0.778960581032137,0.3323395032206201,-706
792,2019-03-04,2019,214805,214805,369776789.96666676,3282980.1499999953,167633,0,86,0.8723307185586923,33053310,4434204084,508992,508992,320901277.5333428,3279482.5333332513,168430,0,71,0.3757387149503409,3758993619,-294187,-294187,48875512.43332398,3497.6166667439975,-797,0,15,0.4965920036083514,-3725940309,1721.453364524414,630.4642853587931,1090.9890791656208,0.780396173273434,0.33090893373569724,-797
793,2019-03-05,2019,217702,217702,369980898.0833337,3298755.6333333342,169327,0,83,0.8631523826147669,33245058,4434935691,520008,520008,321338846.85000926,3293968.233333215,170153,0,65,0.36911355209920055,3762499133,-302306,-302306,48642051.23332441,4787.400000119116,-826,0,18,0.49403883051556635,-3729254075,1699.4832297513742,617.9498139451879,1081.5334158061864,0.7777925788463128,0.32721227365732836,-826
794,2019-03-06,2019,211442,211442,370227904.76666665,3267222.483333334,165608,0,75,0.8664314563804733,33149160,4438920856,527141,527141,321838645.5166795,3262624.6833332134,166291,0,65,0.354305584274411,3770561679,-315699,-315699,48389259.249987125,4597.80000012042,-683,0,10,0.5121258721060622,-3737412519,1750.9667179021512,610.536166825725,1140.4305510764261,0.7832313353070819,0.31545829294249544,-683
795,2019-03-07,2019,210895,210895,370493300.5,3266771.1333333324,164915,0,75,0.8801109556888516,33226829,4442313166,541391,541391,322344689.28333926,3262214.7333332505,165770,0,64,0.35515366897492323,3780481914,-330496,-330496,48148611.21666074,4556.400000081863,-855,0,11,0.5249572867139283,-3747255085,1756.7666397970554,595.4009011663276,1161.3657386307277,0.781976813106048,0.30619275163421633,-855
796,2019-03-08,2019,222592,222592,371035688.6333332,3359394.700000003,171390,0,84,0.8622771707878093,33908630,4446713810,565207,565207,323119318.91668594,3359066.1666665277,173199,0,70,0.34776462428809307,3789226631,-342615,-342615,47916369.71664727,328.53333347523585,-1809,0,14,0.5145125464997162,-3755318001,1666.8868990499802,571.6831513351497,1095.2037477148306,0.7699737636572743,0.30643463368288076,-1809
797,2019-03-09,2019,221771,221771,371182304.28333354,3338538.066666667,171671,0,69,0.8602026414634909,33429380,4448520602,576099,576099,323072009.8000067,3330974.049999878,172283,0,68,0.33485043369281847,3786137822,-354328,-354328,48110294.48332685,7564.0166667890735,-612,0,1,0.5253522077706725,-3752708442,1673.7188554109127,560.7925196884679,1112.926335722445,0.7740912923691555,0.299051031159575,-612
798,2019-03-10,2019,220973,220973,371260764.266667,3341987.75,170690,0,78,0.8656758970552965,33900507,4446542829,584949,584948,323283113.35001254,3335399.533333212,171270,0,59,0.33186311969077376,3789612737,-363976,-363975,47977650.91665447,6588.216666787863,-580,0,19,0.5338127773645227,-3755712230,1680.1182237950654,552.669832788577,1127.4483910064885,0.7724473125675988,0.2927947564659483,-580
799,2019-03-11,2019,229633,229633,371602624.93333346,3414900.4666666677,178269,0,85,0.8660950298955301,34147695,4446947464,603962,603962,323844044.85000634,3408600.966666518,178817,0,85,0.3341865878979157,3796473737,-374329,-374329,47758580.083327115,6299.500000149943,-548,0,0,0.5319084419976143,-3762326042,1618.245744006016,536.1993715664336,1082.0463724395822,0.7763213475415119,0.2960732628874002,-548
800,2019-03-12,2019,226539,226539,371721983.1666666,3397345.933333331,175990,0,136,0.8785330561183714,33594378,4443202306,610160,610160,324314303.9000112,3391708.583333207,176737,0,136,0.3357430837813066,3796722581,-383621,-383621,47407679.266655445,5637.350000123959,-747,0,0,0.5427899723370648,-3763128203,1640.8741239551098,531.5233773108876,1109.3507466442222,0.7768640278274381,0.2896568113281762,-747
801,2019-03-13,2019,225607,225607,371795390.11666656,3396636.383333333,176128,0,77,0.872583740752725,33849218,4440998706,623143,623143,324669534.61667955,3388978.666666525,176702,0,68,0.3224990090557078,3803350252,-397536,-397536,47125855.499987006,7657.716666807886,-574,0,9,0.5500847316970172,-3769501034,1647.9780774384951,521.0193079544816,1126.9587694840134,0.7806849964761732,0.283565730498457,-574
802,2019-03-14,2019,225995,225995,371996533.4500003,3382878.68333333,175851,0,77,0.8741874820239384,33873789,4441440321,633643,633643,325173728.6500126,3374894.016666557,176465,0,61,0.3215706636071138,3812089332,-407648,-407648,46822804.799987674,7984.666666772682,-614,0,16,0.5526168184168245,-3778215543,1646.0387771853373,513.1812844930231,1132.8574926923143,0.778118984933295,0.2784927790569769,-614
803,2019-03-15,2019,225885,225885,371800932.0166661,3377489.6999999965,175570,0,70,0.8663390663390657,33682803,4440244266,647605,647605,325420865.6666759,3370096.6166665154,175865,0,70,0.30715636846534555,3816994606,-421720,-421720,46380066.34999019,7393.083333481103,-295,0,0,0.5591826978737201,-3783311803,1645.9744206860398,502.4990011915843,1143.4754194944555,0.7772539123890475,0.27156214050231237,-295
804,2019-03-16,2019,228159,228159,371545118.1333332,3403076.083333329,177192,0,114,0.8771032481734224,33646780,4437374504,669049,669048,325419197.0166868,3398070.349999858,180236,0,117,0.31119095910762506,3823174499,-440890,-440889,46125921.11664641,5005.7333334707655,-3044,0,-3,0.5659122890657974,-3789527719,1628.4482230958813,486.3914054248526,1142.0568176710287,0.7766163070490316,0.26939133008195215,-3044
805,2019-03-17,2019,232767,232767,371262070.50000054,3447617.233333331,178689,0,76,0.8784707454235351,33265369,4427822692,677159,677159,322276880.58334327,3438975.7833331637,179515,0,68,0.3136264894950808,3766991278,-444392,-444392,48985189.91665727,8641.450000167359,-826,0,8,0.5648442559284543,-3733725909,1594.9944386446555,475.9249756458133,1119.0694629988423,0.7676732526517934,0.2651002201846243,-826
806,2019-03-18,2019,234650,234650,371664047.6666666,3487788.316666666,180556,0,81,0.8755550820370762,34473970,4432138548,689977,689977,323039752.6833452,3481442.966666556,181620,0,73,0.3138669839719273,3774579144,-455327,-455327,48624294.98332143,6345.350000109989,-1064,0,8,0.5616880980651489,-3740105174,1583.9081511470984,468.1891609189077,1115.7189902281907,0.7694694225442148,0.26322616550986483,-1064
807,2019-03-19,2019,234930,234930,372104597.7166669,3473957.0833333344,181489,0,118,0.8742859575192606,34240558,4434320442,700230,700230,323735305.2333471,3468091.1333332676,182357,0,118,0.3038558759264877,3771613144,-465300,-465300,48369292.48331976,5865.950000066776,-868,0,0,0.570430081592773,-3737372586,1583.8956187658744,462.3271000004957,1121.5685187653787,0.7725237304729068,0.26042443197235193,-868
808,2019-03-20,2019,225004,225004,371528110.0666668,3405142.9166666684,176430,0,151,0.8865353504826584,34165548,4430383422,705382,705382,323555862.5166751,3401280.349999858,177237,0,151,0.29353598475718473,3778670399,-480378,-480378,47972247.54999167,3862.5666668103077,-807,0,0,0.5929993657254737,-3744504851,1651.206689955142,458.6959442070752,1192.510745748067,0.7841193934330056,0.25126385419531544,-807
809,2019-03-21,2019,224429,224429,371597058.56666744,3396962.7333333315,177525,0,78,0.8849524794032858,33615132,4432346072,717712,717712,323843652.9500131,3393130.0499993702,178342,0,61,0.2883663642240918,3788200708,-493283,-493283,47753405.61665434,3832.683333961293,-817,0,17,0.596586115179194,-3754585576,1655.7443938469069,451.21671777817994,1204.527676068727,0.7910074010043265,0.24848685823840203,-817
810,2019-03-22,2019,222152,222152,371599441.1166666,3376719.9166666693,175738,0,93,0.8824093413518669,34208111,4434507065,727167,727167,324070826.10001415,3371449.999999391,176498,0,93,0.2766338406445761,3796250240,-505015,-505015,47528615.016652465,5269.91666727839,-760,0,0,0.6057755007072908,-3762042129,1672.7260664620017,445.6621740260685,1227.0638924359332,0.7910709784291836,0.24272003542514994,-760
811,2019-03-23,2019,216749,216749,371104708.5999998,3344396.4166666646,171329,0,66,0.8817572399411303,33877953,4425841515,736612,736612,323979676.06666905,3340044.4833328016,171945,0,69,0.26544639511710355,3806514137,-519863,-519863,47125032.53333074,4351.933333863039,-616,0,-3,0.6163108448240268,-3772636184,1712.140349436444,439.8240540022007,1272.3162954342433,0.7904488602023538,0.2334268244340304,-616
812,2019-03-24,2019,222886,222886,371025593.2333335,3373063.3500000015,175687,0,74,0.8816390441750492,34262931,4426172147,752550,752550,324152954.98332626,3367675.499999985,176183,0,65,0.2632011162049022,3815847133,-529664,-529664,46872638.25000727,5387.850000016391,-496,0,9,0.6184379279701471,-3781584202,1664.6428812636664,430.73942592960765,1233.9034553340587,0.788237035973547,0.23411467676566342,-496
813,2019-03-25,2019,235249,235249,371918491.59999925,3508773.2499999986,184382,0,118,0.8767093590195918,34598967,4435226827,773805,773805,325252754.5500084,3506182.78333284,186022,0,117,0.2708511834376873,3825592436,-538556,-538556,46665737.04999083,2590.466667158529,-1640,0,1,0.6058581755819045,-3790993469,1580.9567377544613,420.3290939577909,1160.6276437966703,0.7837737886239686,0.2403990669483914,-1640
814,2019-03-26,2019,242113,242113,372410101.2833331,3568343.7833333327,186106,0,136,0.8641832532742972,35580777,4434574157,786565,786565,325889100.38332653,3562149.1833332977,186931,0,136,0.2698238543540575,3820251776,-544452,-544452,46521000.90000659,6194.600000035018,-825,0,0,0.5943593989202398,-3784670999,1538.1664812849087,414.3193510813811,1123.8471302035277,0.7686741315005803,0.2376548664128203,-825
815,2019-03-27,2019,233942,233942,372812947.58333343,3517852.9833333367,182705,0,179,0.8741782151131476,34824937,4437972729,789588,789588,326479235.4333304,3511756.9166666553,183506,0,179,0.264606351666946,3824425394,-555646,-555646,46333712.150003016,6096.0666666813195,-801,0,0,0.6095718634462016,-3789600457,1593.6127227403947,413.4804929068456,1180.132229833549,0.7809841755648836,0.23240728075907943,-801
816,2019-03-28,2019,236636,236636,373125500.46666634,3536696.566666659,184843,0,147,0.8680927669500841,35046615,4443760664,805950,805950,326999833.18332744,3532371.8499999503,185570,0,149,0.25793659656306545,3835372881,-569314,-569314,46125667.283338904,4324.7166667087,-727,0,-2,0.6101561703870186,-3800326266,1576.7909382624214,405.7321585499441,1171.0587797124772,0.7811279771463344,0.230250015509647,-727
817,2019-03-29,2019,235775,235775,373375678.1333335,3509111.266666668,185239,0,189,0.8751945710953244,35402898,4445318038,815476,815476,327470354.7499946,3504273.8833332676,185953,0,189,0.2570081768194267,3842856450,-579701,-579701,45905323.38333893,4837.3833334003575,-714,0,0,0.6181863942758976,-3807453552,1583.6101288657978,401.5695799140558,1182.040548951742,0.785660057257979,0.22803000946686353,-714
818,2019-03-30,2019,223610,223610,372973208.3833335,3390080.349999999,176964,0,169,0.8733732838424042,34624252,4446434209,820508,820508,327298872.29999155,3384788.8666666644,177531,0,169,0.24079107089754087,3853701965,-596898,-596898,45674336.083341956,5291.483333334792,-567,0,0,0.6325822129448633,-3819077713,1667.9630087354478,398.897844140449,1269.0651645949988,0.791395733643397,0.21636717740716727,-567
819,2019-03-31,2019,218068,218068,372642525.1833331,3334729.7666666717,173279,0,133,0.8805922923124894,33575061,4444925362,829979,829979,327137637.36666155,3331628.6166666523,173951,0,133,0.23457340486928055,3865589156,-611911,-611911,45504887.81667155,3101.1500000194646,-672,0,0,0.6460188874432088,-3832014095,1708.8363500528876,394.15170428006195,1314.6846457728257,0.7946099381844195,0.20958482082076776,-672
820,2019-04-01,2019,236429,236429,373225224.6000004,3476825.233333334,185574,0,164,0.8721688117785878,34018212,4451254822,529606,529606,327852646.48333853,3472790.4999998054,186451,0,166,0.39421947636545057,3844606298,-293177,-293177,45372578.11666185,4034.7333335285075,-877,0,-2,0.4779493354131373,-3810588086,1578.5932546345853,619.0500985323779,959.5431561022074,0.7849037131654746,0.35205605676672846,-877
821,2019-04-02,2019,232938,232938,372639303.4499999,3502347.833333335,182874,0,172,0.8665868170929607,34927035,4445133923,536679,536679,327312270.86668056,3494921.6499998905,183312,0,174,0.3808701290715689,3831389069,-303741,-303741,45327032.583319366,7426.183333444409,-438,0,-2,0.4857166880213918,-3796462034,1599.7359960590368,609.8846253844115,989.8513706746253,0.785075857095021,0.34156730559608256,-438
822,2019-04-03,2019,226448,226448,372108036.5666664,3437413.9333333317,176995,0,204,0.8592877835087969,34210126,4442366979,541815,541815,327161646.9000059,3434894.94999988,177842,0,204,0.36390649945091813,3839091833,-315367,-315367,44946389.66666055,2518.9833334516734,-847,0,0,0.49538128405787873,-3804881707,1643.2383441967534,603.8253774812545,1039.412966715499,0.7816143220518618,0.3282338067421537,-847
823,2019-04-04,2019,225624,225624,372168421.4833336,3390749.3166666673,175345,0,84,0.8540802396908135,34411590,4445207064,553261,553261,327401329.4000114,3385464.5166665465,176235,0,86,0.3526436889641582,3847232461,-327637,-327637,44767092.08332217,5284.800000120886,-890,0,-2,0.5014365507266553,-3812820871,1649.507239847417,591.7665069470131,1057.7407329004038,0.7771557990284721,0.3185386282423666,-890
824,2019-04-05,2019,230451,230451,372208295.4666669,3448392.45,179261,0,56,0.8564944391649417,35709930,4448321389,571816,571816,327559847.21667445,3443059.4999998705,180011,0,51,0.348825496313494,3853314422,-341365,-341365,44648448.24999243,5332.95000012964,-750,0,5,0.5076689428514477,-3817604492,1615.1298777903628,572.8413461964591,1042.2885315939038,0.77787034987915,0.31480581165969473,-750
825,2019-04-06,2019,234631,234631,372595225.53333354,3497267.033333335,183151,0,81,0.8621239307678877,35361951,4453169359,583634,583634,328113236.30001575,3491647.133333223,184082,0,81,0.3516244769838609,3864108729,-349003,-349003,44481989.23331779,5619.900000112131,-931,0,0,0.5104994537840268,-3828746778,1588.0051039007358,562.1900648351805,1025.8150390655553,0.7805916524244452,0.3154065732976489,-931
826,2019-04-07,2019,238998,238998,373142790.5000003,3515908.2666666633,185246,0,59,0.8537100728876389,34812118,4458757255,598789,598789,328801897.06667423,3512037.783333199,186083,0,55,0.3440443962731429,3875783541,-359791,-359791,44340893.433326066,3870.4833334642462,-837,0,4,0.509665676614496,-3840971423,1561.2799709621013,549.1114517245211,1012.1685192375802,0.7750943522539938,0.31076556182561804,-837
827,2019-04-08,2019,241071,241071,373845559.8333337,3560333.3666666676,187334,0,61,0.8510272907151837,35270088,4466374787,612333,612333,329656482.3333459,3555893.166666489,188174,0,55,0.3387535866922158,3886279095,-371262,-371262,44189077.49998778,4440.2000001785345,-840,0,6,0.5122737040229679,-3851009007,1550.7695236396485,538.3614509316759,1012.4080727079726,0.7770905666795259,0.30730664524041656,-840
828,2019-04-09,2019,226433,226433,373958171.26666665,3447511.9,178001,0,65,0.8601484765913084,34862412,4471629159,613110,613110,329958643.2166709,3442904.1333331955,178581,0,62,0.32067328864314587,3889960863,-386677,-386677,43999528.04999578,4607.76666680444,-580,0,3,0.5394751879481625,-3855098451,1651.5179822140176,538.1720135321082,1113.3459686819094,0.7861089152199547,0.291270734452219,-580
829,2019-04-10,2019,232734,232734,374043333.5666667,3489148.683333335,183546,0,59,0.8567721089312268,34430714,4473398236,632058,632058,330285646.4500181,3484605.749999607,184037,0,56,0.31733796581959317,3899413132,-399324,-399324,43757687.116648614,4542.933333727997,-491,0,3,0.5394341431116336,-3864982418,1607.170991632794,522.5559148844221,1084.6150767483718,0.7886514217948387,0.2911710634150663,-491
830,2019-04-11,2019,236643,236643,374484150.5500003,3540621.7833333313,185515,0,59,0.859070414083662,34819804,4477577602,643107,643107,330850466.7000123,3535545.866666522,186270,0,55,0.3196513177433828,3907146952,-406464,-406464,43633683.84998798,5075.9166668094695,-755,0,4,0.5394190963402792,-3872327148,1582.4856452546676,514.4563295066176,1068.02931574805,0.7839445916422628,0.28964075962475916,-755
831,2019-04-12,2019,237947,237947,374753968.7833334,3546074.583333332,186779,0,56,0.8578927240099689,35851348,4482521929,654543,654543,331193498.8833425,3543921.1999994596,187485,0,52,0.31489604197127513,3912890806,-416596,-416596,43560469.899990916,2153.383333872538,-706,0,4,0.5429966820386938,-3877039458,1574.9472310360434,505.99196520830947,1068.955265827734,0.7849605164175215,0.2864364908035072,-706
832,2019-04-13,2019,235850,235850,374921613.4833334,3532020.016666667,185041,0,67,0.8569217723129107,35802589,4485043101,664642,664642,331581065.8333441,3525965.3166665677,185729,0,68,0.3064085628052288,3921327857,-428792,-428792,43340547.64998931,6054.700000099372,-688,0,-1,0.5505132095076819,-3885525268,1589.6612825242034,498.8867177117066,1090.774564812497,0.7845707017171931,0.27944216585770987,-688
833,2019-04-14,2019,230319,230319,374437553.1333336,3456883.3666666704,180743,0,73,0.8589912252137254,34984251,4480857679,672964,672964,331345477.75000954,3451326.3333332296,181352,0,73,0.2961644307867862,3932905378,-442645,-442645,43092075.38332409,5557.033333440777,-609,0,0,0.5628267944269392,-3897921127,1625.734538328725,492.3673149678282,1133.3672233608968,0.7847507153122408,0.26948246860158936,-609
834,2019-04-15,2019,242374,242374,375183211.366666,3591688.549999995,187324,0,47,0.8477146888692679,35450838,4489083225,694650,694650,332223321.05001354,3585343.8333332087,188237,0,43,0.2992902900741372,3943795549,-452276,-452276,42959890.31665248,6344.716666786466,-913,0,4,0.5484243987951307,-3908344711,1547.9515598482758,478.2600173468848,1069.691542501391,0.772871677655194,0.2709810696033974,-913
835,2019-04-16,2019,240667,240667,375440213.8999993,3532212.0833333363,189278,0,52,0.8579115541391216,34029045,4487370505,699004,699004,332578344.30000997,3526918.2333334973,189959,0,48,0.29812275752356476,3943703490,-458337,-458337,42861869.599989355,5293.849999838974,-681,0,4,0.5597887966155568,-3909674445,1559.9987281181022,475.7889000635332,1084.209828054569,0.7864725949133035,0.27175667092033806,-681
836,2019-04-17,2019,236522,236522,375323008.1166671,3468452.566666671,185779,0,56,0.8553749756893664,28656198,4483759217,709687,709687,332602654.2500119,3463429.316666688,186515,0,60,0.28790015880238246,3943651126,-473165,-473165,42720353.86665517,5023.249999983236,-736,0,-4,0.5674748168869839,-3914994928,1586.8418503000444,468.6610495190301,1118.1808007810143,0.7854618175053484,0.26281304293301133,-736
837,2019-04-18,2019,244168,244168,376261483.43333286,3630323.133333337,191426,0,52,0.8616813013990366,35260101,4493287867,724507,724507,333658062.8166609,3627390.699999941,192650,0,50,0.2932559657808668,3948136545,-480339,-480339,42603420.61667198,2932.4333333959803,-1224,0,2,0.5684253356181699,-3912876444,1540.9942475399432,460.5311788797912,1080.463068660152,0.7839929884341929,0.265904953299278,-1224
838,2019-04-19,2019,245875,245875,376661086.01666695,3655585.966666665,193731,0,58,0.871792577529232,36127808,4497023375,746059,746059,333978027.41665375,3651537.766666646,200061,0,47,0.29753544960921313,3953610853,-500184,-500184,42683058.6000132,4048.2000000188127,-6330,0,11,0.5742571279200188,-3917483045,1531.9210412472473,447.6563213052235,1084.264719942024,0.7879247585155058,0.2681570760489452,-6330
839,2019-04-20,2019,245767,245767,376957422.0499999,3664370.4166666684,192917,0,61,0.8678504437129484,36301894,4500782741,747108,747108,328159671.4166621,3658793.516666583,193806,0,48,0.2891817515004539,3837372517,-501341,-501341,48797750.633337796,5576.9000000855885,-889,0,13,0.5786686922124945,-3801070623,1533.7999896243186,439.2399377555348,1094.5600518687838,0.7849589245098,0.25940827832120655,-889
840,2019-04-21,2019,241842,241842,376288973.03333324,3634063.7666666615,190661,0,57,0.8703409664160897,36497528,4488653559,755439,755438,327452293.6333302,3627524.416666611,191519,0,54,0.28292290972533285,3840913718,-513597,-513596,48836679.400003016,6539.350000050385,-858,0,3,0.5874180566907569,-3804416190,1555.9289661569671,433.46018287844964,1122.4687832785175,0.7883700928705518,0.2535201386213844,-858
841,2019-04-22,2019,240221,240221,376036100.1833331,3598875.133333337,189949,0,62,0.8750483929381694,36001313,4484692632,766231,766231,327474779.65000844,3593680.416666152,190776,0,62,0.27873970121282826,3849061952,-526010,-526010,48561320.53332466,5194.716667185072,-827,0,0,0.5963086917253411,-3813060639,1565.3756340342147,427.38388247148504,1137.9917515627296,0.7907260397717102,0.24897974631671127,-827
842,2019-04-23,2019,238023,238023,376025542.9333332,3573238.33333333,187084,0,73,0.8679371321258876,35218157,4486872603,775530,775530,327649995.26666045,3568663.3166666236,187882,0,73,0.2699237940505166,3853924074,-537507,-537507,48375547.666672766,4575.016666706651,-798,0,0,0.598013338075371,-3818705917,1579.7865875706684,422.48526203584703,1157.3013255348214,0.7859912697512426,0.24226271066238572,-798
843,2019-04-24,2019,238987,238987,376005963.8499995,3564957.699999998,187252,0,79,0.8605405314933441,34762729,4488850616,787393,787393,327827274.5833271,3558852.199999947,188035,0,79,0.2647458130819025,3854741502,-548406,-548406,48178689.26667237,6105.500000050757,-783,0,0,0.5957947184114416,-3819978773,1573.3322894132295,416.34517271975636,1156.9871166934731,0.7835237899969454,0.23880705060878113,-783
844,2019-04-25,2019,241242,241242,376279641.09999955,3590833.016666665,189648,0,105,0.8598834365491904,34983391,4493189904,796848,796848,328261865.76666194,3585118.049999967,190371,0,106,0.2627125875951248,3857651247,-555606,-555606,48017775.333337605,5714.96666669799,-723,0,-1,0.5971708489540657,-3822667856,1559.7600795052253,411.95041685071925,1147.8096626545062,0.7861317681000821,0.2389050358412144,-723
845,2019-04-26,2019,239537,239537,376433811.55000025,3620926.2000000016,190677,0,96,0.87084250032354,35143037,4495419231,806815,806815,328654419.18333304,3615653.8499994534,191345,0,96,0.2612284104782475,3862212442,-567278,-567278,47779392.36666721,5272.3500005481765,-668,0,0,0.6096140898452925,-3827069405,1571.5059116128207,407.3479288106109,1164.1579828022097,0.7960231613487687,0.23716093528256169,-668
846,2019-04-27,2019,238031,238031,376430436.9666662,3616954.6166666676,189353,0,136,0.8798853930790523,36143876,4497294121,815044,815044,328813587.1499935,3611430.8833333035,190206,0,136,0.26236006890425534,3869521919,-577013,-577013,47616849.81667274,5523.733333364129,-853,0,0,0.617525324174797,-3833378043,1581.434506289795,403.430473876249,1178.0040324135462,0.7954972251513458,0.2333689960296622,-853
847,2019-04-28,2019,236467,236467,375387375.76666665,3606833.766666663,188174,0,249,0.889612504070336,34123206,4482712469,825773,825773,327923814.4333265,3600960.983333258,188979,0,249,0.25934609148034216,3877020167,-589306,-589306,47463561.33334017,5872.783333404921,-805,0,0,0.6302664125899938,-3842896961,1587.4831404241042,397.1113301516597,1190.3718102724447,0.7957727716763862,0.22885102806703536,-805
848,2019-04-29,2019,240730,240730,375008229.38333344,3634884.349999997,192340,0,354,0.8834087982386905,35784051,4479864525,838779,838779,327899653.5166698,3629438.0333328433,193274,0,354,0.25634285073897983,3882205745,-598049,-598049,47108575.866663635,5446.3166671535,-934,0,0,0.6270659474997107,-3846421694,1557.7959929519936,390.9249677408111,1166.8710252111825,0.7989864163170357,0.23042303157327496,-934
849,2019-04-30,2019,239599,239599,373175646.40000033,3501476.7333333353,191360,0,427,0.8792649385014127,33807721,4462662039,845070,845070,326348040.0500004,3497569.1499996656,192104,0,427,0.25187735927201593,3874721392,-605471,-605471,46827606.349999905,3907.583333669696,-744,0,0,0.6273875792293968,-3840913671,1557.5008510052226,386.17870714852074,1171.3221438567018,0.7986677740725128,0.22732318032825682,-744
850,2019-05-01,2019,220368,220368,370500368.26666677,3351744.150000002,173540,0,513,0.8629928120235237,32464542,4444949320,507357,507357,323817149.7833357,3351731.333333132,174941,0,518,0.38026084197123666,3817622955,-286989,-286989,46683218.483331084,12.816666869912297,-1401,0,-5,0.4827319700522871,-3785158413,1681.2802596868273,638.2431892796112,1043.037070407216,0.7875009075727873,0.34480848790890833,-1401
851,2019-05-02,2019,227427,227427,370838034.8833328,3511812.150000002,178605,0,582,0.8608080834729389,35098622,4449428365,524674,524674,324114227.63333285,3504136.7333330894,179208,0,584,0.3758791173185619,3821289349,-297247,-297247,46723807.24999994,7675.416666912381,-603,0,-2,0.48492896615437703,-3786190727,1630.5805154327884,617.7440232093315,1012.8364922234568,0.7853289187299661,0.34156066433633075,-603
852,2019-05-03,2019,227970,227970,370773771.71666723,3526976.983333329,178888,0,574,0.863468877483879,35364174,4451168803,531150,531150,324141882.3666717,3524113.749999768,180099,0,574,0.37510119551915494,3814396773,-303180,-303180,46631889.34999555,2863.233333561104,-1211,0,0,0.4883676819647241,-3779032599,1626.4147550847358,610.264298911177,1016.1504561735588,0.7846997411940168,0.33907370799209263,-1211
853,2019-05-04,2019,221924,221924,370704985.4833332,3473569.3999999994,174682,0,436,0.8725599754871042,31754210,4448774218,538063,538063,323533455.8166671,3467217.5333330184,175468,0,439,0.36558730111529963,3810380387,-316139,-316139,47171529.66666609,6351.866666981019,-786,0,-3,0.5069726743718046,-3778626177,1670.414130438047,601.2928891536253,1069.1212412844218,0.7871253221823687,0.3261105112226635,-786
854,2019-05-05,2019,220695,220695,370713079.8333333,3427842.6333333384,174112,0,360,0.8635718978680983,34513239,4452886984,543696,543696,323519184.50000477,3422144.399999896,174639,0,360,0.3531753038462588,3816104509,-323001,-323001,47193895.333328545,5698.23333344236,-527,0,0,0.5103965940218396,-3781591270,1679.752961477756,595.0369038948323,1084.7160575829234,0.788925893201024,0.32120707159883466,-527
855,2019-05-06,2019,221079,221079,370935721.86666644,3444260.883333326,175046,0,66,0.8743752233364543,34336906,4457094041,558700,558700,323881539.7666733,3438532.2499998165,175977,0,54,0.3514193663862516,3823279778,-337621,-337621,47054182.09999311,5728.633333509322,-931,0,12,0.5229558569502027,-3788942872,1677.842408671409,579.7056376707953,1098.1367710006136,0.79178031382447,0.3149758367639162,-931
856,2019-05-07,2019,227347,227347,371631276.06666636,3516426.150000001,177806,0,65,0.8768710385446041,34167366,4463229240,566982,566982,324711910.8333378,3509842.1166665126,178851,0,57,0.3589867050453144,3821998243,-339635,-339635,46919365.23332858,6584.033333488274,-1045,0,8,0.5178843334992898,-3787830877,1634.6434132258898,572.7023271168005,1061.9410861090894,0.7820908127224023,0.3154438765251807,-1045
857,2019-05-08,2019,228216,228216,371900507.3333335,3516579.916666662,178109,0,68,0.8633619027587898,34049238,4466414792,577099,577099,325196647.0500047,3509805.3166664606,179300,0,68,0.345876530716568,3828783127,-348883,-348883,46703860.28332877,6774.600000201259,-1191,0,0,0.5174853720422218,-3794733889,1629.598745632793,563.5023575677739,1066.0963880650193,0.7804404599151681,0.3106919263419275,-1191
858,2019-05-09,2019,227205,227205,372362672.8833335,3529860.7000000044,178861,0,53,0.8677361853832438,35014935,4472100522,585448,585448,325445397.8000078,3524072.1666665226,179751,0,52,0.34053921099739154,3826793142,-358243,-358243,46917275.083325684,5788.533333481755,-890,0,1,0.5271969743858522,-3791778207,1638.8841481628199,555.8912111750451,1082.9929369877748,0.7872229924517506,0.3070315382408002,-890
859,2019-05-10,2019,233666,233666,373058219.2999995,3544603.5333333337,182988,0,60,0.8699596860476074,35899489,4479184556,598100,598100,326301833.4833425,3538205.483333203,183990,0,54,0.3450660424678124,3831171940,-364434,-364434,46756385.81665695,6398.050000130665,-1002,0,6,0.5248936435797951,-3795272451,1596.5447232374393,545.5640084991516,1050.9807147382876,0.7831177835029487,0.3076241431198796,-1002
860,2019-05-11,2019,230845,230845,373384013.28333366,3518756.150000002,181597,0,66,0.8748337629145101,35635472,4482287495,605106,605106,326724469.85001236,3513090.3166664867,182719,0,60,0.33961487739338164,3838592922,-374261,-374261,46659543.4333213,5665.8333335150965,-1122,0,6,0.5352188855211284,-3802957450,1617.4663227851313,539.9458439513281,1077.5204788338033,0.786662045961576,0.3019619702994186,-1122
861,2019-05-12,2019,224592,224592,373964856.28333366,3491538.3666666634,178340,0,59,0.8694655196979412,34730245,4488597610,608478,608478,327449334.46667886,3485339.133333112,178932,0,57,0.32343486535257304,3851315656,-383886,-383886,46515521.8166548,6199.233333551325,-592,0,2,0.5460306543453681,-3816585411,1665.0853827533201,538.1449032942503,1126.9404794590698,0.7940621215359407,0.29406486347904115,-592
862,2019-05-13,2019,224170,224170,374089361.3166673,3473934.2666666633,178137,0,109,0.8707275728241959,34406514,4491368266,620722,620722,327727998.4166782,3468793.5499998513,178771,0,109,0.31775899678116865,3862578959,-396552,-396552,46361362.89998913,5140.716666812077,-634,0,0,0.5529685760430272,-3828172445,1668.7753103299608,527.9787061142962,1140.7966042156645,0.7946513806486148,0.28800493618721423,-634
863,2019-05-14,2019,230597,230597,374506156.0166667,3477443.88333333,179718,0,184,0.8580553953433919,34672923,4495452347,631610,631610,328337193.4833441,3471782.799999904,180439,0,186,0.3168315891135375,3861572588,-401013,-401013,46168962.53332263,5661.083333426155,-721,0,-2,0.5412238062298544,-3826899665,1624.072108555908,519.8416641334749,1104.2304444224333,0.7793596620944765,0.285681037348997,-721
864,2019-05-15,2019,229185,229185,372295330.55000025,3475140.583333338,179227,0,114,0.8598948447760547,35083526,4489871114,649152,649152,326455635.68334115,3493005.6499998346,181119,0,114,0.30891840431825063,3868213979,-419967,-419967,45839694.866659105,-17865.066666496452,-1892,0,0,0.5509764404578041,-3833130453,1624.4314878809705,502.89552475127726,1121.5359631296933,0.7820188930340118,0.27900861431529134,-1892
865,2019-05-16,2019,228001,228001,372889412.4166666,3543949.7499999953,181884,0,112,0.8747461633940202,35613844,4495605390,658756,658756,326782851.28334236,3602211.8999998523,185889,0,113,0.31247836831847936,3861803747,-430755,-430755,46106561.133324265,-58262.14999985695,-4005,0,-1,0.5622677950755408,-3826189903,1635.4727058945646,496.06053118809143,1139.4121747064733,0.7977333432748102,0.28218187007025364,-4005
866,2019-05-17,2019,223615,223615,373302742.73333347,3491418.333333332,179680,0,55,0.8763231446906515,35091500,4501899696,665081,665081,324912029.3833388,3558091.899999844,183424,0,52,0.30230002059899924,3828860847,-441466,-441466,48390713.34999466,-66673.56666651182,-3744,0,3,0.5740231240916522,-3793769347,1669.3993816753502,488.53001271023953,1180.8693689651107,0.8035239138698209,0.27579197120350757,-3744
867,2019-05-18,2019,222203,222203,373352973.91666627,3470168.333333335,178858,0,64,0.8724814696471251,35550133,4504723483,671891,671891,323221198.9833468,3484143.6833331613,181403,0,64,0.29426945739710175,3811735977,-449688,-449688,50131774.93331945,-13975.349999826401,-2545,0,0,0.5782120122500234,-3776185844,1680.233722842024,481.06195645327415,1199.1717663887498,0.8049306264991922,0.2699887332915607,-2545
868,2019-05-19,2019,221823,221823,373694230.0833336,3437489.5666666706,177707,0,116,0.8699864306226133,35021798,4510785433,673859,673859,321957580.9666786,3431849.3666665745,178271,0,116,0.28864792189463734,3801043946,-452036,-452036,51736649.11665499,5640.2000000961125,-564,0,0,0.5813385087279759,-3766022148,1684.6505100162453,477.78182226055986,1206.8686877556854,0.801120713361554,0.2645523766841431,-564
869,2019-05-20,2019,225369,225369,374370171.3999996,3483146.383333332,178325,0,104,0.8601537922251951,35589937,4522044219,684434,684434,322779844.53333914,3477843.3166665453,178873,0,105,0.2857894260074766,3809734407,-459065,-459065,51590326.866660476,5303.066666786559,-548,0,-1,0.5743643662177185,-3774144470,1661.1431536724199,471.60112521198414,1189.5420284604356,0.7912578926116725,0.26134441012573895,-548
870,2019-05-21,2019,234670,234670,375214569.34999955,3601193.683333337,183638,0,110,0.8539864490561221,35875725,4529789091,696443,696443,323821533.0833436,3595127.0833332054,184356,0,110,0.289888763330229,3817296571,-461773,-461773,51393036.26665592,6066.60000013141,-718,0,0,0.564097685725893,-3781420846,1598.9030099714473,464.9648759242948,1133.9381340471525,0.7825371798696041,0.26471082342704283,-718
871,2019-05-22,2019,239622,239622,375956271.00000024,3638824.333333334,187353,0,175,0.85717922394438,35372846,4535190629,707060,707060,324778741.5833302,3632660.783333254,188074,0,175,0.292747433032559,3824494081,-467438,-467438,51177529.416670024,6163.5500000799075,-721,0,0,0.5644317909118209,-3789121235,1568.9555675188433,459.3368901979043,1109.618677320939,0.7818689435861482,0.2659943993437615,-721
872,2019-05-23,2019,238960,238960,376599963.9666672,3629904.1666666656,186468,0,131,0.8518413123535319,36071571,4540557348,715969,715969,325766643.80000484,3622891.5333327143,187142,0,133,0.2863741307235333,3834924923,-477009,-477009,50833320.166662335,7012.633333951235,-674,0,-2,0.5654671816299985,-3798853352,1575.9958317989085,455.00104585534405,1120.9947859435645,0.7803314362236358,0.26138282523405343,-674
873,2019-05-24,2019,237138,237138,377185374.68333274,3607404.1499999994,186496,0,76,0.8564970607831738,36210281,4546202045,726054,726054,326501013.86666286,3600224.2666665763,187181,0,76,0.28210160676754215,3843499998,-488916,-488916,50684360.81666988,7179.883333423175,-685,0,0,0.5743954540156316,-3807289717,1590.5733146241123,449.69246621692446,1140.8808484071878,0.786445023572772,0.25780589322557274,-685
874,2019-05-25,2019,232053,232053,377083352.1499997,3571396.1666666716,182746,0,93,0.8538997556592675,35382398,4547043912,732794,732794,326687061.84999424,3564733.683333263,183368,0,93,0.2724558334265836,3852465066,-500741,-500741,50396290.300005436,6662.483333408833,-622,0,0,0.5814439222326839,-3817082668,1624.9880507901198,445.8102302284056,1179.1778205617143,0.7875183686485415,0.25023130647903774,-622
875,2019-05-26,2019,219501,219501,376771150.6999999,3448219.33333333,175981,0,58,0.8697181334025822,36043495,4547573557,732961,732961,326610635.15000683,3443083.616666127,176464,0,58,0.26308903202214773,3866915012,-513460,-513460,50160515.5499931,5135.716667203233,-483,0,0,0.6066291013804345,-3830871517,1716.4894497063792,445.6043843396945,1270.8850653666848,0.8017321105598608,0.2407549651345706,-483
876,2019-05-27,2019,221382,221382,377183989.25000054,3485495.366666666,179105,0,177,0.8766882583046497,34714980,4555020263,746827,746827,327200157.8166596,3480639.9499999173,179635,0,178,0.2621919132543433,3879873411,-525445,-525445,49983831.43334091,4855.4166667489335,-530,0,-1,0.6144963450503064,-3845158431,1703.7699056382205,438.12041853958095,1265.6494870986396,0.809031447904527,0.24053093956163876,-530
877,2019-05-28,2019,232229,232229,377805063.8166671,3559851.2166666603,182521,0,69,0.8679665330342029,35728325,4560827443,759980,759980,328056359.0833398,3553641.4999994976,183301,0,58,0.271259769993958,3881558187,-527751,-527751,49748704.73332727,6209.71666716272,-780,0,11,0.596706763040245,-3845829862,1626.8642754206712,431.6644636481747,1195.1998117724966,0.7859526587979968,0.24119187347035448,-780
878,2019-05-29,2019,232395,232395,378101586.7500002,3543034.016666672,183596,0,103,0.8597861399771932,35161313,4562682701,766406,766406,328535295.3500063,3535886.1999995755,184259,0,103,0.2635300349945212,3888563484,-534011,-534011,49566291.3999939,7147.816667096689,-663,0,0,0.596256104982672,-3853402171,1626.9781481959603,428.6700460982903,1198.3081020976701,0.7900169969233417,0.24041956874032824,-663
879,2019-05-30,2019,227765,227765,377021505.30000037,3514664.9333333327,183318,0,251,0.870888854740632,34994332,4550629061,778627,778627,327675205.4833266,3512512.766666595,185602,0,251,0.2587837308492984,3895411690,-550862,-550862,49346299.816673756,2152.1666667377576,-2284,0,0,0.6121051238913336,-3860417358,1655.30922354181,420.83719866293694,1234.472024878873,0.8048558821592431,0.23837087591362746,-2284
880,2019-05-31,2019,235012,235012,377202677.5833329,3554996.8833333356,187690,0,305,0.8793721171684841,35341640,4550906446,793569,793569,325720485.08333915,3552384.966666147,192480,0,305,0.2700332296246475,3858227248,-558557,-558557,51482192.49999374,2611.9166671885177,-4790,0,0,0.6093388875438366,-3822885608,1605.0358176745567,410.45011219357,1194.5857054809867,0.7986400694432625,0.2425497971820976,-4790
881,2019-06-01,2019,236196,236196,377273743.59999985,3560196.7166666654,186700,0,71,0.8624447492760257,36243308,4553290689,506235,506235,323044984.4166678,3553019.066666379,187491,0,75,0.4082945667525938,3766822702,-270039,-270039,54228759.183332026,7177.650000286289,-791,0,-4,0.45415018252343187,-3730579394,1597.2909939203028,638.1324570933812,959.1585368269216,0.7904452234584837,0.3703635663278912,-791
882,2019-06-02,2019,232943,232943,377335818.3666663,3531151.0666666673,183747,0,80,0.8686974925196286,36671319,4556899536,513063,513063,323247577.0666734,3524629.199999838,184602,0,79,0.40568702089217223,3772354888,-280120,-280120,54088241.29999292,6521.8666668292135,-855,0,1,0.46301047162745634,-3735683569,1619.8633071895972,630.0348632949041,989.8284438946931,0.7888067037859047,0.3598037667888739,-855
883,2019-06-03,2019,227461,227461,377421407.8166669,3501567.4166666656,179630,0,67,0.8646713062898697,35365334,4560554273,523718,523718,323564338.2500026,3496539.216666424,180556,0,54,0.3862593991422874,3782496463,-296257,-296257,53857069.56666428,5028.200000241399,-926,0,13,0.47841190714758225,-3747131129,1659.279647133649,617.8216869574898,1041.4579601761593,0.7897177977763221,0.3447580568168365,-926
884,2019-06-04,2019,228632,228632,377626451.0000002,3497591.400000002,180896,0,71,0.8635930228489447,34669994,4564463048,531560,531560,323974847.133339,3493004.6333331275,181680,0,62,0.3776845511325125,3785936058,-302928,-302928,53651603.86666119,4586.7666668742895,-784,0,9,0.4859084717164322,-3751266064,1651.678028447462,609.4793572378263,1042.198671209636,0.7912103292627454,0.34178643991270974,-784
885,2019-06-05,2019,228406,228406,377940943.71666646,3501519.566666663,181336,0,141,0.8661681391907383,34492537,4570022374,541014,541014,324373535.20000803,3497194.4833330815,182433,0,141,0.37348756224422486,3792856311,-312608,-312608,53567408.516658425,4325.083333581686,-1097,0,0,0.49268057694651346,-3758363774,1654.6892100762084,599.5658803654028,1055.1233297108056,0.7939195993100007,0.3372056915347847,-1097
886,2019-06-06,2019,223358,223358,378182795.81666696,3461276.849999997,180046,0,197,0.8908299680333807,34421726,4571879351,546359,546359,324718282.7500062,3458964.0166664757,181148,0,198,0.3814451670055731,3796366081,-323001,-323001,53464513.06666076,2312.83333352115,-1102,0,-1,0.5093848010278075,-3761944355,1693.168795461398,594.3313512727093,1098.8374441886888,0.8060870888886899,0.3315548933942701,-1102
887,2019-06-07,2019,223967,223967,378369678.8000002,3484438.5166666666,180746,0,185,0.8778837953805693,33764219,4573508737,556667,556667,324896562.76667315,3481051.8499997896,181297,0,185,0.35709679215760975,3801797650,-332700,-332700,53473116.03332704,3386.6666668769903,-551,0,0,0.5207870032229596,-3768033431,1689.399236494663,583.6461704514065,1105.7530660432565,0.8070206771533306,0.3256830385131506,-551
888,2019-06-08,2019,226958,226958,378609457.0333334,3516237.0333333304,181302,0,218,0.8700728769199588,35015772,4577110664,566518,566518,325292246.1666779,3511125.6666665487,181860,0,218,0.3537504545310078,3808598502,-339560,-339560,53317210.86665553,5111.366666781716,-558,0,0,0.5163224223889511,-3773582730,1668.191722844462,574.1957822464209,1093.9959405980412,0.7988350267450365,0.32101363063486066,-558
889,2019-06-09,2019,232378,232378,378707817.9333331,3512292.449999996,183086,0,193,0.8523956656826389,35394488,4578835435,581547,581547,325583208.1666746,3506010.9333331496,183736,0,193,0.3441321165787168,3820898174,-349169,-349169,53124609.766658485,6281.51666684635,-650,0,0,0.5082635491039221,-3785503686,1629.70598737115,559.8570849246486,1069.8489024465016,0.7878800919192006,0.3159435092950355,-650
890,2019-06-10,2019,231271,231271,375888764.0333333,3515885.16666666,180406,0,193,0.8467036506955041,34295091,4542696202,592676,592676,322482588.4000058,3506899.1999999527,181473,0,194,0.33536535982560595,3786576575,-361405,-361405,53406175.633327484,8985.966666707303,-1067,0,-1,0.5113382908698982,-3752281484,1625.317329165063,544.1127840506547,1081.2045451144083,0.7800632158809362,0.30619259089283185,-1067
891,2019-06-11,2019,230005,230005,372743258.2666668,3501599.4499999997,174728,0,190,0.8209778048303304,33791589,4497039857,600037,600037,319373070.18334246,3493937.0333332606,175891,0,190,0.3184453625359708,3744983075,-370032,-370032,53370188.08332437,7662.416666739155,-1163,0,0,0.5025324422943597,-3711191486,1620.5876318630762,532.2556278751852,1088.332003987891,0.7596704419469142,0.29313359009527745,-1163
892,2019-06-12,2019,226317,226317,368627072.0666663,3504832.933333335,174083,0,75,0.8339497253851905,33864480,4447210505,605331,605331,316482870.76667076,3500270.766666567,174740,0,79,0.31435198263429737,3706731839,-379014,-379014,52144201.29999554,4562.166666768026,-657,0,-4,0.5195977427508931,-3672867359,1628.8085829463378,522.8261410148675,1105.9824419314702,0.769199839163651,0.28866851359008544,-657
893,2019-06-13,2019,227314,227314,368839794.41666585,3517799.6999999993,175491,0,57,0.8379422296910881,34929650,4446642556,610823,610823,316925549.8000121,3511759.3333331784,176093,0,58,0.3144413357060892,3715041039,-383509,-383509,51914244.61665374,6040.366666820832,-602,0,-1,0.523500893984999,-3680111389,1622.6004311950248,518.8500593461806,1103.7503718488442,0.7720202011314745,0.28828809655170157,-602
894,2019-06-14,2019,230384,230384,369417970.54999936,3530682.0500000007,178516,0,51,0.845475380234739,36338896,4455214705,625449,625449,317705725.08334786,3525794.999999859,180226,0,44,0.316750046766403,3721036979,-395065,-395065,51712245.4666515,4887.05000014184,-1710,0,7,0.528725333468336,-3684698083,1603.4879616205958,507.96423862432886,1095.523722996267,0.7748628376970623,0.28815458974272884,-1710
895,2019-06-15,2019,226933,226933,369696975.5833338,3539288.0166666727,177095,0,65,0.8487086496895574,36440034,4461958877,628092,628092,317359903.9166813,3534120.233333177,177621,0,66,0.3096568655547314,3713265516,-401159,-401159,52337071.6666525,5167.783333495725,-526,0,-1,0.539051784134826,-3676825482,1629.1018740479956,505.2761441264676,1123.825729921528,0.7803845187786703,0.2827945587589079,-526
896,2019-06-16,2019,227084,227084,370162017.8166668,3513642.299999996,176725,0,46,0.8424944073558683,36918958,4467114675,636210,636210,318014555.9333449,3508746.433332982,177264,0,40,0.30345011867150123,3727377830,-409126,-409126,52147461.88332188,4895.866667014081,-539,0,6,0.5390442886843672,-3690458872,1630.0664856029784,499.85783928788436,1130.208646315094,0.7782362473798242,0.27862498231715943,-539
897,2019-06-17,2019,233633,233633,371159877.11666644,3577260.1166666597,180225,0,49,0.8400868028061107,37129155,4480828532,653353,653353,319120083.9166762,3572587.7666665083,180949,0,41,0.30377452923610654,3741378803,-419720,-419720,52039793.19999021,4672.350000151433,-724,0,8,0.5363122735700041,-3704249648,1588.6449136751505,488.43440516332856,1100.210508511822,0.7714021563734575,0.27695441820883965,-724
898,2019-06-18,2019,226147,226147,371405714.1166663,3535984.3833333324,176721,0,49,0.8455871623324656,35997899,4484613980,657619,657619,319588639.6666769,3532224.1166665293,179190,0,41,0.2963053074804745,3745736743,-431472,-431472,51817074.44998944,3760.2666668030433,-2469,0,8,0.5492818548519911,-3709738844,1642.3198809476416,485.97841556688127,1156.3414653807604,0.7814430436839754,0.27248300307624934,-2469
899,2019-06-19,2019,228109,228109,372064818.8833338,3560352.0999999978,178015,0,121,0.8443331915882312,36292423,4490770702,663665,663665,319111445.66667306,3555094.5166665493,178667,0,121,0.2932247444117133,3731534350,-435556,-435556,52953373.21666074,5257.583333448507,-652,0,0,0.5511084471765179,-3695241927,1631.0834683565042,480.8321150982394,1150.2513532582648,0.780394460542986,0.26921262986597155,-652
900,2019-06-20,2019,229655,229655,372701348.9500003,3550756.3833333314,178748,0,171,0.8439746576386313,36253821,4499401697,672104,672104,319814101.81667495,3545271.0666665253,179369,0,171,0.29193398640686746,3743045480,-442449,-442449,52887247.13332534,5485.316666806117,-621,0,0,0.5520406712317638,-3706791659,1622.8749600487702,475.8402000533771,1147.034759995393,0.7783327164660033,0.26687685239189174,-621
901,2019-06-21,2019,227675,227675,373246468.7499997,3530384.716666663,178138,0,51,0.8429647523882716,35743297,4506778936,680537,680537,320640055.4500144,3529093.3999998663,178742,0,52,0.2843974684697511,3752794884,-452862,-452862,52606413.29998529,1291.3166667968035,-604,0,-1,0.5585672839185205,-3717051587,1639.382755023607,471.15741752471126,1168.2253374988957,0.7824223125068629,0.26264846731331287,-604
902,2019-06-22,2019,228056,228056,373410139.3166668,3547187.700000003,178489,0,41,0.843275335882415,35444054,4508124375,690177,690177,321027527.6333462,3542436.14999987,179122,0,37,0.2817813401489783,3764107317,-462121,-462121,52382611.68332058,4751.550000132993,-633,0,4,0.5614939957334366,-3728663263,1637.3616099408337,465.13796842454354,1172.2236415162902,0.7826542603571053,0.2595305262273301,-633
903,2019-06-23,2019,232556,232556,374035877.6833339,3554913.6333333394,181097,0,37,0.8402234300555567,36197854,4517035902,701606,701606,321778296.7500144,3548616.266666534,181740,0,36,0.2808556369244311,3776969295,-469050,-469050,52257580.93331945,6297.366666805465,-643,0,1,0.5593677931311256,-3740771441,1608.3690710337892,458.6310504043786,1149.7380206294106,0.7787242642632313,0.25903427279698293,-643
904,2019-06-24,2019,234139,234139,374735706.13333315,3586973.149999998,180356,0,36,0.8359991287226832,36300414,4525400124,714589,714589,322628833.76666725,3579915.999999549,181302,0,32,0.27742240644621946,3788363916,-480450,-480450,52106872.3666659,7057.15000044927,-946,0,4,0.5585767222764637,-3752063502,1600.4839267842315,451.4886651860961,1148.9952615981354,0.7702945686109534,0.25371507258018244,-946
905,2019-06-25,2019,234391,234391,374967742.26666707,3620773.8833333347,180647,0,42,0.8334620356583662,36215404,4525451081,719608,719608,323033503.55000764,3613445.566666159,181497,0,42,0.2743771608987122,3793789618,-485217,-485217,51934238.71665943,7328.316667175852,-850,0,0,0.559084874759654,-3757574214,1599.7531571889153,448.90204604452373,1150.8511111443916,0.7707079196726837,0.2522164845304666,-850
906,2019-06-26,2019,226404,226404,375198485.23333335,3570968.933333338,178580,0,36,0.8480503878023361,35387700,4529192945,721239,721239,323501160.00001055,3565221.7499994403,179171,0,34,0.2679527868016127,3801057126,-494835,-494835,51697325.2333228,5747.1833338974975,-591,0,2,0.5800976010007234,-3765669426,1657.2078462983575,448.53531215035594,1208.6725341480014,0.7887669829154962,0.2484211197675112,-591
907,2019-06-27,2019,229748,229748,375393837.1999999,3571931.6333333314,178947,0,40,0.8410736981388296,35223192,4531782581,737225,737225,323948112.90000015,3579006.8833332406,180789,0,35,0.26630133270033113,3811012046,-507477,-507477,51445724.29999977,-7075.249999909196,-1842,0,5,0.5747723654384984,-3775788854,1633.937345265247,439.41552836650976,1194.5218168987371,0.7788838205338022,0.24522906846620773,-1842
908,2019-06-28,2019,234731,234731,376146309.76666695,3590100.4333333275,182628,0,43,0.8441918621741471,35992700,4539725654,750398,750398,324434789.38333106,3584492.499999921,183951,0,43,0.26764330395337144,3815070526,-515667,-515667,51711520.38333589,5607.9333334066905,-1323,0,0,0.5765485582207757,-3779077826,1602.4568964758253,432.3502852930459,1170.1066111827795,0.7780310227451849,0.24513791348057964,-1323
909,2019-06-29,2019,232611,232611,376067748.36666673,3585286.283333334,181714,0,35,0.8433436079979023,36430455,4540375637,759875,759875,323821906.2666641,3595869.51666615,185682,0,35,0.26448034216154676,3809707664,-527264,-527264,52245842.10000265,-10583.233332816046,-3968,0,0,0.5788632658363555,-3773277209,1616.7238366485967,426.1515463288884,1190.5722903197084,0.7811926349140841,0.24435861161375227,-3968
910,2019-06-30,2019,228425,228425,376122369.966667,3544138.4333333313,180049,0,37,0.8500120389624602,34903944,4543225383,757563,757563,320922554.48332846,3540217.2499999683,180572,0,33,0.2587269969626296,3749104645,-529138,-529138,55199815.483338535,3921.1833333629183,-523,0,4,0.5912850419998307,-3714200701,1646.5902154609478,423.6249057614066,1222.9653096995412,0.7882193280070044,0.2383590539664688,-523
911,2019-07-01,2019,227395,227395,376406925.53333354,3553451.98333333,178221,0,36,0.8419886101277517,34416541,4548881710,496325,496325,321324396.7666633,3549562.4666663557,178755,0,36,0.3877902583992326,3725077559,-268930,-268930,55082528.76667023,3889.5166669744067,-534,0,0,0.45419835172851913,-3690661018,1655.2999209891755,647.4072367232425,1007.892684265933,0.7837507421007498,0.36015715508991086,-534
912,2019-07-02,2019,225518,225518,376624015.48333347,3538507.53333333,177154,0,38,0.8394540568823777,34820217,4552041704,502654,502654,321743157.08333385,3533985.899999682,177543,0,38,0.37842929728998387,3729382635,-277136,-277136,54880858.39999962,4521.633333648089,-389,0,0,0.46102475959239386,-3694562418,1670.0397107252347,640.0887232237958,1029.950987501439,0.7855426174407364,0.35321115518826074,-389
913,2019-07-03,2019,229282,229282,376925838.7833329,3563252.0499999984,178394,0,32,0.8315349656754559,35397920,4557352668,516359,516359,322270274.4499999,3558111.199999717,178985,0,28,0.37166196386622685,3737864883,-287077,-287077,54655564.333332956,5140.850000281353,-591,0,4,0.4598730018092291,-3702466963,1643.9399463688073,624.1205720245022,1019.8193743443052,0.7780549716070166,0.346628992619476,-591
914,2019-07-04,2019,227498,227498,377087545.7333328,3564117.783333334,178849,0,34,0.8444425885062737,35416517,4558560116,524816,524816,322745620.5833361,3559402.933333042,179498,0,32,0.3696209719215879,3748321970,-297318,-297318,54341925.1499967,4714.850000292063,-649,0,2,0.47482161658468586,-3712905453,1657.5422453530705,614.9690950415691,1042.5731503115014,0.7861563618141698,0.3420208225358983,-649
915,2019-07-05,2019,230426,230426,377871022.21666604,3580981.833333328,182072,0,33,0.8469052971452875,36122892,4568676581,535544,535544,323710719.8000051,3575809.483333086,182638,0,33,0.3667467098875172,3759451165,-305118,-305118,54160302.416660964,5172.350000241771,-566,0,0,0.48015858725777033,-3723328273,1639.8801446740647,604.4521454819867,1035.427999192078,0.7901538888840669,0.34103266958457196,-566
916,2019-07-06,2019,225998,225998,378142827.8166663,3536964.2166666673,178421,0,26,0.8430472836042792,35164378,4574901515,548740,548740,324151168.10000956,3534080.7833331926,181480,0,26,0.35354448372635444,3769595003,-322742,-322742,53991659.716656744,2883.433333474677,-3059,0,0,0.4895027998779247,-3734430625,1673.2131603671992,590.7190438094718,1082.4941165577275,0.7894804378799812,0.33072128877063817,-3059
917,2019-07-07,2019,223939,223939,378132530.3166664,3504624.2833333346,176884,0,38,0.8458687410410866,35542053,4577606058,551136,551136,322702396.166679,3500090.6333331326,177343,0,38,0.34575313534227786,3751584936,-327197,-327197,55430134.1499874,4533.650000202004,-459,0,0,0.5001156056988088,-3716042883,1688.551481951185,585.5222597810323,1103.0292221701527,0.7898758143958846,0.3217772019973292,-459
918,2019-07-08,2019,226944,226944,378647463.40000033,3550107.783333335,178177,0,35,0.8439659122955445,36536755,4584994205,562405,562405,323393324.7500056,3544939.6833331934,178746,0,35,0.34283656795370027,3763701154,-335461,-335461,55254138.64999473,5168.100000141654,-569,0,0,0.5011293443418443,-3727164399,1668.4621025451227,575.0185804713784,1093.4435220737441,0.7851143894529047,0.3178243436669304,-569
919,2019-07-09,2019,226924,226924,379031502.54999954,3573839.5833333307,179331,0,32,0.8480063809909912,37409133,4590614139,567209,567209,324060519.3666716,3569166.533333189,179982,0,32,0.34185987881010005,3767989072,-340285,-340285,54970983.18332791,4673.05000014184,-651,0,0,0.5061465021808912,-3730579939,1670.3015218751632,571.3247134066484,1098.9768084685147,0.790268988736317,0.3173116082431696,-651
920,2019-07-10,2019,229501,229501,379432371.7166669,3572827.8833333314,180550,0,35,0.8417174652833761,37514957,4597421970,578986,578986,324713966.0333463,3568096.633333172,181168,0,31,0.335643694320767,3779807322,-349485,-349485,54718405.68332058,4731.250000159256,-618,0,4,0.5060737709626091,-3742292365,1653.292890735408,560.8321548938079,1092.4607358416001,0.7867068117350251,0.31290566611282483,-618
921,2019-07-11,2019,232791,232791,379624734.26666665,3603708.6333333314,182787,0,35,0.8408830238282395,38151279,4602597818,590223,590223,325121045.28334755,3598719.1166664883,183393,0,35,0.3337196280050094,3793546682,-357432,-357432,54503688.9833191,4989.51666684309,-606,0,0,0.5071633958232301,-3755395403,1630.7534838832544,550.8444186067767,1079.9090652764776,0.7851978813613928,0.3107181522915915,-606
922,2019-07-12,2019,233363,233363,380083506.3500007,3604374.550000001,183715,0,29,0.843921272866735,38674608,4612538738,599048,599048,325711077.10000646,3599215.2166664884,184255,0,28,0.3306730011618482,3801130559,-365685,-365685,54372429.24999422,5159.333333512768,-540,0,1,0.5132482717048867,-3762455951,1628.7222325304383,543.7144888222755,1085.0077437081627,0.7872499067975643,0.30757969311307276,-540
923,2019-07-13,2019,230106,230106,380170387.98333365,3581508.8999999976,181462,0,44,0.8444977532093896,39054705,4620281290,607810,607810,326018702.66667426,3577070.8999998486,182135,0,44,0.32150013984633297,3814558836,-377704,-377704,54151685.31665939,4438.000000149012,-673,0,0,0.5229976133630566,-3775504131,1652.1533031878075,536.382591050944,1115.7707121368635,0.7886017748342068,0.2996577877955282,-673
924,2019-07-14,2019,230631,230631,380254390.5333335,3564728.91666667,182318,0,42,0.8488754764103699,38682896,4627551826,624317,624317,326277438.0333423,3579621.9833331387,184404,0,42,0.3176367134004031,3831819287,-393686,-393686,53976952.49999118,-14893.066666468978,-2086,0,0,0.5312387630099668,-3793136391,1648.756630866334,522.6150145412383,1126.1416163250956,0.7905181870607161,0.29536917943929125,-2086
925,2019-07-15,2019,232748,232748,380635294.61666626,3599282.866666667,182478,0,33,0.8434315225050281,38658917,4634232734,641320,641320,326608691.2666637,3632006.3499997975,187115,0,33,0.314212873448517,3836945921,-408572,-408572,54026603.35000259,-32723.483333130367,-4637,0,0,0.5292186490565111,-3798287004,1635.3966290437136,509.275698975026,1126.1209300686876,0.7840153298846821,0.2917654213185305,-4637
926,2019-07-16,2019,232935,232935,381096384.7666664,3595785.1500000064,182625,0,34,0.8437504024727932,38608040,4643804018,638553,638553,323782647.18334246,3590908.3999998355,183195,0,34,0.30962034474820926,3791703519,-405618,-405618,57313737.583323956,4876.750000170898,-570,0,0,0.534130057724584,-3753095479,1636.063214058284,507.05680998028737,1129.0064040779966,0.7840170004507695,0.2868908297353548,-570
927,2019-07-17,2019,231579,231579,381204822.21666706,3570598.083333334,181021,0,32,0.8361552645101665,38416219,4650861661,644008,644008,324109252.4666761,3565952.883333217,181600,0,31,0.30221674264916115,3804382996,-412429,-412429,57095569.74999094,4645.200000117067,-579,0,1,0.5339385218610053,-3765966777,1646.1113581830264,503.26898496086403,1142.8423732221622,0.7816814132542242,0.2819840747319909,-579
928,2019-07-18,2019,230992,230992,381420930.34999967,3571716.266666666,181907,0,31,0.8450725566253381,38799507,4657297055,652855,652855,324574351.5666736,3566234.0333328512,182553,0,31,0.3009565676911396,3817138982,-421863,-421863,56846578.78332609,5482.233333814889,-646,0,0,0.5441159889341984,-3778339475,1651.2300441140803,497.1614701069511,1154.0685740071292,0.7875034633234052,0.279622580818099,-646
929,2019-07-19,2019,234849,234849,381523920.1500003,3592237.48333333,184654,0,37,0.8450110496531816,39278686,4662058334,664589,664589,324900225.7333417,3586204.983333154,185345,0,37,0.3005932990163805,3827790962,-429740,-429740,56623694.41665858,6032.50000017602,-691,0,0,0.5444177506368011,-3788512276,1624.5499029163432,488.87391415347184,1135.6759887628714,0.7862669204467552,0.2788866502454901,-691
930,2019-07-20,2019,232410,232410,381412943.34999985,3579118.6666666702,182874,0,36,0.8488016866744119,38724567,4662736026,673745,673745,325022097.9333415,3573418.299999822,183585,0,38,0.29521703315052505,3840155387,-441335,-441335,56390845.41665834,5700.366666848306,-711,0,-2,0.5535846535238869,-3801430820,1641.1210505141769,482.4111465515017,1158.709903962675,0.7868594294565638,0.27248439691574705,-711
931,2019-07-21,2019,234053,234053,381999381.86666685,3595843.400000004,184475,0,31,0.8482395013095332,39016247,4672362590,682809,682809,325816815.7166756,3591401.149999809,185309,0,28,0.29344223640872313,3855265546,-448756,-448756,56182566.149991274,4442.250000195112,-834,0,3,0.55479726490081,-3816249299,1632.1063257752169,477.1712378083411,1154.9350879668757,0.7881761823176802,0.27139214626637903,-834
932,2019-07-22,2019,235347,235347,383022824.233333,3645931.6999999955,185695,0,41,0.8508415233676234,42290093,4689254930,691967,691967,327018741.76667774,3640947.549999825,186407,0,41,0.29149511465141864,3871992165,-456620,-456620,56004082.466655254,4984.150000170339,-712,0,0,0.5593464087162048,-3829702072,1627.48122658599,472.59297302714975,1154.8882535588402,0.7890264163129337,0.2693871239524428,-712
933,2019-07-23,2019,237014,237014,383589769.8166669,3652533.3166666664,186050,0,30,0.8470681056815221,42198944,4699949442,700081,700080,327840560.51666,3646827.1166665964,186827,0,28,0.2890251270924367,3888305817,-463067,-463066,55749209.300006926,5706.2000000700355,-777,0,2,0.5580429785890855,-3846106873,1618.4266322523856,468.29013900791335,1150.1364932444721,0.7849747272313028,0.26686483421204116,-777
934,2019-07-24,2019,240844,240844,384420949.06666666,3668836.6166666658,188132,0,33,0.8407973626081617,42339690,4713512822,712425,712425,328919108.649994,3662938.0499999067,188957,0,33,0.2865213882163059,3906993515,-471581,-471581,55501840.41667265,5898.566666759085,-825,0,0,0.5542759743918558,-3864653825,1596.140859089978,461.68945313540934,1134.4514059545686,0.7811363372141303,0.2652307260413377,-825
935,2019-07-25,2019,240413,240413,385206652.88333297,3673928.0166666685,188074,0,32,0.8445841115081132,42336297,4729795967,722664,722664,329951251.3333297,3667823.2333332305,188774,0,32,0.28290187417666174,3925089887,-482251,-482251,55255401.55000329,6104.783333437983,-700,0,0,0.5616822373314514,-3882753590,1602.270479896399,456.5762945619675,1145.6941853344315,0.7822954665513097,0.2612195985963048,-700
936,2019-07-26,2019,238151,238151,385896554.4833336,3642900.6166666658,187808,0,34,0.847596692854534,42316821,4742383357,730465,730464,330805046.5666616,3636967.8999998774,188355,0,34,0.2776601206081053,3941400676,-492314,-492313,55091507.91667199,5932.716666788328,-547,0,0,0.5699365722464287,-3899083855,1620.3860344207396,452.86974658116156,1167.5162878395781,0.7886089077937947,0.25785629701628415,-547
937,2019-07-27,2019,231346,231346,385771487.3999997,3584137.6666666665,181177,0,165,0.8298263207490081,40299115,4750272111,736649,736643,330915547.9666623,3579576.6166666104,181676,0,165,0.2617284486913097,3959244028,-505303,-505297,54855939.43333739,4561.050000056159,-499,0,0,0.5680978720576983,-3918944913,1667.5087851097476,449.22105818783626,1218.2877269219114,0.7831429979338307,0.24662491905914485,-499
938,2019-07-28,2019,227874,227874,385848480.6333328,3550435.9833333334,179677,0,195,0.837642732387195,40586666,4759292543,744108,744107,331182653.8999981,3545587.1499999203,180239,0,195,0.25778516021867304,3979231382,-516234,-516233,54665826.73333466,4848.833333413117,-562,0,0,0.579857572168522,-3938644716,1693.2536429488787,445.07396637848876,1248.1796765703898,0.7884927635447659,0.24222155923602487,-562
939,2019-07-29,2019,232883,232883,386479578.58333313,3592425.4666666635,183820,0,90,0.8416715689852846,41323517,4773841194,761487,761487,332015389.5666798,3589211.0333329067,184859,0,93,0.2594463201604297,3995812188,-528604,-528604,54464189.01665336,3214.433333756868,-1039,0,-3,0.5822252488248549,-3954488671,1659.543970935333,436.00926813810315,1223.5347027972298,0.7893233941507108,0.24276054614195647,-1039
940,2019-07-30,2019,230820,230820,387156439.08333343,3601339.716666664,182428,0,35,0.8490425439736592,40790570,4786635232,765777,765777,332837472.8166622,3600904.8166666017,183658,0,33,0.2586079237166958,4005287885,-534957,-534957,54318966.26667124,434.9000000623055,-1230,0,2,0.5904346202569635,-3964497315,1677.3088947376027,434.64020572132904,1242.6686890162737,0.7903474568928169,0.23983222269668586,-1230
941,2019-07-31,2019,233652,233652,387477360.4499998,3624725.249999994,183723,0,38,0.8437248557684097,41310825,4796957275,775376,775375,333270933.5499947,3619470.549999914,184564,0,36,0.2563852892016281,4016289771,-541724,-541723,54206426.9000051,5254.700000079814,-841,0,2,0.5873395665667815,-3974978946,1658.3524234759377,429.81903408027694,1228.5333893956608,0.7863104103538596,0.2380316130496688,-841
942,2019-08-01,2019,244103,244103,387762506.33333343,3703836.2999999975,191713,0,41,0.8442092067692746,41287125,4804425040,519434,519434,333720549.5166826,3697948.916666476,192517,0,41,0.3993481366256333,4001042742,-275331,-275331,54041956.81665081,5887.383333521429,-804,0,0,0.4448610701436413,-3959755617,1588.5200359411126,642.4695909714856,946.050444969627,0.7853774840948288,0.37062841477454306,-804
943,2019-08-02,2019,243517,243517,388069926.76666635,3697472.950000006,190742,0,34,0.8411527737283234,41238245,4813288400,530454,530454,334225619.48334193,3692597.4833331797,191484,0,34,0.3887311623628104,4013179051,-286937,-286937,53844307.28332442,4875.466666826047,-742,0,0,0.452421611365513,-3971940806,1593.6050738415238,630.07465205907,963.5304217824538,0.7832800174115154,0.3609813480528001,-742
944,2019-08-03,2019,242494,242494,388340109.0166668,3694883.9166666646,189988,0,53,0.8427260055918903,41666084,4822595135,550692,550692,334766521.79999936,3726266.483333115,193551,0,53,0.3786998903198205,4028842066,-308198,-308198,53573587.21666747,-31382.56666645035,-3563,0,0,0.4640261152720698,-3987175982,1601.4421347194852,607.9015525920104,993.5405821274749,0.7834750550529085,0.35146869756597154,-3563
945,2019-08-04,2019,239024,239024,388735861.6333335,3656103.7500000005,187709,0,31,0.8468354642211652,40976440,4831636876,557884,557884,334478169.366682,3650831.9333331385,188476,0,31,0.3654343913788531,4033721813,-318860,-318860,54257692.26665151,5271.816666861996,-767,0,0,0.4814010728423121,-3992745373,1626.3465661746666,599.5478797862673,1026.7986863883993,0.7853144454113394,0.33784084146525084,-767
946,2019-08-05,2019,238995,238995,389247598.4666668,3661000.5999999987,186936,0,33,0.8446327329023623,40400065,4840107758,564225,564225,335063697.3166752,3656191.9166664626,187574,0,33,0.3598493508795263,4046206275,-325230,-325230,54183901.14999163,4808.683333536144,-638,0,0,0.484783382022836,-4005806210,1628.6851125197884,593.84766239829,1034.8374501214985,0.7821753593171406,0.3324453896938278,-638
947,2019-08-06,2019,240058,240058,389366502.1999992,3666631.483333328,187047,0,110,0.840105307883928,40386234,4846469342,572505,572505,335355986.3000112,3659458.6333331624,187593,0,110,0.3541401385140733,4053815396,-332447,-332447,54010515.899987996,7172.850000165403,-546,0,0,0.48596516936985473,-4013429162,1621.96845012455,585.7695326678565,1036.1989174566934,0.7791741995684376,0.3276705006943171,-546
948,2019-08-07,2019,244871,244871,389734498.74999994,3686083.3166666683,191773,0,131,0.845784106733749,41809924,4855011229,592380,592380,335963966.01668024,3686945.3666665563,193300,0,134,0.3535838482055392,4068663888,-347509,-347509,53770532.7333197,-862.049999888055,-1527,0,-3,0.49220025852820987,-4026853964,1591.591077546953,567.1426550806581,1024.4484224662951,0.7831592961191811,0.3263108140045241,-1527
949,2019-08-08,2019,242402,242402,389702050.15,3696295.7999999966,189603,0,139,0.8448898936477424,42005660,4863994932,607621,607621,335875989.6833382,3706443.1499997946,193260,0,140,0.34397264084025747,4082564804,-365219,-365219,53826060.46666175,-10147.349999797996,-3657,0,-1,0.5009172528074849,-4040559144,1607.6684604499962,552.7721880635104,1054.8962723864859,0.7821841403948813,0.3180601065466796,-3657
950,2019-08-09,2019,238647,238647,389723799.63333344,3608526.066666665,185760,0,150,0.8421350362669554,41898693,4871271207,612000,611999,332658333.0833514,3602331.93333317,186419,0,150,0.33128104575163564,4032967161,-373353,-373352,57065466.54998207,6194.133333494887,-659,0,0,0.5108539905153198,-3991068468,1633.0555156081302,543.5602559536068,1089.4952596545236,0.7783881632704371,0.3046062091503268,-659
951,2019-08-10,2019,221350,221350,388173501.29999995,3500426.616666665,175505,0,160,0.8594849785407732,40963350,4864505314,613697,613697,331420855.0833413,3494234.2499998105,176192,0,160,0.31317572026586044,4039675274,-392347,-392347,56752646.21665865,6192.366666854359,-687,0,0,0.5463092582749127,-3998711924,1753.663886604924,540.0398813801295,1213.6240052247945,0.7928845719448837,0.2870993340361775,-687
952,2019-08-11,2019,228641,228641,387671255.96666604,3514611.8833333305,180212,0,160,0.8538144952130196,40539268,4869387138,628424,628424,331123884.55001056,3509697.8166664755,180901,0,160,0.3129336244319089,4055164315,-399783,-399783,56547371.41665548,4914.066666855011,-689,0,0,0.5408808707811106,-4014625047,1695.5456631429447,526.9115828644523,1168.6340802784925,0.78818759540065,0.28786456277927003,-689
953,2019-08-12,2019,239208,239208,388162371.66666645,3631808.4000000036,185337,0,128,0.8420704993144043,41844999,4881353239,643726,643726,331803521.6333456,3627546.7999998797,186547,0,128,0.3161127560483863,4064244933,-404518,-404518,56358850.033320844,4261.600000123959,-1210,0,0,0.525957743266018,-4022399934,1622.6981190707102,515.442162711069,1107.255956359641,0.7747943212601586,0.2897925514892982,-1210
954,2019-08-13,2019,240739,240739,388614396.53333324,3654472.4166666707,185723,0,115,0.8354815796360372,41275429,4887896071,651749,651749,332529751.91668344,3652443.3499998813,188247,0,115,0.3141408732502885,4067594459,-411010,-411010,56084644.61664981,2029.066666789353,-2524,0,0,0.5213407063857487,-4026319030,1614.256088682487,510.21137265524527,1104.0447160272417,0.7714703475548208,0.28883358470822357,-2524
955,2019-08-14,2019,237967,237967,389028169.4166668,3625037.2166666654,184796,0,143,0.8409401303542077,40775456,4896956744,679716,679715,333043867.4333279,3641028.2166666123,192439,0,143,0.3066972088342799,4072224364,-441749,-441748,55984301.98333889,-15990.999999946915,-7643,0,0,0.5342429215199278,-4031448908,1634.798814191324,489.97575076808357,1144.8230634232405,0.7765614560002017,0.283116772299019,-7643
956,2019-08-15,2019,238121,238121,389237065.44999963,3632345.5499999956,186312,0,117,0.8470189525493338,41247772,4906123231,675597,675597,329162867.81668174,3627479.966666504,188946,0,117,0.30408068715521136,3995912771,-437476,-437476,60074197.63331789,4865.583333491813,-2634,0,0,0.5429382653941224,-3954664999,1634.6188091348502,487.2177760065272,1147.401033128323,0.782425741534766,0.27967264508279344,-2634
957,2019-08-16,2019,253241,253241,390047263.99999994,3795860.0333333295,196879,0,120,0.8477576695716733,42858621,4917511598,689932,689932,329730057.38332653,3789885.8499999037,197871,0,120,0.31398166775856207,3999627424,-436691,-436691,60317206.61667341,5974.183333425783,-992,0,0,0.5337760018131112,-3956768803,1540.221622880971,477.9167474234077,1062.3048754575632,0.7774373028064177,0.2867978293512984,-992
958,2019-08-17,2019,248593,248593,390700065.4833331,3793965.8333333316,192257,0,134,0.8446818695618948,42300223,4930089243,693518,693518,330570751.3166792,3787874.083332869,193299,0,134,0.30603243174653744,4016716239,-444925,-444925,60129314.16665393,6091.750000462402,-1042,0,0,0.5386494378153575,-3974416016,1571.6454827100245,476.6577815091738,1094.9877012008506,0.7733805859376571,0.27872239797669274,-1042
959,2019-08-18,2019,245843,245843,391649626.383333,3758555.8666666658,190682,0,156,0.8454867537412093,42221036,4945334940,701291,701291,331616361.6833439,3752793.633332817,191624,0,156,0.2992067486963331,4034549044,-455448,-455448,60033264.69998914,5762.2333338488825,-942,0,0,0.5462800050448762,-3992328008,1593.088379101024,472.8655603499031,1120.222818751121,0.7756250940640979,0.27324463026047674,-942
960,2019-08-19,2019,248174,248174,392222847.6833331,3786972.933333337,192085,0,109,0.8495370183822644,41817937,4955251275,714418,714418,332501840.31666136,3780536.8999999613,193066,0,110,0.2982959555890206,4052707585,-466244,-466244,59721007.36667174,6436.033333375584,-981,0,-1,0.5512410627932438,-4010889648,1580.4348871490693,465.4163813295037,1115.0185058195657,0.7739932466737047,0.2702423511165732,-981
961,2019-08-20,2019,248258,248258,392759196.6000001,3780748.583333334,192399,0,95,0.8460472572887878,40690727,4962630853,721832,721832,333385192.8833286,3775028.5666666143,193202,0,95,0.29328015383080636,4061891899,-473574,-473574,59374003.71667147,5720.01666671969,-803,0,0,0.5527671034579815,-4021201172,1582.0605845531668,461.85981347921484,1120.200771073952,0.7749961733358038,0.2676550776357934,-803
962,2019-08-21,2019,250182,250182,393350742.06666714,3813225.8500000006,193257,0,119,0.8410836910728994,41113686,4969792935,731799,731799,334319595.88332826,3807480.5166665595,193998,0,119,0.2899020086116566,4075043534,-481617,-481617,59031146.18333888,5745.333333441056,-741,0,0,0.5511816824612428,-4033929848,1572.2583641775473,456.8462048777441,1115.412159299803,0.7724656450104324,0.2650973832978728,-741
963,2019-08-22,2019,253129,253129,394065693.36666656,3830795.6833333327,195563,0,112,0.8414958380904591,42411708,4979564867,743220,743220,335365983.4000046,3825300.883332708,196409,0,112,0.28884986948682,4091002819,-490091,-490091,58699709.96666193,5494.800000624731,-846,0,0,0.5526459686036391,-4048591111,1556.7781382878554,451.23379806787307,1105.5443402199824,0.7725823591923485,0.2642676461882081,-846
964,2019-08-23,2019,257886,257886,394858819.41666657,3805538.833333335,198909,0,136,0.8337947775373618,42253031,4991504214,758814,758814,336380841.4499959,3799032.899999939,199838,0,138,0.28591591615336737,4108108564,-500928,-500928,58477977.96667069,6505.93333339598,-929,0,-2,0.5478788613839944,-4065855533,1531.1370893211208,443.29814875581616,1087.8389405653047,0.7713059258742235,0.26335571035853317,-929
965,2019-08-24,2019,250980,250980,394708364.7499997,3769215.1666666665,195254,0,122,0.8415252211331584,42515890,5001666139,766925,766925,336455844.23332787,3762249.383333222,196044,0,122,0.2778459432147827,4125813517,-515945,-515945,58252520.51667184,6965.783333444502,-790,0,0,0.5636792779183757,-4083297627,1572.6685980954646,438.70762360508246,1133.9609744903821,0.777966371822456,0.2556234312351273,-790
966,2019-08-25,2019,252483,252483,394979635.5000003,3730105.183333336,196436,0,195,0.8459341817072825,42773847,5011697826,781597,781597,336948969.2999973,3723085.549999897,197295,0,196,0.2758454804713926,4144905825,-529114,-529114,58030666.20000297,7019.633333439007,-859,0,-1,0.57008870123589,-4102131978,1564.3811088271302,431.1032019058381,1133.277906921292,0.7780167377605621,0.252425482697605,-859
967,2019-08-26,2019,252951,252951,395173448.8833336,3788079.516666665,195263,0,250,0.8464287549762596,43235196,5022481398,793941,793941,337404003.4999946,3781211.149999935,196157,0,250,0.272749486422793,4162376555,-540990,-540990,57769445.38333905,6868.366666730028,-894,0,0,0.5736792685534666,-4119141359,1562.2529615749042,424.973648545666,1137.2793130292382,0.7719400200038743,0.2470674773062482,-894
968,2019-08-27,2019,251948,251948,395480936.11666703,3824817.6833333313,195760,0,188,0.8534816708209626,44351760,5030563074,798646,798646,337991131.91666263,3817995.0999999084,196549,0,188,0.2724824265068648,4173227937,-546698,-546698,57489804.2000044,6822.5833334228955,-789,0,0,0.5809992443140978,-4128876177,1569.6926989564,423.2051896793606,1146.4875092770394,0.776985727213552,0.2461027789533786,-789
969,2019-08-28,2019,251398,251398,396272080.3833332,3802608.749999998,196206,0,158,0.8534753657546994,44369764,5045171614,806152,806152,339023311.73332536,3797249.8666665815,197407,0,159,0.26857093947542865,4188175352,-554754,-554754,57248768.650007844,5358.883333416656,-1201,0,-1,0.5849044262792708,-4143805588,1576.2737984523872,420.54514748251614,1155.728650969871,0.7804596695279994,0.24487565620379284,-1201
970,2019-08-29,2019,244820,244820,396502506.63333285,3745877.9499999997,192231,0,150,0.8576750265501194,43734620,5053588075,811024,811024,338866947.38332856,3740273.533333242,193108,0,150,0.26124011126673924,4189248176,-566204,-566204,57635559.25000429,5604.416666757781,-877,0,0,0.5964349152833801,-4145513556,1619.5674643956083,417.8260413789586,1201.7414230166496,0.7851932031696757,0.2381039278738977,-877
971,2019-08-30,2019,247003,247003,396693235.233333,3771723.0833333367,194958,0,90,0.8587507034327521,43911001,5060647225,823104,823104,339255075.61667377,3765466.9999994966,195725,0,90,0.26006434180856847,4207575569,-576101,-576101,57438159.616659224,6256.083333840128,-767,0,0,0.5986863616241835,-4163664568,1606.0259803862018,412.16550474384013,1193.8604756423617,0.7892940571572005,0.23778890638364047,-767
972,2019-08-31,2019,250427,250427,396515893.19999975,3807406.249999997,196200,0,149,0.8549557356035892,43858849,5060876255,834085,834085,339585273.28332675,3801207.883333259,197223,0,149,0.25946875917921813,4220624833,-583658,-583658,56930619.916673005,6198.36666673841,-1023,0,0,0.5954869764243711,-4176765984,1583.3591952944362,407.13509208692966,1176.2241032075065,0.7834618471650421,0.2364543182049791,-1023
973,2019-09-01,2019,257319,257319,396465212.61666644,3819051.950000002,196908,0,157,0.8391840478161353,43667313,5066498497,559966,559966,339755255.6833354,3816540.3499996555,198622,0,159,0.3915594875403169,4205333185,-302647,-302647,56709956.93333101,2511.600000346545,-1714,0,-2,0.44762456027581843,-4161665872,1540.75374386138,606.7426516669502,934.0110921944297,0.7652291513646485,0.3547036784376194,-1714
974,2019-09-02,2019,244710,244710,396559179.8500007,3813163.399999998,189946,0,65,0.8531404519635488,43075231,5073927859,575336,575336,340131988.78333884,3877233.7166664824,195709,0,68,0.3763870155874102,4215356595,-330626,-330626,56427191.066661835,-64070.316666484345,-5763,0,-3,0.4767534363761386,-4172281364,1620.5270722487871,591.1884338601076,1029.3386383886796,0.7762085734134282,0.3401647037557184,-5763
975,2019-09-03,2019,244190,244190,396713831.2499998,3790680.7166666696,189137,0,74,0.8475531348540083,42303298,5081568589,586363,586362,338044165.86667883,3848978.1999998093,194380,0,74,0.36509636522086486,4180158093,-342173,-342172,58669665.38332099,-58297.48333313968,-5243,0,0,0.48245676963314343,-4137854795,1624.611291412424,576.5110390282433,1048.1002523841807,0.7745485073098817,0.3315011349624721,-5243
976,2019-09-04,2019,248088,248088,396825003.9500005,3838991.416666667,192936,0,84,0.8582277256457386,42971766,5087294765,598841,598841,336045781.1000119,3884009.5499998117,198302,0,84,0.36979765914491236,4149887974,-350753,-350753,60779222.84998864,-45018.13333314471,-5366,0,0,0.4884300665008262,-4106916208,1599.5332460659142,561.1602764339981,1038.372969631916,0.7776917867853342,0.3311429912113566,-5366
977,2019-09-05,2019,249677,249677,397240657.5333334,3889863.966666671,193065,0,107,0.8547643555473672,42473007,5093065243,598400,598400,334863814.6500132,3883498.083333139,194271,0,107,0.3645137032085528,4136834761,-348723,-348723,62376842.88332021,6365.88333353214,-1206,0,0,0.4902506523388144,-4094361754,1591.0182256809135,559.5986207386584,1031.419604942255,0.773259050693496,0.32465073529411764,-1206
978,2019-09-06,2019,251420,251420,397476102.94999975,3860208.2833333337,195525,0,88,0.8568809163948761,42259032,5096761435,601912,601912,335370118.71668446,3853768.83333321,196470,0,89,0.36370765161685015,4147248297,-350492,-350492,62105984.23331529,6439.4500001235865,-945,0,-1,0.4931732647780259,-4104989265,1580.9247591679252,557.174667919371,1023.7500912485542,0.7776827619123379,0.32640984064115686,-945
979,2019-09-07,2019,258366,258366,396986831.8500004,3873537.9666666687,199660,0,116,0.849117143896643,41405709,5095876029,629320,629320,335261132.96668565,3883746.0833331365,204095,0,116,0.36026822602173647,4160411431,-370954,-370954,61725698.88331473,-10208.11666646786,-4435,0,0,0.4888489178749065,-4119005722,1536.528923503868,532.7355446619933,1003.7933788418748,0.7727797001153403,0.32431036674505814,-4435
980,2019-09-08,2019,253285,253285,397422741.1166665,3873997.366666676,194599,0,162,0.8374874153621416,42159285,5103668049,628041,628041,334257199.8500125,3868606.2833332056,195605,0,162,0.34151273563349743,4132463871,-374756,-374756,63165541.266654015,5391.083333470393,-1006,0,0,0.4959746797286441,-4090304586,1569.0733407689618,532.221940685421,1036.8514000835407,0.7683005310223661,0.3114525962476972,-1006
981,2019-09-09,2019,247106,247106,397777929.5000002,3790948.61666667,190279,0,150,0.8423267747444427,42145511,5113540200,628619,628619,334815754.78334713,3785449.4499998204,191096,0,150,0.3336806555322041,4136367400,-381513,-381513,62962174.71665305,5499.166666849516,-817,0,0,0.5086461192122387,-4094221889,1609.7461393086376,532.6211183297787,1077.1250209788589,0.77002986572564,0.3039933568664008,-817
982,2019-09-10,2019,241204,241204,397817677.1166662,3744060.4000000022,186407,0,120,0.8436344339231517,41484794,5120438139,633358,633358,335150080.0500152,3738414.983333125,187235,0,120,0.3241815845067184,4144511061,-392154,-392154,62667597.06665099,5645.416666877456,-828,0,0,0.5194528494164333,-4103026267,1649.2996679850507,529.1637273864311,1120.1359405986195,0.7728188587253942,0.2956226968002299,-828
983,2019-09-11,2019,244358,244358,398054439.66666746,3726237.9166666637,189414,0,60,0.8492171322404013,40987395,5127632023,646049,646048,335615956.6500164,3721479.816666007,190769,0,60,0.32498928099880214,4158227335,-401691,-401690,62438483.016651034,4758.100000656676,-1355,0,0,0.5242278512415992,-4117239940,1628.9805926823246,519.4907447279713,1109.4898479543533,0.775149575622652,0.295285651707533,-1355
984,2019-09-12,2019,239095,239095,398199181.3500004,3674000.416666663,186055,0,99,0.8475124950333552,41386089,5131845510,649018,649018,336102726.11667776,3668055.116666543,186998,0,99,0.3151638321279186,4173419378,-409923,-409923,62096455.23332262,5945.300000119954,-943,0,0,0.5323486629054366,-4132033289,1665.4433649804487,517.8634893279967,1147.5798756524518,0.7781634914991948,0.2881245204293255,-943
985,2019-09-13,2019,235627,235627,398256662.1166666,3642928.566666666,183953,0,110,0.8441604739694514,42132345,5141119377,657125,657125,336427701.3833431,3637547.4833331387,184879,0,110,0.3052509035571621,4189320059,-421498,-421498,61828960.733323514,5381.083333527204,-926,0,0,0.5389095704122893,-4147187714,1690.1996041059242,511.9691099613363,1178.230494144588,0.7806957606725885,0.2813452539471181,-926
986,2019-09-14,2019,245730,245730,398488360.7833341,3752534.966666667,190494,0,185,0.8420298701827207,42346021,5149595294,675029,675029,336888667.5333456,3746893.4833331234,191378,0,187,0.3090874614275886,4206259924,-429299,-429299,61599693.2499885,5641.483333543409,-884,0,-2,0.5329424087551321,-4163913903,1621.651246422228,499.0728806219371,1122.578365800291,0.7752167012574778,0.28351078249971484,-884
987,2019-09-15,2019,248010,248010,399201761.1166671,3780419.099999998,192708,0,213,0.847119067779526,43060122,5160976269,678998,678998,337812040.6666779,3774541.3666664846,193529,0,217,0.311641565954535,4222690256,-430988,-430988,61389720.4499892,5877.733333513606,-821,0,-4,0.5354775018249909,-4179630134,1609.6196166149232,497.51551649147405,1112.1041001234491,0.7770170557638805,0.2850214580897146,-821
988,2019-09-16,2019,248501,248501,399687319.933333,3796316.4166666674,193397,0,208,0.849867807373008,43767386,5171758370,692094,692094,338503604.4999906,3790477.3499998944,194218,0,208,0.3077139810488179,4241225895,-443593,-443593,61183715.4333424,5839.066666773055,-821,0,0,0.5421538263241901,-4197458509,1608.3932053928675,489.1006200024716,1119.2925853903957,0.7782544134631249,0.2806237303025312,-821
989,2019-09-17,2019,248407,248407,400025062.40000075,3796396.1499999976,192911,0,224,0.8471057578892716,43503813,5178562432,695479,695479,339106869.78332907,3791067.416666517,193797,0,226,0.30500849055111057,4248637384,-447072,-447072,60918192.61667168,5328.733333480544,-886,0,-2,0.542097267338161,-4205133571,1610.3614729053559,487.58750412784434,1122.7739687775115,0.7765924470727475,0.27865255457030336,-886
990,2019-09-18,2019,245436,245436,400339715.8499991,3771786.9999999986,192569,0,281,0.855571309832299,43295487,5187312361,704724,704724,339679694.3666849,3766803.9499994153,193403,0,281,0.30010614084379406,4264876446,-459288,-459288,60660021.483314216,4983.050000583287,-834,0,0,0.555465168988505,-4221580959,1631.1368986212256,482.0038687013425,1149.133029919883,0.784599651232908,0.27443793598628685,-834
991,2019-09-19,2019,247764,247764,400995314.36666644,3848127.983333335,193007,0,271,0.8481296717844404,43833182,5198112825,711861,711861,340592828.53332835,3842358.6333332937,193987,0,278,0.29778285367508883,4280466589,-464097,-464097,60402485.83333808,5769.350000041071,-980,0,-7,0.5503468181093516,-4236633407,1618.4567345000341,478.45412030344175,1140.0026141965923,0.7789953342697082,0.27250685175898104,-980
992,2019-09-20,2019,254415,254415,401700888.6333329,3900634.5999999996,197469,0,282,0.8450916809150398,44344626,5208217972,724735,724735,341528868.8833245,3894429.966666547,198536,0,282,0.2991659020193603,4298207547,-470320,-470320,60172019.750008404,6204.633333452512,-1067,0,0,0.5459257788956795,-4253862921,1578.919830329709,471.2465506472359,1107.673279682473,0.7761688579682802,0.27394288946994416,-1067
993,2019-09-21,2019,247313,247313,401522678.6333336,3836686.7666666685,192395,0,282,0.8478365472094074,43404269,5211651717,727628,727628,341641014.06665856,3830386.2333332133,193301,0,282,0.29042037964454465,4313013494,-480315,-480315,59881664.56667507,6300.533333455212,-906,0,0,0.5574161675648628,-4269609225,1623.540528129672,469.5270303873113,1154.0134977423609,0.777941313234646,0.2656591005293914,-906
994,2019-09-22,2019,252843,252843,401622983.01666653,3834185.7,197518,0,273,0.8562863120592622,44360936,5218458701,751002,751002,342067412.43333125,3842667.499999923,199735,0,273,0.29225221770381454,4332825090,-498159,-498159,59555570.58333528,-8481.79999992298,-2217,0,0,0.5640340943554476,-4288464154,1588.428325153026,455.4813601472849,1132.946965005741,0.781188326352717,0.26595801342739434,-2217
995,2019-09-23,2019,255004,255004,401600817.1333339,3831821.1000000006,195959,0,239,0.8384731219902432,44146520,5226333767,780196,780196,341358156.0833369,3861965.266666582,206304,0,237,0.2884608482996579,4329642369,-525192,-525192,60242661.04999703,-30144.166666581295,-10345,0,2,0.5500122736905853,-4285495849,1574.8804612215256,437.5287185314163,1137.3517426901094,0.768454612476667,0.2644258622192372,-10345
996,2019-09-24,2019,248487,248487,402008141.93333274,3840876.6166666695,191819,0,213,0.8402652855078949,43448922,5236154628,757202,757202,336508255.2166629,3835234.833333248,192757,0,212,0.2781424243464766,4221515047,-508715,-508715,65499886.71666986,5641.783333421685,-938,0,1,0.5621228611614183,-4178066125,1617.823636380707,444.4101510781309,1173.4134853025762,0.771947828256609,0.25456483210556763,-938
997,2019-09-25,2019,249587,249587,402370665.2666672,3846794.166666665,191499,0,251,0.8361733583880566,43400148,5243608078,764648,764647,337168124.0499909,3843857.8166666017,192724,0,251,0.27556601207352793,4235565454,-515061,-515060,65202541.216676295,2936.350000063423,-1225,0,0,0.5606073463145287,-4192165306,1612.1459261366465,440.94611507007926,1171.1998110665672,0.7672635193339397,0.25204277000659125,-1225
998,2019-09-26,2019,248641,248641,402967007.50000006,3824806.5333333327,191266,0,178,0.836422794309868,43797999,5251858767,785140,785140,338114752.2999904,3887470.8166665626,196073,0,180,0.2717922918205672,4250228514,-536499,-536499,64852255.200009644,-62664.28333322983,-4807,0,-2,0.5646305024893008,-4206430515,1620.6780358026233,430.6426271747592,1190.0354086278642,0.7692456191858945,0.24972998446136996,-4807
999,2019-09-27,2019,250392,250392,403603336.6333339,3825899.4500000034,193063,0,79,0.8393518962267169,43825035,5262761826,799589,799587,336734236.2666593,3839470.916666588,197880,0,79,0.2697110640591594,4219062323,-549197,-549195,66869100.3666746,-13571.466666584369,-4817,0,0,0.5696408321675575,-4175237288,1611.8859094273537,421.1352063836197,1190.7507030437341,0.771043004568836,0.24747714138138469,-4817
1000,2019-09-28,2019,252839,252839,404105638.3333333,3884049.150000003,194698,0,61,0.8446204897187543,44109209,5274648059,799282,799282,335980808.5833273,3878355.766666563,195569,0,61,0.2691378011765534,4202330281,-546443,-546443,68124829.75000602,5693.383333439939,-871,0,0,0.5754826885422009,-4158221072,1598.2725700280942,420.353277795981,1177.919292232113,0.7700473423799334,0.24468085106382978,-871
1001,2019-09-29,2019,256641,256641,404750533.2000004,3872987.0166666717,197660,0,60,0.8456170292353907,43618693,5286306381,802830,802830,336856103.1000122,3868367.31666601,198462,0,60,0.2723328724636475,4220487362,-546189,-546189,67894430.09998822,4619.700000661891,-802,0,0,0.5732841567717433,-4176868669,1577.1078401346645,419.5858439520349,1157.5219961826297,0.7701809141953156,0.24720301931915847,-802
1002,2019-09-30,2019,262296,262296,405162000.13333315,3987700.5166666624,201095,0,66,0.8399403727086956,44309122,5297349163,816144,816144,337553775.09999394,3982108.666666569,201883,0,66,0.2717241075104396,4237712391,-553848,-553848,67608225.0333392,5591.850000093225,-788,0,0,0.568216265198256,-4193403269,1544.6747191468155,413.5958545305656,1131.07886461625,0.7666720041479855,0.24736198513987728,-788
1003,2019-10-01,2019,252246,252246,405204767.5166664,3931835.4333333336,193375,0,32,0.8335910182916679,44540658,5304359910,548864,548864,337909987.1666813,3926877.499999805,194286,0,30,0.38596446478545443,4199692355,-296618,-296618,67294780.34998512,4957.933333528694,-911,0,2,0.4476265535062135,-4155151697,1606.3872866831045,615.6533989598175,990.733887723287,0.7666127510446151,0.35397839902052236,-911
1004,2019-10-02,2019,258223,258223,405406029.2666669,3901122.6166666625,198958,0,49,0.8424462576919948,43614406,5307684427,566784,566784,338423732.400012,3895557.7666664794,199703,0,49,0.3862035625564579,4218995676,-308561,-308561,66982296.86665487,5564.850000183098,-745,0,0,0.4562426951355369,-4175381270,1569.9841968634355,597.0947175643844,972.8894792990511,0.7704890733977996,0.352344102868112,-745
1005,2019-10-03,2019,251697,251697,405262982.7999995,3803547.383333339,193130,0,38,0.8383373659598642,43221979,5311975796,573672,573672,338622688.3833436,3798131.516666471,193867,0,38,0.3699221854997309,4234825259,-321975,-321975,66640294.4166559,5415.866666867863,-737,0,0,0.4684151804601333,-4191603280,1610.1224202116016,590.2722956381758,1019.8501245734258,0.7673114896085372,0.3379404956142186,-737
1006,2019-10-04,2019,243099,243099,405020506.416667,3702806.9500000025,186673,0,35,0.8351412387545817,42272456,5317062546,580311,580311,338742229.7166805,3697425.8166664597,187312,0,35,0.3517320884835978,4247889789,-337212,-337212,66278276.69998646,5381.13333354285,-639,0,0,0.48340915027098386,-4205617333,1666.072285022427,583.7253295503282,1082.3469554720987,0.7678888025043296,0.32277864800081335,-639
1007,2019-10-05,2019,239983,239983,404537833.04999954,3633768.233333336,184942,0,35,0.8388594192088608,42193359,5319670039,593247,593247,338575622.3833473,3628978.0166665325,185557,0,35,0.34114963918906277,4264001234,-353264,-353264,65962210.66665226,4790.216666803695,-615,0,0,0.497709780019798,-4221807875,1685.693707679292,570.7161138334409,1114.977593845851,0.7706462541096661,0.3127820283962666,-615
1008,2019-10-06,2019,233259,233259,403711352.81666654,3601200.249999993,180037,0,57,0.839946154274863,42470357,5318915395,596334,596334,338098506.7833483,3596346.566666503,180680,0,57,0.33034004433756536,4282066072,-363075,-363075,65612846.03331822,4853.683333490044,-643,0,0,0.5096061099372976,-4239595715,1730.74287730234,566.9616469685584,1163.7812303337817,0.7718330268071114,0.30298456905023025,-643
1009,2019-10-07,2019,232412,232412,403779910.7666667,3587558.0666666697,179606,0,36,0.843798943255942,42348824,5327880491,606457,606456,338482287.0166762,3581770.5833331374,180350,0,36,0.32557131008463314,4297631039,-374045,-374044,65297623.74999052,5787.483333532233,-744,0,0,0.5182276331713088,-4255282215,1737.345364123482,558.1316484900408,1179.2137156334413,0.7727914221296662,0.2973829966510404,-744
1010,2019-10-08,2019,235450,235450,403941617.6333334,3619448.9666666635,181788,0,49,0.8423699299214266,42456226,5331718296,616191,616184,338865130.25001013,3614786.96666654,182571,0,50,0.3239401419365116,4303236171,-380741,-380734,65076487.38332325,4662.0000001234,-783,0,-1,0.5184297879849149,-4260779945,1715.615279818787,549.9414626962241,1165.673817122563,0.7720874920365258,0.2962896244833177,-783
1011,2019-10-09,2019,237658,237658,404144739.71666634,3678049.583333332,183666,0,71,0.8448568952023501,42562662,5336294584,623685,623685,339328946.800015,3674680.7999998243,184559,0,71,0.32416364029919165,4315498361,-386027,-386027,64815792.91665137,3368.783333507832,-893,0,0,0.5206932549031584,-4272935699,1700.530761500418,544.0710403489181,1156.4597211515,0.772816400037028,0.29591700938775184,-893
1012,2019-10-10,2019,244543,244543,404701331.46666706,3724041.283333335,186301,0,40,0.8321603971489677,42784760,5343582734,636124,636124,340120094.7333425,3719064.8666664786,187227,0,40,0.32225163647339766,4328849387,-391581,-391581,64581236.73332453,4976.416666856501,-926,0,0,0.5099087606755701,-4286064627,1654.9291186689745,534.6757782025871,1120.2533404663873,0.7618332972115334,0.29432469141236617,-926
1013,2019-10-11,2019,243171,243171,404936522.7333337,3623393.6000000043,187133,0,50,0.8411899445246347,42020661,5348334552,643582,643582,340650240.6833466,3617552.4333331743,188082,0,52,0.3201736530853883,4338698515,-400411,-400411,64286282.04998708,5841.166666829959,-949,0,-2,0.5210162914392464,-4296677854,1665.2336122865543,529.3035552320398,1135.9300570545145,0.7695531128300661,0.29224248036769207,-949
1014,2019-10-12,2019,231854,231854,404662449.8666669,3538857.9666666603,180658,0,44,0.8499055440061422,40847236,5346680664,654092,654091,340669274.23335063,3541503.583333196,183971,0,44,0.3072335390128587,4354968338,-422238,-422237,63993175.63331628,-2645.616666535847,-3313,0,0,0.5426720049932834,-4314121102,1745.333053847106,520.8285609087277,1224.5044929383782,0.7791886273258171,0.2812616573815304,-3313
1015,2019-10-13,2019,229573,229573,404401127.4333331,3523421.2166666673,177488,0,39,0.8387397472699308,41094441,5349496120,663589,663589,340174072.2500085,3519826.699999961,179296,0,42,0.29349491929492366,4363001883,-434016,-434016,64227055.183324575,3594.516666706186,-1808,0,-3,0.5452448279750072,-4321907442,1761.536101516002,512.6276539394241,1248.9084475765778,0.7731222748319707,0.2701913383133235,-1808
1016,2019-10-14,2019,227049,227049,404177378.81666595,3568613.5500000035,176893,0,39,0.843980814714005,41558673,5355580156,666488,666486,339930725.20000947,3563494.549999776,177752,0,39,0.28964962609979344,4362921089,-439439,-439437,64246653.61665648,5119.000000227708,-859,0,0,0.5543311886142115,-4321362416,1780.1328295507399,510.03430709723756,1270.0985224535023,0.7790961422424234,0.26669947545942313,-859
1017,2019-10-15,2019,232692,232692,404445292.66666657,3629504.6833333364,180383,0,45,0.8400675571141254,42169323,5361750301,672753,672753,340437116.65001166,3624322.4333331813,181127,0,45,0.2923896288831134,4370980935,-440061,-440061,64008176.01665491,5182.250000155065,-744,0,0,0.547677928231012,-4328811612,1738.1142998756577,506.0358209476757,1232.078478927982,0.7752006944802572,0.2692325415122638,-744
1018,2019-10-16,2019,237554,237554,404823771.36666626,3695605.333333328,185197,0,45,0.8466032986184202,42283971,5368522180,681447,681446,341117782.266678,3690547.316666543,185903,0,45,0.296752351980418,4382619641,-443893,-443892,63705989.09998828,5058.016666784883,-706,0,0,0.5498509466380022,-4340335670,1704.1336764132209,500.57933022818827,1203.5543461850325,0.7795995857783914,0.27280624905531903,-706
1019,2019-10-17,2019,236230,236230,405178332.3833335,3696721.5166666643,183669,0,59,0.8438174660288703,42460027,5376597011,687396,687396,341826481.26667845,3691473.349999874,184393,0,58,0.2915859271802548,4394684307,-451166,-451166,63351851.11665505,5248.166666790377,-724,0,1,0.5522315388486155,-4352224280,1715.185761263741,497.2773790750578,1217.9083821886832,0.7775007408034542,0.2682485786940861,-724
1020,2019-10-18,2019,236239,236239,405436441.04999954,3676899.5666666655,183023,0,30,0.8426720397563484,41575376,5379987019,695499,695499,342287360.5333431,3672246.249999836,183737,0,30,0.28763233304433417,4407193760,-459260,-459260,63149080.51665646,4653.3166668294,-714,0,0,0.5550397067120143,-4365618384,1716.2129921393146,492.14644526209685,1224.0665468772177,0.7747366014925563,0.26418010665723457,-714
1021,2019-10-19,2019,236077,236077,405488892.0500008,3686180.2333333325,182951,0,45,0.8439322763335695,41674671,5381841036,703267,703267,342606315.8833306,3681363.049999899,183625,0,45,0.2847339630609782,4420355577,-467190,-467190,62882576.1666702,4817.183333433233,-674,0,0,0.5591983132725913,-4378680906,1717.612863811387,487.16393046073625,1230.4489333506506,0.774963253514743,0.2611028243895988,-674
1022,2019-10-20,2019,238171,238171,405801319.0333332,3674791.583333331,183827,0,34,0.8394262945530733,41726544,5386937979,712437,712437,343161549.83332956,3669904.6333332937,184496,0,34,0.28213020940798705,4437124353,-474266,-474266,62639769.200003624,4886.950000037439,-669,0,0,0.5572960851450862,-4395397809,1703.8233833394208,481.6728353992417,1222.1505479401792,0.7718278043926423,0.2589646523131168,-669
1023,2019-10-21,2019,243005,243005,406342013.83333355,3744962.4666666635,187151,0,38,0.8418221847287097,42216179,5395490957,731890,731890,343978300.28333443,3767619.9166666027,189609,0,38,0.2835754006749635,4452535935,-488885,-488885,62363713.54999912,-22657.449999939185,-2458,0,0,0.5582467840537462,-4410319756,1672.154950858351,469.98633713171984,1202.168613726631,0.7701528775128084,0.2590676194510104,-2458
1024,2019-10-22,2019,243426,243426,406494765.11666703,3767424.249999995,187434,0,43,0.8424572560038786,42990681,5397607682,734012,734012,343904557.73333085,3763086.0833332133,188251,0,43,0.2810076674495784,4456013721,-490586,-490586,62590207.38333619,4338.16666678153,-817,0,0,0.5614495885543002,-4413023040,1669.8905010831506,468.52715995560135,1201.3633411275493,0.7699834857410466,0.25646855909712646,-817
1025,2019-10-23,2019,241452,241452,406768822.116666,3736541.8333333367,185734,0,36,0.8345261169921963,41578978,5402964655,735095,735095,344294680.09999293,3734027.1499999254,186449,0,36,0.2755888694658446,4466243035,-493643,-493643,62474142.01667309,2514.683333411347,-715,0,0,0.5589372475263517,-4424664057,1684.6777915141147,468.36759888176755,1216.310192632347,0.7692377781091065,0.25363932552935337,-715
1026,2019-10-24,2019,239737,239737,406978018.16666645,3656858.4333333313,185150,0,40,0.8374051564839812,42171369,5409951829,743928,743927,344803463.19999546,3653969.766666593,185877,0,39,0.2712426471378981,4480893637,-504191,-504190,62174554.96667099,2888.6666667382233,-727,0,1,0.5661625093460831,-4438722268,1697.6020312536923,463.4909919924878,1234.1110392612045,0.7723046505128537,0.2498588573087718,-727
1027,2019-10-25,2019,233837,233837,406322585.56666684,3585009.9666666677,181274,0,89,0.8398243220705012,41172731,5409403967,752899,752899,344425160.16666186,3581883.6166666434,182034,0,89,0.26238977605229985,4491197948,-519062,-519062,61897425.40000498,3126.3500000243075,-760,0,0,0.5774345460182013,-4450025217,1737.6317074144247,457.4652910505418,1280.166416363883,0.7752152140166013,0.2417774495649483,-760
1028,2019-10-26,2019,230687,230687,406086052.01666725,3592854.799999998,178265,0,78,0.8364103742300181,40989851,5409956486,758752,758751,344432650.48332727,3589072.183333273,179069,0,78,0.2558345809961594,4503704343,-528065,-528064,61653401.53333998,3782.6166667249054,-804,0,0,0.5805757932338587,-4462714492,1760.333490906151,453.94688176137794,1306.386609144773,0.7727570257535101,0.2360046497406267,-804
1029,2019-10-27,2019,228975,228975,406024207.86666715,3534664.0833333344,177068,0,113,0.8395545365214553,40715209,5413117157,765318,765317,344631927.66666126,3532630.4999999637,177853,0,113,0.2528413025696526,4516291794,-536343,-536342,61392280.20000589,2033.5833333707415,-785,0,0,0.5867132339518026,-4475576585,1773.2250589220096,450.31265170728113,1322.9124072147283,0.7733071295993013,0.2323909799586577,-785
1030,2019-10-28,2019,230218,230218,406109624.68333364,3555685.5999999973,178596,0,76,0.8392610482238574,41146603,5419157844,777303,777303,344974664.98332745,3552474.4166665897,179440,0,76,0.25022931855402275,4528626358,-547085,-547085,61134959.70000619,3211.183333407622,-844,0,0,0.5890317296698346,-4487479755,1764.0220342602822,443.80976914192723,1320.212265118355,0.775769053679556,0.2308494885520833,-844
1031,2019-10-29,2019,233350,233350,406109367.96666706,3605783.933333332,180360,0,38,0.835187486608099,41091801,5419651753,783230,783230,345208166.4666623,3602767.899999959,181098,0,38,0.25018832271490943,4530195505,-549880,-549880,60901201.50000477,3016.033333373256,-738,0,0,0.5849991638931896,-4489103704,1740.3444095421771,440.7494177529746,1299.5949917892026,0.7729162202699807,0.23121943745770718,-738
1032,2019-10-30,2019,234332,234332,406508041.5666672,3647206.8833333347,180585,0,43,0.8321398699281374,41249725,5426554088,790051,790051,345846881.36666465,3642949.516666597,181413,0,43,0.24840548268402696,4536286769,-555719,-555719,60661160.20000255,4257.366666737478,-828,0,0,0.5837343872441104,-4495037044,1734.752579957783,437.7526025113121,1296.999977446471,0.7706373862724681,0.22962188516943843,-828
1033,2019-10-31,2019,238496,238496,407217711.53333306,3718682.0833333316,183284,0,35,0.8328273849456603,41076692,5436027159,797908,797908,346720281.94999754,3713593.299999932,184138,0,35,0.2505928001724549,4546877870,-559412,-559412,60497429.58333552,5088.783333399799,-854,0,0,0.5822345847732054,-4505801178,1707.440424717115,434.5366658186126,1272.9037588985025,0.7684992620421307,0.23077597918557027,-854
1034,2019-11-01,2019,234397,234397,407061559.6666672,3630495.166666664,179671,0,79,0.831781123478542,41003326,5437277383,516008,516008,346892409.3666775,3625376.449999835,180689,0,83,0.3808526224399653,4481290710,-281611,-281611,60169150.2999897,5118.716666829307,-1018,0,-4,0.45092850103857673,-4440287384,1736.6329759624364,672.2616885138942,1064.3712874485423,0.7665243155842438,0.35016705167361745,-1018
1035,2019-11-02,2019,233049,233049,407037550.2833336,3628051.6499999943,178463,0,113,0.8337731550017381,41497596,5437228161,524329,524329,347088887.4666753,3622186.849999827,179437,0,113,0.37352692679597194,4494017487,-291280,-291280,59948662.81665832,5864.800000167452,-974,0,0,0.46024622820576616,-4452519891,1746.5749704282516,661.9677482395124,1084.6072221887393,0.7657745795948492,0.3422221544106849,-974
1036,2019-11-03,2019,228632,228632,406999648.8999994,3540906.850000001,176803,0,147,0.8444793379754368,41688049,5443473331,532081,532081,347245121.7333394,3535790.483333152,177779,0,147,0.36547818847129543,4512205293,-303449,-303449,59754527.16665995,5116.366666849237,-976,0,0,0.4790011495041414,-4470517244,1780.1517237307087,652.6170296126706,1127.534694118038,0.7733081983274432,0.334120180949893,-976
1037,2019-11-04,2019,227296,227296,406960274.1000007,3563756.283333331,176685,0,206,0.8426853090243556,40973661,5450248118,544448,544448,347454555.1166837,3559488.8333331523,177902,0,206,0.354691357117659,4526330090,-317152,-317152,59505718.98331696,4267.4500001785345,-1217,0,0,0.4879939519066966,-4485356429,1790.4418647930481,638.1776682377082,1152.2641965553398,0.777334400957342,0.3267566415892794,-1217
1038,2019-11-05,2019,228168,228168,407015840.38333285,3590573.566666668,177061,0,237,0.8417131236632659,40891655,5452628289,556359,556359,347738220.3833431,3608698.633333159,180360,0,237,0.3519993385565779,4530555286,-328191,-328191,59277619.99998975,-18125.06666649133,-3299,0,0,0.489713785106688,-4489663631,1783.8427841911787,625.0248857003178,1158.817898490861,0.7760115353599102,0.32417917208133595,-3299
1039,2019-11-06,2019,233233,233233,407166884.4666669,3591850.816666664,179935,0,201,0.8384319543117816,41218947,5453983345,564204,564202,346875055.9833373,3586950.799999873,180776,0,201,0.348790508397669,4518018775,-330971,-330969,60291828.483329594,4900.016666790936,-841,0,0,0.4896414459141126,-4476799828,1745.7516066194187,614.806498352252,1130.9451082671667,0.7714817371469732,0.32040893010329596,-841
1040,2019-11-07,2019,230550,230550,406808475.44999933,3555456.383333331,178954,0,57,0.8422901756668831,41903135,5454741186,568009,568008,346806751.7666797,3550496.799999865,179807,0,57,0.34403504169827875,4522264345,-337459,-337458,60001723.68331963,4959.583333466202,-853,0,0,0.4982551339686044,-4480361210,1764.513014313595,610.5666676643282,1153.9463466492668,0.7762047278247669,0.31655660385662904,-853
1041,2019-11-08,2019,231413,231413,406723720.15000015,3607235.083333334,179278,0,51,0.839926883969354,42073134,5455403315,576751,576747,347046795.90000534,3601736.099999875,180190,0,50,0.33953300471087633,4533535312,-345338,-345334,59676924.249994814,5498.983333459124,-912,0,1,0.5003938792584777,-4491462178,1757.566429500504,601.7314279918323,1155.8350015086717,0.7747101502508502,0.3124225185565348,-912
1042,2019-11-09,2019,234140,234140,406630888.7166669,3562786.833333334,179836,0,154,0.8319723242504481,41315854,5454106771,587201,587201,347260969.23334587,3556962.3999998122,180651,0,155,0.3337749765412598,4542288463,-353061,-353061,59369919.48332101,5824.433333521709,-815,0,-1,0.4981973477091883,-4500972609,1736.6997895133975,591.3834772647626,1145.3163122486349,0.7680703852396003,0.3076476368398555,-815
1043,2019-11-10,2019,229255,229255,405915601.0499996,3553773.5833333354,174981,0,326,0.8326492333864041,40895875,5452867512,593779,593779,346778075.300013,3548743.2833331656,175791,0,326,0.32353282955443147,4557389121,-364524,-364524,59137525.74998659,5030.30000016978,-810,0,0,0.5091164038319727,-4516493246,1770.5855970425928,584.0187600100593,1186.5668370325334,0.7632592527971037,0.2960545927019986,-810
1044,2019-11-11,2019,235857,235857,406194236.8000002,3637481.633333331,180582,0,128,0.8346837278520459,41516396,5460494318,605165,605160,347349745.33334655,3631600.366666537,181407,0,128,0.32720167227120045,4570981759,-369308,-369303,58844491.466653645,5881.266666794196,-825,0,0,0.5074820555808455,-4529465363,1722.205560148735,573.9800141009758,1148.225546047759,0.7656418931810377,0.2997645270298183,-825
1045,2019-11-12,2019,234949,234949,406636617.75000036,3600025.7666666694,180603,0,76,0.8345002532464489,41556032,5468240056,608526,608526,348030935.900015,3594406.3833331745,181456,0,76,0.3242835967567481,4577055094,-373577,-373577,58605681.84998536,5619.383333494887,-853,0,0,0.5102166564897008,-4535499062,1730.7441944847621,571.924512510583,1158.8196819741793,0.7686902263895569,0.29818939535862066,-853
1046,2019-11-13,2019,229598,229598,406474320.18333304,3531672.433333338,177395,0,38,0.8369933536006412,40664348,5470182897,614895,614895,348132658.6000134,3526692.6333331745,178151,0,40,0.3141902275998365,4582800494,-385297,-385297,58341661.583319664,4979.800000163261,-756,0,-2,0.5228031260008047,-4542136146,1770.373958759802,566.1660260695132,1204.2079326902888,0.7726330368731434,0.28972588815976713,-756
1047,2019-11-14,2019,229689,229689,406170318.766667,3521271.8666666653,178271,0,47,0.8420995345880737,40046473,5467894477,628455,628455,348167294.46668583,3516722.599999847,180286,0,47,0.3116134011186103,4596682448,-398766,-398766,58003024.29998118,4549.26666681841,-2015,0,0,0.5304861334694635,-4556635975,1768.3490230993518,554.0051307837249,1214.3438923156268,0.7761407816656436,0.2868717728397419,-2015
1048,2019-11-15,2019,234639,234639,406360034.2000004,3568508.583333331,180771,0,44,0.8370262403095806,40014944,5472606559,639126,639126,347655645.98334396,3562955.9166665124,181552,0,44,0.3091315327494095,4586106332,-404487,-404487,58704388.21665645,5552.666666818783,-781,0,0,0.5278947075601711,-4546091388,1731.8520544325556,543.9547851023804,1187.8972693301753,0.7704217968879854,0.2840629234298088,-781
1049,2019-11-16,2019,229932,229932,406367579.05,3567232.7499999986,176118,0,48,0.8375171789920494,40213904,5473367293,635900,635899,347835733.7333452,3562029.399999842,176785,0,48,0.30441736122031016,4592702943,-405968,-405967,58531845.3166548,5203.350000156555,-667,0,0,0.5330998177717392,-4552489039,1767.3380784318842,546.9983971249289,1220.3396813069553,0.7659568916027347,0.27800754835665986,-667
1050,2019-11-17,2019,234386,234386,406436872.8666673,3535741.1333333356,179181,0,78,0.8401440359065797,40497446,5477454638,649454,649454,348168867.38334584,3530734.8333331477,179872,0,75,0.3048499200867274,4608438956,-415068,-415068,58268005.48332143,5006.300000187941,-691,0,3,0.5352941158198523,-4567941510,1734.0492728519077,536.0947309329773,1197.9545419189303,0.7644697208877663,0.2769587992375134,-691
1051,2019-11-18,2019,222961,222961,405660595.8666661,3505232.033333334,172598,0,57,0.8391916075008631,40381666,5473508835,651887,651887,347966021.4333415,3499304.4166665482,173230,0,57,0.28861443777831913,4618130566,-428926,-428926,57694574.433324575,5927.616666785907,-632,0,0,0.5505771697225439,-4577748900,1819.4240062910826,533.7827283460807,1285.641277945002,0.774117446548948,0.26573623956299175,-632
1052,2019-11-19,2019,230118,230118,405696035.49999994,3542908.666666664,177953,0,36,0.8367837370392586,40013941,5473482716,664524,664524,348223472.71668196,3539217.4833331797,178910,0,37,0.2917622237872503,4622105057,-434406,-434406,57472562.78331798,3691.183333484456,-957,0,-1,0.5450215132520082,-4582091116,1762.9913153251807,524.019407450569,1238.9719078746116,0.7733119529980271,0.2692303062041401,-957
1053,2019-11-20,2019,229572,229572,405369675.43333334,3541532.7499999967,177223,0,49,0.8348579095011585,39775340,5461109735,667455,667455,348275762.2166805,3536821.949999828,177889,0,34,0.2886321924324555,4622638434,-437883,-437883,57093913.21665281,4710.800000168849,-666,0,15,0.5462257170687029,-4582863094,1765.7627037850145,521.7966188232623,1243.9660849617521,0.7719713205443173,0.26651834206051345,-666
1054,2019-11-21,2019,231018,231018,405053882.166667,3554727.283333333,177512,0,38,0.8336233540243623,39590546,5455642731,675121,675121,348358356.4833441,3548799.2333331485,178112,0,38,0.2865264152648188,4626124228,-444103,-444103,56695525.68332291,5928.050000184681,-600,0,0,0.5470969387595435,-4586533682,1753.3433852196235,515.993957354821,1237.3494278648027,0.768390341878122,0.2638223370329171,-600
1055,2019-11-22,2019,237701,237701,405163494.7166658,3622855.833333335,183108,0,75,0.8446788191888129,40648249,5456560935,686112,686112,348747448.7500129,3617505.4333331836,183917,0,75,0.2944286064082799,4631404169,-448411,-448411,56416045.96665293,5350.400000151247,-809,0,0,0.5502502127805331,-4590755920,1704.509003818519,508.2952182005458,1196.2137856179731,0.7703291109418976,0.2680568187118138,-809
1056,2019-11-23,2019,234654,234654,405182955.5833331,3633004.8000000003,180646,0,50,0.8451166398186254,41319442,5458621913,691957,691957,348933852.5166644,3631567.266666193,182104,0,50,0.2895078740441916,4636140817,-457303,-457303,56249103.06666869,1437.5333338072523,-1458,0,0,0.5556087657744337,-4594821375,1726.7251169097185,504.271006025901,1222.4541108838175,0.769839849310048,0.26317242256382983,-1458
1057,2019-11-24,2019,225035,225035,405097159.416667,3492618.1166666667,174083,0,84,0.8486724287333072,40497779,5461014203,696805,696805,348968238.81666243,3490880.099999573,176518,0,84,0.278083538436141,4650792863,-471770,-471770,56128920.600004554,1738.016667093616,-2435,0,0,0.5705888902971662,-4610295084,1800.1517960169174,500.8119040716735,1299.3398919452438,0.7735818872619815,0.2533248182777104,-2435
1058,2019-11-25,2019,225238,225238,405269485.35000026,3506513.6999999955,173840,0,40,0.8352187463927043,40882039,5470547041,706502,706502,346990798.7000152,3501836.016666529,174704,0,40,0.2684366073981431,4619040999,-481264,-481264,58278686.649985075,4677.683333466761,-864,0,0,0.5667821389945612,-4578158960,1799.2944589722883,491.1391598325485,1308.1552991397398,0.7718058231737096,0.24728026247625626,-864
1059,2019-11-26,2019,226172,226172,405707901.0333341,3522965.899999999,174750,0,90,0.8366906602055072,40459357,5477537703,703579,703579,347579552.15001047,3518305.4166661487,175623,0,91,0.27086226280204556,4622959597,-477407,-477407,58128348.88332361,4660.483333850279,-873,0,-1,0.5658283974034617,-4582500240,1793.802508857569,494.0163821688971,1299.7861266886719,0.7726420600251136,0.24961376050166365,-873
1060,2019-11-27,2019,218428,218428,405720403.9499999,3477442.6166666704,168387,0,83,0.8358635339791602,40283953,5480526241,704992,704992,347890150.18334156,3471771.816666509,169111,0,84,0.2606909014570342,4635429490,-486564,-486564,57830253.766658366,5670.800000161398,-724,0,-1,0.575172632522126,-4595145537,1857.4560218927973,493.4668055571433,1363.989216335654,0.7709039134176937,0.239876480867868,-724
1061,2019-11-28,2019,220643,220643,405672088.066667,3455310.4833333353,167896,0,57,0.8222105391968018,40126352,5484451447,717317,717317,348063247.74999666,3450897.633333262,168755,0,57,0.2546781966689806,4647505919,-496674,-496674,57608840.31667036,4412.850000073202,-859,0,0,0.5675323425278211,-4607379567,1838.5903385408421,485.2293306167241,1353.361007924118,0.760939617390989,0.23525860951294894,-859
1062,2019-11-29,2019,230200,230200,405965276.95000035,3499850.916666667,175066,0,67,0.8225456125108597,39977372,5490581037,730940,730940,348545273.75001365,3496125.083332834,175878,0,66,0.2609625961091049,4655883342,-500740,-500740,57420003.199986696,3725.833333833143,-812,0,1,0.5615830164017548,-4615905970,1763.5329146394454,476.84525918681925,1286.6876554526261,0.7604952215464813,0.24061892905026405,-812
1063,2019-11-30,2019,223077,223077,405933336.6833337,3482447.0999999996,170364,0,44,0.8305472998112761,39868154,5493571956,731845,731845,348752713.3999952,3477644.283333285,171477,0,44,0.25550492249041606,4665205496,-508768,-508768,57180623.28333849,4802.816666714847,-1113,0,0,0.5750423773208599,-4625337342,1819.7005369595865,476.539039550718,1343.1614974088686,0.7637004263101979,0.23430781108021506,-1113
1064,2019-12-01,2019,219616,219616,405715286.6666666,3415784.7000000025,167299,0,45,0.8393923939967947,39995597,5497404355,493670,493670,348827706.18334204,3410537.699999867,168335,0,45,0.3768610610326746,4612181578,-274054,-274054,56887580.48332459,5247.000000135507,-1036,0,0,0.4625313329641201,-4572185981,1847.3849203458155,706.600980783402,1140.7839395624137,0.7617796517557919,0.34098689407904065,-1036
1065,2019-12-02,2019,221749,221749,406217687.7166671,3447798.33333333,170679,0,40,0.8338526893018688,40360805,5510667739,512132,512132,349473921.9666772,3452644.166666502,173701,0,40,0.3681726586114482,4627994692,-290383,-290383,56743765.74998993,-4845.833333171904,-3022,0,0,0.46568003069042063,-4587633887,1831.8805844295448,682.3903250854803,1149.4902593440645,0.769694564575263,0.3391723227605383,-3022
1066,2019-12-03,2019,221243,221243,406675935.63333297,3488352.35,169866,0,39,0.8284284700532896,40172430,5519871068,514811,514811,349318647.68334484,3485455.349999834,171794,0,37,0.3609266313268369,4621137603,-293568,-293568,57357287.94998813,2897.000000166241,-1928,0,2,0.4675018387264527,-4580965173,1838.1414807850779,678.5376530092497,1159.6038277758282,0.7677802235550956,0.33370304830316366,-1928
1067,2019-12-04,2019,222523,222523,406954640.46666664,3486415.466666669,170855,0,45,0.8299276928677037,40797321,5526325655,516859,516859,349108715.0666772,3481514.3833331224,171846,0,45,0.36014851245697904,4612120267,-294336,-294336,57845925.399989426,4901.083333546761,-991,0,0,0.4697791804107247,-4571322946,1828.82057345383,675.4428481784727,1153.3777252753575,0.7678082715045186,0.33248139241069613,-991
1068,2019-12-05,2019,219985,219985,407256003.81666636,3479664.300000007,169607,0,48,0.8360797327090479,40312818,5531572742,523760,523760,349657528.15000856,3475119.0999998683,170472,0,51,0.3537555368871177,4626097151,-303775,-303775,57598475.666657805,4545.200000138488,-865,0,-3,0.4823241958219302,-4585784333,1851.289878021985,667.5911259928375,1183.6987520291475,0.7709934768279656,0.3254773178555063,-865
1069,2019-12-06,2019,216222,216222,407460485.9166667,3458025.466666664,166702,0,43,0.8326118526329422,39440245,5535139476,528891,528891,350085057.733341,3453503.766666504,167589,0,43,0.34355661185385933,4636239054,-312669,-312669,57375428.18332571,4521.700000159908,-887,0,0,0.4890552407790829,-4596798809,1884.4543382110362,661.9228871985739,1222.5314510124622,0.7709761263886191,0.3168686931711827,-887
1070,2019-12-07,2019,224851,224851,407729718.40000015,3471640.3166666636,172157,0,67,0.8283040769220509,39851209,5538728900,544563,544563,350560074.3833449,3467908.416666471,173065,0,67,0.3445239577422663,4650461175,-319712,-319712,57169644.01665527,3731.9000001926906,-908,0,0,0.4837801191797846,-4610609966,1813.3329111278142,643.745672003689,1169.587239124125,0.765649252171438,0.31780528607342035,-908
1071,2019-12-08,2019,224561,224561,407706583.06666636,3452435.6500000036,171088,0,38,0.8292357087829143,39809630,5540289204,559974,559974,350857556.43334603,3494499.649999803,174661,0,38,0.33989256644058435,4666918764,-335413,-335413,56849026.63332033,-42063.9999997993,-3573,0,0,0.48934314234232995,-4627109134,1815.5716400740394,626.5604410800252,1189.0111989940142,0.7618776189988467,0.3119091243522021,-3573
1072,2019-12-09,2019,226417,226417,407785086.14999956,3528233.6666666665,172431,0,34,0.8273009535503071,39922206,5542947835,569540,569540,350643887.28333974,3544157.599999849,175452,0,34,0.33539523123924964,4662143160,-343123,-343123,57141198.86665982,-15923.933333182707,-3021,0,0,0.49190572231105745,-4622220954,1801.0356384458744,615.6615642155771,1185.3740742302973,0.7615638401710119,0.3080591354426379,-3021
1073,2019-12-10,2019,229399,229399,408256112.46666634,3549078.5166666703,175028,0,38,0.8296287254957522,40619494,5550108640,570573,570573,350306106.58334583,3545524.8833331373,176265,0,38,0.33654939858703264,4642166533,-341174,-341174,57950005.88332051,3553.633333533071,-1237,0,0,0.49307932690871953,-4601547039,1779.6769491875132,613.9549305406072,1165.722018646906,0.7629850173714794,0.3089262898875341,-1237
1074,2019-12-11,2019,226040,226040,408146926.0333335,3478897.266666659,173206,0,44,0.834246151123695,39856731,5552358059,573904,573904,350095246.5000123,3474494.1333331633,174054,0,46,0.33073649948423184,4637585968,-347864,-347864,58051679.5333212,4403.133333495818,-848,0,-2,0.5035096516394633,-4597729237,1805.6402673568107,610.024057159407,1195.6162101974037,0.766262608387896,0.303280688059327,-848
1075,2019-12-12,2019,223255,223255,407910815.383333,3456555.6999999983,172027,0,37,0.83687263443148,39966863,5552931745,591123,591123,350091748.1333365,3513237.3666665,176367,0,37,0.3244383994532436,4645281167,-367868,-367868,57819067.24999654,-56681.66666650167,-4340,0,0,0.5124342349782364,-4605314304,1827.1071885661374,592.24856439918,1234.8586241669573,0.7705404134285906,0.2983592247298786,-4340
1076,2019-12-13,2019,222450,222450,407799987.4666663,3442016.0666666725,171262,0,49,0.837176893683975,39580863,5554996949,597298,597298,348581820.5833412,3436915.9999998375,172204,0,49,0.3140023907664149,4636550304,-374848,-374848,59218166.8833251,5100.066666834988,-942,0,0,0.5231745029175601,-4596969441,1833.220892185508,583.5978365628902,1249.6230556226178,0.7698898628905372,0.28830500018416266,-942
1077,2019-12-14,2019,221167,221167,407851799.73333335,3443429.7666666727,168975,0,39,0.8299068124991529,39054161,5558714896,595737,595737,348585406.68334556,3439299.183333193,169769,0,39,0.31019057067128364,4632469332,-374570,-374570,59266393.04998779,4130.583333479706,-794,0,0,0.5197162418278692,-4593415171,1844.0897590207098,585.1330481124146,1258.9567109082952,0.7640154272563267,0.2849730669741849,-794
1078,2019-12-15,2019,219545,219545,408121698.40000045,3446627.083333336,168083,0,39,0.8373590835591792,39410290,5561237731,601287,601287,349024091.76667,3442617.1333331903,168890,0,39,0.30767337394621447,4646617145,-381742,-381742,59097606.633330464,4009.9500001454726,-807,0,0,0.5296857096129648,-4607206855,1858.9432617458856,580.4617292019784,1278.4815325439072,0.7655970302215946,0.28088084392311824,-807
1079,2019-12-16,2019,227358,227358,408563208.20000035,3505926.2,174535,0,105,0.8416330192911621,39666348,5569466275,616003,616003,349638740.5500103,3501689.7666665157,175383,0,105,0.31283613878504124,4658958285,-388645,-388645,58924467.64999002,4236.433333484456,-848,0,0,0.5287968805061208,-4619291937,1797.0038802241413,567.592593786086,1229.4112864380554,0.7676659717274079,0.2847112757567739,-848
1080,2019-12-17,2019,226425,226425,408601458.4999998,3503259.4333333354,174691,0,53,0.8425968863862205,40813316,5570641104,618040,618039,349838640.0666816,3498933.616666535,175479,0,53,0.31078570966280084,4665668708,-391615,-391614,58762818.4333182,4325.816666800529,-788,0,0,0.5318111767234197,-4624855392,1804.577491443082,566.0462204920427,1238.5312709510392,0.7715181627470464,0.2839282247103747,-788
1081,2019-12-18,2019,224128,224128,408474906.0166668,3467679.0333333337,173518,0,138,0.8431967447173044,41620729,5574590718,633844,633844,350101307.9666835,3472996.049999587,175597,0,137,0.3021295460712765,4678470411,-409716,-409716,58373598.04998332,-5317.016666253097,-2079,0,1,0.5410671986460279,-4636849682,1822.5072548573442,552.3461734538522,1270.161081403492,0.7741915334094803,0.27703504332296275,-2079
1082,2019-12-19,2019,218787,218787,408823698.3333336,3453790.283333333,169707,0,85,0.8430208376183236,42377524,5581748988,655732,655731,350048697.85002136,3503995.0166665614,181054,0,87,0.2996590070333631,4683745946,-436945,-436944,58775000.48331225,-50204.733333228156,-11347,0,-2,0.5433618305849605,-4641368422,1868.5922762016646,533.8297226301964,1334.7625535714683,0.775672229154383,0.27610975215484374,-11347
1083,2019-12-20,2019,219080,219080,409146293.16666657,3452051.100000002,169093,0,306,0.839492422859231,42566158,5587714872,646785,646785,340077904.20001066,3447542.633333186,169940,0,308,0.2866362083227048,4458075568,-427705,-427705,69068388.96665591,4508.4666668158025,-847,0,-2,0.5528562145365261,-4415509410,1867.5656982228709,525.7974507757766,1341.7682474470944,0.7718322074128172,0.2627457346722636,-847
1084,2019-12-21,2019,219636,219636,409169406.46666664,3463598.433333333,169010,0,327,0.8384827623886795,42686070,5592145063,647671,647671,340364967.1666799,3458725.099999848,170076,0,327,0.2869744052149893,4466769276,-428035,-428035,68804439.29998672,4873.333333485294,-1066,0,0,0.5515083571736902,-4424083206,1862.9432627923775,525.5213946072619,1337.4218681851157,0.7695004461927917,0.26259628731253987,-1066
1085,2019-12-22,2019,217931,217931,409053596.0666672,3394891.849999999,167484,0,237,0.8384763984931014,42629258,5597088376,653878,653878,340535585.43335235,3390525.0499998573,168407,0,237,0.28162134220757223,4483159106,-435947,-435947,68518010.63331485,4366.80000014184,-923,0,0,0.5568550562855292,-4440529848,1876.9867346392537,520.7937649429288,1356.1929696963248,0.7685184760314044,0.25755110280511045,-923
1086,2019-12-23,2019,217277,217277,409597348.3499998,3399756.8666666704,167509,0,87,0.8318597918785705,41972088,5610218758,663257,663257,341294233.6500038,3394574.9833328337,168327,0,87,0.27447580651240433,4501944897,-445980,-445980,68303114.699996,5181.883333836682,-818,0,0,0.5573839853661662,-4459972809,1885.1390085006688,514.5731347728012,1370.5658737278677,0.7709467638084104,0.2537885012898469,-818
1087,2019-12-24,2019,214356,214356,409493147.63333315,3407146.5833333335,165950,0,162,0.8417165836272372,42144874,5614667373,667595,667595,341447123.1166638,3403777.816666309,167369,0,162,0.2731086961406154,4512587186,-453239,-453239,68046024.51666933,3368.766667024698,-1419,0,0,0.5686078874866218,-4470442312,1910.3414302997496,511.4584787433456,1398.882951556404,0.7741794024893168,0.25070439413117235,-1419
1088,2019-12-25,2019,212450,212450,409280567.1333335,3384129.966666666,164191,0,131,0.8453847964226874,41830618,5615405430,672162,672162,341373142.05001235,3379239.5499998126,165236,0,131,0.269506458264522,4525759853,-459712,-459712,67907425.08332115,4890.416666853242,-1045,0,0,0.5758783381581654,-4483929235,1926.4794875657026,507.87331335304935,1418.6061742126533,0.7728453753824429,0.24582764274088686,-1045
1089,2019-12-26,2019,211460,211460,409735990.0833334,3354941.716666666,163992,0,293,0.8496453229925279,42109243,5628396679,677650,677650,342098704.58334386,3350300.533333163,164952,0,293,0.2675894635874026,4545036930,-466190,-466190,67637285.49998951,4641.183333503082,-960,0,0,0.5820558594051253,-4502927687,1937.652464217031,504.83096669865546,1432.8214975183755,0.7755225574576752,0.2434176934995942,-960
1090,2019-12-27,2019,216139,216139,409981065.683334,3388968.999999999,167941,0,287,0.8525162048496574,42727362,5637100685,688347,688347,342602776.5666759,3383691.31666651,168964,0,287,0.27018930858999624,4557693438,-472208,-472208,67378289.11665809,5277.683333489113,-1023,0,0,0.5823268962596612,-4514966076,1896.8398377124627,497.7181226426147,1399.121715069848,0.7770046127723363,0.24546340726406884,-1023
1091,2019-12-28,2019,214563,214563,410180227.8166664,3395149.8666666676,166726,0,453,0.8500114185577208,42608742,5644950178,692381,692381,343151015.63334477,3390075.5999998236,167739,0,453,0.2655849886117545,4568291828,-477818,-477818,67029212.183321655,5074.2666668440215,-1013,0,0,0.5844264299459663,-4525683086,1911.7006558291337,495.61009853439765,1416.090557294736,0.7770491650470958,0.24226401359944885,-1013
1092,2019-12-29,2019,219331,219331,410429072.6333338,3399341.4,167395,0,361,0.8403691224678678,43113106,5652744509,703055,703055,343705568.8833432,3394989.0999998217,168358,0,361,0.2643889880592562,4588055249,-483724,-483724,66723503.74999058,4352.300000178162,-963,0,0,0.5759801344086115,-4544942143,1871.277077263742,488.8743681267372,1382.4027091370049,0.763207207371507,0.23946632909231852,-963
1093,2019-12-30,2019,219617,219617,410836148.33333325,3391745.9833333325,166872,0,424,0.8320485208339973,43083984,5666681198,712299,712299,344342644.15000725,3386619.4999996815,167775,0,424,0.25873404286682294,4606429022,-492682,-492682,66493504.183326006,5126.483333650976,-903,0,0,0.5733144779671744,-4563345038,1870.693745626856,483.4242981528926,1387.2694474739635,0.7598318891524791,0.23554013132125695,-903
1094,2019-12-31,2019,211585,211585,410910838.43333334,3334846.316666662,164088,0,321,0.8437696434057227,42466601,5676346598,727080,727080,344749800.8333343,3370356.749999491,167826,0,322,0.2515624140397199,4623595933,-515495,-515495,66161037.59999901,-35510.433332828805,-3738,0,-1,0.5922072293660028,-4581129332,1942.0603465904169,474.1566276521625,1467.9037189382543,0.775518113287804,0.23082191780821917,-3738
1095,2020-01-01,2020,208093,208093,410452598.5999998,3296424.883333338,159956,0,304,0.8287160067854282,41012553,5679755456,474533,474533,344090174.83334637,3291594.966666535,160822,0,307,0.36631593587801525,4574359359,-266440,-266440,66362423.76665342,4829.91666680295,-866,0,-3,0.462400070907413,-4533346806,1972.4478891649396,725.1132689051053,1247.3346202598343,0.7686755441076826,0.3389058295208131,-866
1096,2020-01-02,2020,213898,213898,411249725.8166664,3386058.7999999984,165128,0,73,0.8353187033071833,42341678,5695336643,478967,478967,345022796.61668396,3381804.9166664667,166006,0,73,0.37598832487415723,4588916598,-265069,-265069,66226929.199982464,4253.883333531674,-878,0,0,0.45933037843302604,-4546574920,1922.644091186764,720.3477413197234,1202.2963498670406,0.7719941280423379,0.3465917276138022,-878
1097,2020-01-03,2020,215627,215627,411978517.2833338,3411316.16666667,166085,0,189,0.8440686926961849,43020675,5707730815,483313,483313,346014799.13334435,3407188.7333331453,167017,0,188,0.37969390436425005,4598029637,-267686,-267686,65963718.149989426,4127.433333524503,-932,0,1,0.46437478833193485,-4555008962,1910.6072861159955,715.9228059939302,1194.6844801220655,0.7702421310874797,0.34556695143726734,-932
1098,2020-01-04,2020,211527,211527,412017171.1333329,3370108.833333335,163089,0,304,0.8475797415932717,41673752,5711960277,488756,488756,346343524.4166765,3365328.166666532,164015,0,304,0.3698900883058266,4611076213,-277229,-277229,65673646.71665639,4780.66666680295,-926,0,0,0.47768965328744506,-4569402461,1947.8230728622489,708.622552800736,1239.2005200615129,0.7710079564310939,0.3355764430513385,-926
1099,2020-01-05,2020,209508,209508,412303927.8,3336189.2666666736,161570,0,261,0.8435525135078376,42499238,5723326295,497462,497462,346963254.5500062,3332342.8166664904,162400,0,261,0.35783838765574194,4629225600,-287954,-287954,65340673.2499938,3846.450000183191,-830,0,0,0.4857141258520956,-4586726362,1967.9626925940777,697.4668508348501,1270.4958417592275,0.7711877350745556,0.3264570962204148,-830
1100,2020-01-06,2020,214961,214961,412889187.09999996,3381719.933333332,165640,0,192,0.8422178906871487,42826713,5736729438,511083,511083,347773650.1000069,3377459.066666461,166480,0,192,0.3570594208768433,4646240440,-296122,-296122,65115536.999993086,4260.866666871123,-840,0,0,0.4851584698103054,-4603413727,1920.7632412391083,680.4641322446782,1240.29910899443,0.7705583803573671,0.3257396548114494,-840
1101,2020-01-07,2020,216478,216478,413338980.1499999,3436054.016666663,167190,0,74,0.8414758081652643,43425233,5746715480,516750,516750,348524006.6333436,3431442.949999801,167965,0,74,0.35495500725689594,4656908193,-300272,-300272,64814973.51665634,4611.066666861996,-775,0,0,0.4865208009083684,-4613482960,1909.3810001478207,674.4538106112116,1234.9271895366091,0.772318665176138,0.32504112239961297,-775
1102,2020-01-08,2020,217762,217762,413713720.3500006,3407415.5000000005,167716,0,54,0.8317107668004519,42824927,5755966673,526667,526667,349086780.66667867,3403222.883333146,168585,0,54,0.3467902868415788,4672203132,-308905,-308905,64626939.68332195,4192.616666854359,-869,0,0,0.48492047995887305,-4629378205,1899.8435004729963,662.8225817578824,1237.020918715114,0.7701802885719271,0.32009789867221605,-869
1103,2020-01-09,2020,217857,217857,413860928.2666661,3405598.5166666633,166874,0,75,0.8315500534754442,42519894,5760474225,534953,534953,349551056.9166833,3401070.633333179,167824,0,74,0.3416281430331204,4688056289,-317096,-317096,64309871.3499828,4527.883333484177,-950,0,1,0.4899219104423238,-4645536395,1899.6907524966657,653.4238651183998,1246.266887378266,0.7659795186750942,0.31371727983579867,-950
1104,2020-01-10,2020,215156,215156,413747529.6166666,3377868.683333331,165202,0,146,0.8342133149900531,42281825,5759698598,540699,540699,349754329.98334336,3373499.633333155,166079,0,146,0.33473337291172506,4700559612,-325543,-325543,63993199.63332325,4369.050000175834,-877,0,0,0.4994799420783281,-4658277787,1923.0118129016464,646.8558846665952,1276.1559282350513,0.7678242763390284,0.30715610718717806,-877
1105,2020-01-11,2020,206627,206627,413286891.41666675,3312167.5333333323,159331,0,144,0.8382689580742102,40958308,5760670173,543562,543561,349617347.11667204,3307293.699999868,160250,0,144,0.3215309385129883,4710974948,-336935,-336934,63669544.29999471,4873.833333464339,-919,0,0,0.5167380195612219,-4670016640,2000.159182568913,643.1979982314258,1356.961184337487,0.7711044539193813,0.29481457497028857,-919
1106,2020-01-12,2020,201046,201046,413340806.15000004,3250716.5499999993,155216,0,122,0.8361171075276307,41179184,5768292084,549066,549066,349902979.5500124,3246196.5999998217,156118,0,122,0.3085257510026062,4726399883,-348020,-348020,63437826.599987626,4519.950000177603,-902,0,0,0.5275913565250245,-4685220699,2055.951404902361,637.2694349131295,1418.6819699892314,0.7720422191936174,0.284333759511607,-902
1107,2020-01-13,2020,207577,207577,413825947.38333285,3312343.066666668,160696,0,153,0.8384262225583765,41375238,5780762788,563419,563419,350610463.31667763,3307645.3166664974,161571,0,153,0.3116206588702207,4745312709,-355842,-355842,63215484.06665522,4697.750000170432,-875,0,0,0.5268055636881558,-4703937471,1993.602120578546,622.2908054514982,1371.3113151270477,0.7741512788025648,0.28676881681306454,-875
1108,2020-01-14,2020,205690,205690,414212474.0333328,3302222.4500000007,159105,0,128,0.8325441197919197,41331944,5788900097,563684,563684,351174077.75000536,3298634.399999827,159782,0,128,0.3059178546845374,4753444277,-357994,-357994,63038396.28332746,3588.0500001735054,-677,0,0,0.5266262651073823,-4712112333,2013.7705966908106,622.9981297145304,1390.7724669762802,0.7735184014779523,0.28346023658645625,-677
1109,2020-01-15,2020,207438,207438,414347742.5833336,3297956.9666666663,160123,0,186,0.8356810227634295,41033866,5797119102,573955,573955,351521381.566674,3294119.133333141,160839,0,185,0.3041754144488696,4769590954,-366517,-366517,62826361.01665962,3837.833333525341,-716,0,1,0.53150560831456,-4728557088,1997.4534202187333,612.4546028289221,1384.9988173898112,0.7719077507496216,0.28022928626808724,-716
1110,2020-01-16,2020,206204,206204,414548314.78333366,3303642.6333333305,160581,0,177,0.8435966324610579,41791388,5806082243,578741,578741,351883043.6333437,3298957.8666664716,161279,0,177,0.3026362396996316,4783544747,-372537,-372537,62665271.14998996,4684.766666858923,-698,0,0,0.5409603927614263,-4741753359,2010.3795987630388,608.0147140661257,1402.3648846969131,0.7787482299082462,0.2786721521371391,-698
1111,2020-01-17,2020,200588,200588,414346163.0166666,3233945.83333333,155991,0,159,0.8399555307396251,42013713,5812662432,583865,583865,351884141.70001173,3229912.5833331924,156860,0,159,0.2910638589399961,4796712731,-383277,-383277,62462021.31665486,4033.2500001378357,-869,0,0,0.548891671799629,-4754699018,2065.6577812065857,602.680656829938,1462.9771243766477,0.7776686541567791,0.26865799457066275,-869
1112,2020-01-18,2020,196389,196389,413404782.133334,3156183.8333333326,152041,0,145,0.8359022144824813,41406750,5808078512,591652,591652,351172774.7500131,3151424.999999804,152809,0,147,0.27951735141603906,4809244371,-395263,-395263,62232007.38332087,4758.833333528601,-768,0,-2,0.5563848630664422,-4767837621,2105.0302314963365,593.5461635387239,1511.4840679576125,0.7741828717494361,0.2582751347075646,-768
1113,2020-01-19,2020,213094,213094,412871476.95,3170849.6166666676,149374,0,138,0.7675579791078122,41402714,5811880858,617194,617194,350848350.200006,3165122.59999976,150289,0,138,0.2673891839518869,4825832551,-404100,-404100,62023126.74999398,5727.016666907817,-915,0,0,0.5001687951559253,-4784429837,1937.5086907655775,568.4571629017878,1369.0515278637897,0.7009770336095807,0.24350366335382392,-915
1114,2020-01-20,2020,213928,213928,412956819.9000001,3169855.366666661,150509,0,196,0.7697870311506674,41107904,5820481837,644212,644212,351120695.8500116,3164763.7666664766,151412,0,196,0.2577784952779492,4841374398,-430284,-430284,61836124.04998851,5091.600000184495,-903,0,0,0.5120085358727182,-4800266494,1930.3542308627207,545.0390490242522,1385.3151818384686,0.7035497924535358,0.23503442965980142,-903
1115,2020-01-21,2020,211364,211364,412648370.5666666,3160376.850000002,149290,0,205,0.772359531424462,41913644,5824003610,665275,665275,351020916.91667116,3156557.74999984,150353,0,205,0.24780729773402407,4849068228,-453911,-453911,61627453.649995446,3819.1000001621433,-1063,0,0,0.5245522336904379,-4807154584,1952.311512682702,527.6328088635094,1424.6787038191926,0.7063170644007494,0.22600127766713013,-1063
1116,2020-01-22,2020,208142,208142,412253778.7499996,3128044.816666666,148204,0,41,0.779722497141375,41008945,5823460390,686856,686856,350864890.4666704,3123563.566666527,149238,0,41,0.23859877470677676,4860935698,-478714,-478714,61388888.28332919,4481.250000138767,-1034,0,0,0.5411237224345982,-4819926753,1980.6371551633,510.8274375803231,1469.8097175829769,0.7120331312277195,0.21727698382193647,-1034
1117,2020-01-23,2020,197171,197171,411452527.11666644,2999982.183333333,139883,0,100,0.7715029086427521,40245530,5822316871,703976,703976,350354528.23334086,2996124.3999998393,140816,0,100,0.2181750514222104,4875748189,-506805,-506805,61097998.88332558,3857.7833334938623,-933,0,0,0.5533278572205417,-4835502659,2086.780140673154,497.6796485012853,1589.1004921718688,0.7094501726927388,0.2000295464618112,-933
1118,2020-01-24,2020,190671,190671,410975958.8500004,2919055.5000000023,133148,0,99,0.754089504958804,39957837,5827855494,727121,727121,350101853.4500056,2914388.433333036,134153,0,99,0.1997810543224576,4891533330,-536450,-536450,60874105.39999479,4667.066666966304,-1005,0,0,0.5543084506363464,-4851575493,2155.419328843927,481.4904994492053,1673.9288293947216,0.6983128005832036,0.1844988660759351,-1005
1119,2020-01-25,2020,186970,186970,410488205.81666744,2902463.0666666683,131246,0,162,0.7617371770872333,40438185,5832250478,751633,751633,349804219.1333319,2897106.3333332352,132338,0,162,0.1913593469153163,4906702607,-564663,-564663,60683986.68333554,5356.733333433047,-1092,0,0,0.570377830171917,-4866264422,2195.476310727215,465.39231131859816,1730.083999408617,0.7019628817457346,0.17606730944490195,-1092
1120,2020-01-26,2020,185886,185886,410716311.7833339,2906298.933333334,130801,0,131,0.76551757528808,40299110,5842357695,772284,772284,350198703.2499966,2901480.2833332545,131894,0,134,0.18635501965598367,4923681945,-586398,-586398,60517608.533337295,4818.650000079535,-1093,0,-3,0.5791625556320963,-4883382835,2209.5064275057503,453.4584469573325,1756.0479805484179,0.7036624597871813,0.17078432286568154,-1093
1121,2020-01-27,2020,190857,190857,411122730.14999974,2934788.1333333314,134994,0,213,0.7651016205850452,40143407,5852572994,799032,799032,350800658.41667265,2930261.1999997073,136064,0,215,0.18469598213838587,4940409076,-608175,-608175,60322071.73332709,4526.933333624154,-1070,0,-2,0.5804056384466593,-4900265669,2154.087773306715,439.0320518035231,1715.055721503192,0.7073044216350461,0.17028604611580012,-1070
1122,2020-01-28,2020,193304,193304,411335320.43333286,2957893.566666667,136068,0,163,0.7577287588461689,40119437,5861451915,820338,820338,351248959.79999757,2953356.883333272,137014,0,162,0.18028300529781496,4945960724,-627034,-627034,60086360.63333529,4536.683333395049,-946,0,1,0.5774457535483539,-4905841287,2127.919341727708,428.17589798351116,1699.7434437441966,0.703906799652361,0.1670213984967172,-946
1123,2020-01-29,2020,194621,194621,411633020.6666665,2977062.150000004,138064,0,50,0.7609250800273355,39476710,5870117633,849353,849353,351814333.86666375,2978915.283333265,141573,0,50,0.17894091149380872,4956462050,-654732,-654732,59818686.800002754,-1853.1333332611248,-3509,0,0,0.5819841685335267,-4916985340,2115.049355756401,414.21450664996036,1700.8348491064405,0.7093992940124653,0.1666833460292717,-3509
1124,2020-01-30,2020,198789,198789,411843210.25,3025487.6833333336,140945,0,53,0.7664709817947661,41123130,5875836277,870596,870596,349813320.36667114,3021406.699999611,142015,0,53,0.17674443714420085,4901515136,-671807,-671807,62029889.883328855,4080.9833337226883,-1070,0,0,0.5897265446505653,-4860392006,2071.7605614495774,401.80901401645673,1669.9515474331206,0.7090181046234952,0.1631238829491521,-1070
1125,2020-01-31,2020,202022,202022,412495009.4000001,3046261.783333338,142457,0,39,0.7663719792893858,41223656,5887436492,892819,892819,350651164.5166638,3040847.8666665666,143630,0,39,0.17542973435825224,4912569550,-690797,-690797,61843844.883336306,5413.916666771285,-1173,0,0,0.5909422449311336,-4871345894,2041.832124224095,392.74608237130235,1649.0860418527927,0.7051558741127204,0.160872472472024,-1173
1126,2020-02-01,2020,199429,199429,412819997.3333337,3029519.883333332,140272,0,38,0.7659217064719771,41557234,5896060634,480697,480697,351087785.4166746,3024400.4999997886,141575,0,39,0.3222861802757225,4871720771,-281268,-281268,61732211.91665906,5119.3833335433155,-1303,0,-1,0.4436355261962546,-4830163537,2070.0098648307603,730.3723248047619,1339.6375400259985,0.7033681159710975,0.29452024872216803,-1303
1127,2020-02-02,2020,198761,198761,412997092.95000035,3025328.6833333354,139921,0,38,0.7667952968640727,41935157,5904426533,505204,505204,351411852.78334284,3020024.1833331594,141075,0,38,0.3049837293449727,4886462056,-306443,-306443,61585240.16665751,5304.50000017602,-1154,0,0,0.46181156751909996,-4844526899,2077.8577937824844,695.5840666014973,1382.273727180987,0.703966069802426,0.2792436322752789,-1154
1128,2020-02-03,2020,202193,202193,413472518.8333332,3052609.266666666,142583,0,37,0.7656496515705292,42140799,5917767012,532087,532087,352158348.7833427,3047975.366666535,143765,0,37,0.2945646106745704,4900903468,-329894,-329894,61314170.049990475,4633.900000131223,-1182,0,0,0.4710850408959588,-4858762669,2044.9398289423134,661.8435496137713,1383.096279328542,0.7051826720015035,0.27019077707217054,-1182
1129,2020-02-04,2020,203690,203690,413926041.33333343,3040058.216666667,141588,0,41,0.7537434336491715,41474410,5926243521,555513,555513,352825168.23334014,3035375.8499998692,142659,0,41,0.2795416128875527,4907551405,-351823,-351823,61100873.09999329,4682.3666667975485,-1071,0,0,0.4742018207616188,-4866076995,2032.137273962067,635.1339540808949,1397.003319881172,0.6951151259266533,0.25680587132974386,-1071
1130,2020-02-05,2020,197606,197606,413946872.2333333,3006437.383333334,139984,0,38,0.7622086373895529,41112661,5933311629,578394,578394,353064297.7833394,3002329.5333331134,141195,0,38,0.26386857401702213,4919921023,-380788,-380788,60882574.44999391,4107.850000220351,-1211,0,0,0.4983400633725308,-4878808362,2094.8092276212933,610.4217847753251,1484.387442845968,0.7083995425240124,0.24411560285895081,-1211
1131,2020-02-06,2020,198283,198283,414264087.0833332,3010517.8666666714,140143,0,60,0.7636509433486487,41211943,5940577245,602922,602922,353648660.6666692,3005442.8333331756,141217,0,60,0.25396817498781527,4934869107,-404639,-404639,60615426.416664004,5075.033333495725,-1074,0,0,0.5096827683608334,-4893657164,2089.2567042224155,586.5578974837031,1502.6988067387124,0.7067827297347731,0.2342210103462803,-1074
1132,2020-02-07,2020,201894,201894,414734937.43333316,3024460.2333333273,140516,0,43,0.7549803362160324,41621406,5950598787,629665,629665,354318889.86667407,3018749.1499998467,141626,0,43,0.24487147927866032,4950775815,-427771,-427771,60416047.56665909,5711.0833334806375,-1110,0,0,0.5101088569373722,-4909154409,2054.2212122863143,562.7101551883526,1491.5110570979618,0.6959889843185038,0.224922776396973,-1110
1133,2020-02-08,2020,195645,195645,414577182.5499997,2932947.6499999957,135233,0,67,0.7463313654834006,40626858,5943141016,652582,652582,354432932.26666737,2928583.933333168,136195,0,67,0.2261631488456698,4962244572,-456937,-456937,60144250.28333235,4363.71666682791,-962,0,0,0.5201682166377308,-4921617714,2119.02774182831,543.1239786979527,1575.9037631303572,0.6912162334841166,0.2087017416968289,-962
1134,2020-02-09,2020,194545,194545,414684497.11666656,2958015.016666664,134960,0,37,0.7497802564959266,40111898,5948557250,713170,713170,354875690.0333346,2981217.883333266,150567,0,37,0.22713798953965836,4972758884,-518625,-518625,59808807.08333194,-23202.86666660197,-15607,0,0,0.5226422669562683,-4932646986,2131.560806582881,497.6032222798696,1633.9575843030113,0.6937212470122593,0.21112357502418777,-15607
1135,2020-02-10,2020,199458,199458,415361323.43333316,3026135.3500000006,141059,0,55,0.7660108895105731,41751839,5963891344,725423,725423,348693570.2166601,3030695.899999637,150572,0,55,0.22453520221994636,4806945423,-525965,-525965,66667753.216673076,-4560.549999636598,-9513,0,0,0.5414756872906267,-4765193584,2082.45005682065,480.67619887522187,1601.773857945428,0.7072115432822951,0.20756441414181795,-9513
1136,2020-02-11,2020,199982,199982,416093386.41666687,3028258.2499999986,140667,0,81,0.7611985078657083,41267247,5977996263,737538,737538,348232168.83332586,3071620.8333329326,144697,0,82,0.21274700422215662,4781563858,-537556,-537556,67861217.583341,-43362.58333293395,-4030,0,-1,0.5484515036435517,-4740296611,2080.6541909605207,472.1548839969274,1608.4993069635934,0.7033983058475263,0.19618921330155192,-4030
1137,2020-02-12,2020,202654,202654,416808058.29999954,3043946.049999998,142453,0,53,0.7611396764929397,41370367,5990904894,760330,760330,348692582.5000021,3047761.2333332403,144540,0,53,0.20633277655754592,4793120020,-557676,-557676,68115475.79999745,-3815.183333242312,-2087,0,0,0.5548068999353938,-4751749653,2056.747255420567,458.60689766285964,1598.1403577577073,0.7029370256693674,0.19010166638170267,-2087
1138,2020-02-13,2020,205639,205639,417405589.1833332,3074936.083333332,144015,0,84,0.758100360340208,42146497,6002431446,780321,780321,349014394.2166632,3070713.433333224,144962,0,83,0.20163240512558114,4801943475,-574682,-574682,68391194.96667004,4222.65000010794,-947,0,1,0.5564679552146269,-4759796978,2029.7977970294216,447.2702826358168,1582.5275143936049,0.7003292177067579,0.18577226551637083,-947
1139,2020-02-14,2020,205692,205692,418077036.38333344,3084761.583333334,145493,0,80,0.7674630029364296,42291888,6016132584,799992,799992,349941457.24999726,3080531.5833332343,146473,0,80,0.19914199141991284,4816461547,-594300,-594300,68135579.13333619,4230.0000000996515,-980,0,0,0.5683210115165167,-4774169659,2032.539118601275,437.43119587445534,1595.1079227268197,0.7073342667677888,0.1830930809308093,-980
1140,2020-02-15,2020,199251,199251,418095656.88333297,2998996.8333333354,140911,0,126,0.772794113956767,41115528,6021386876,819808,819808,350295380.54999673,2994735.499999956,141796,0,127,0.18947485264842004,4832378194,-620557,-620557,67800276.33333623,4261.333333379123,-885,0,-1,0.583319261308347,-4791262666,2098.3365548144448,427.28953675738313,1671.0470180570617,0.7072034770214453,0.1729624497443304,-885
1141,2020-02-16,2020,193153,193153,418161416.9666664,2958021.5166666643,136123,0,38,0.7655589092584635,40308154,6027439488,842121,842121,350629922.5666713,2953718.7166662985,136849,0,38,0.17700900464422284,4852775084,-648968,-648968,67531494.39999509,4302.8000003658235,-726,0,0,0.5885499046142406,-4812466930,2164.923231669539,416.3652522222713,1748.5579794472676,0.70474183678224,0.16250515068499657,-726
1142,2020-02-17,2020,201125,201125,418753115.183333,3032031.8166666655,142935,0,43,0.7694319453076448,41079132,6039243290,872447,872447,351451095.0666707,3027696.96666635,143640,0,43,0.17877418341745688,4871718090,-671322,-671322,67302020.11666226,4334.850000315346,-705,0,0,0.5906577618901879,-4830638958,2082.0540220426747,402.8337481436359,1679.2202738990388,0.7106774394033561,0.16464037356997044,-705
1143,2020-02-18,2020,212175,212175,419295558.20000046,3111365.716666668,149048,0,75,0.762398963120066,41429939,6045478314,900926,900926,352266343.0666597,3107219.4666665853,149964,0,75,0.18130567882378965,4879596740,-688751,-688751,67029215.133340776,4146.250000082888,-916,0,0,0.5810932842962764,-4838166801,1976.1779578178412,391.00474741172934,1585.1732104061118,0.7024767291151173,0.1664554025524849,-916
1144,2020-02-19,2020,216230,216230,419736356.66666627,3167568.566666663,152912,0,111,0.7699070434259815,42371019,6052835464,925583,925583,353046309.4666612,3162619.9333332856,153882,0,111,0.1815860922251171,4893947574,-709353,-709353,66690047.200005054,4948.63333337754,-970,0,0,0.5883209512008644,-4851576555,1941.1569008309036,381.43128111326723,1559.7256197176364,0.7071729177264949,0.16625413388102417,-970
1145,2020-02-20,2020,214823,214823,420013769.9666662,3173893.3499999996,151399,0,132,0.7680090120704027,42548264,6058483637,947043,947043,353632421.84999657,3169521.299999955,152336,0,132,0.17576921005698848,4906584508,-732220,-732220,66381348.116669655,4372.050000044517,-937,0,0,0.5922398020134143,-4864036244,1955.1620169472833,373.406932789743,1581.7550841575403,0.704761594428902,0.1608543645853462,-937
1146,2020-02-21,2020,221871,221871,420801003.8833333,3221342.7333333325,155234,0,179,0.771610530443365,43471033,6072995008,976470,976470,354663686.08332753,3216679.8833332583,156323,0,181,0.1770438415926735,4922177307,-754599,-754599,66137317.80000579,4662.850000074133,-1089,0,-2,0.5945666888506915,-4878706274,1896.60209708945,363.2100178022136,1533.3920792872364,0.699658810750391,0.1600899157168167,-1089
1147,2020-02-22,2020,216090,216090,421081622.9333333,3171622.31666667,151243,0,167,0.7697348327085939,43945744,6085163939,997304,997304,355121146.783331,3167015.9833332086,152333,0,167,0.16851531729542957,4939218120,-781214,-781214,65960476.1500023,4606.333333461545,-1090,0,0,0.6012195154131643,-4895272376,1948.640024681074,356.08114154092533,1592.5588831401487,0.6999074459715859,0.1527447999807481,-1090
1148,2020-02-23,2020,218389,218389,421757853.3333337,3207678.0166666694,153346,0,163,0.7751764054050342,44448586,6099783818,1026053,1026053,355959401.1333295,3202746.9666665564,154425,0,163,0.16672822943844157,4958943987,-807664,-807664,65798452.20000416,4931.050000112969,-1079,0,0,0.6084481759665926,-4914495401,1931.2229706319167,346.9210665855755,1584.3019040463412,0.70216906529175,0.1505039213373968,-1079
1149,2020-02-24,2020,226575,226575,422804373.583333,3294092.3999999985,160717,0,103,0.7761712457243731,43934646,6115810367,1053601,1053601,357233143.91666335,3289192.1999999015,161832,0,103,0.1686739097628028,4978839824,-827026,-827026,65571229.66666967,4900.200000097044,-1115,0,0,0.6074973359615703,-4934905178,1866.0680727500078,339.05923012284853,1527.0088426271593,0.7093324506234139,0.15359894305339497,-1115
1150,2020-02-25,2020,226624,226624,423568316.11666703,3312090.9333333294,161068,0,64,0.7766873764473309,43645414,6129940446,1080475,1080475,358215529.70000374,3333849.9833332542,165234,0,63,0.16761887132973902,4991270314,-853851,-853851,65352786.41666329,-21759.049999924842,-4166,0,1,0.6090685051175919,-4947624900,1869.0355660330197,331.5352319118941,1537.5003341211257,0.7107279017226772,0.15292718480298018,-4166
1151,2020-02-26,2020,204530,204530,423568331.13333297,3233591.3166666673,157185,0,227,0.8301520559331138,42123153,6134785548,1083888,1083888,358125518.3333313,3229259.2666665274,158231,0,227,0.1580993608195698,5001569469,-879358,-879358,65442812.80000168,4332.050000139978,-1046,0,0,0.672052695113544,-4959446316,2070.934978405774,330.40823252340766,1740.5267458823664,0.7685180658094167,0.14598464047945914,-1046
1152,2020-02-27,2020,205281,205281,423404419.6166666,3240539.9666666654,158077,0,345,0.8366775298249717,43093599,6139913558,1087992,1087990,358090109.9999992,3236317.3833332337,158941,0,349,0.15910594930845046,5012368541,-882711,-882709,65314309.61666739,4222.583333431743,-864,0,-4,0.6775715805165212,-4969274942,2062.5601961051757,329.12996442981944,1733.4302316753563,0.7700517826783775,0.14608655210700078,-864
1153,2020-02-28,2020,208899,208899,424057679.6500002,3307668.199999999,163376,0,43,0.8511577365138178,43298259,6149971320,1097055,1097055,358913060.24999785,3302743.3833332323,164339,0,43,0.1635296316046144,5025550312,-888156,-888156,65144619.40000236,4924.8166667665355,-963,0,0,0.6876281049092033,-4982252053,2029.9651010775553,327.1604981062917,1702.8046029712636,0.7820812928735896,0.14980014675654366,-963
1154,2020-02-29,2020,205971,205971,423657916.133334,3291654.866666665,160971,0,49,0.8566982730578566,43252199,6151186720,1102039,1102039,358888256.3333301,3286821.1166665507,161987,0,49,0.16152695140552864,5038798038,-896068,-896068,64769659.800003886,4833.750000114087,-1016,0,0,0.695171321652328,-4995545839,2056.8813868619077,325.6583989616793,1731.2229879002284,0.7815226415369154,0.1469884459624387,-1016
1155,2020-03-01,2020,205649,205649,424093898.41666615,3277032.6166666625,160357,0,199,0.8543148763183873,42672311,6161119724,452044,452043,359620641.1166776,3272170.249999837,161496,0,199,0.3928843209953014,5015640726,-246395,-246394,64473257.29998857,4862.366666825488,-1139,0,0,0.4614305553230859,-4972968415,2062.2220308227425,795.5452050284543,1266.676825794288,0.7797606601539516,0.3572572581430126,-1139
1156,2020-03-02,2020,207812,207812,424742261.5166668,3296776.166666674,161550,0,283,0.8482570785132725,42953786,6174013229,466988,466988,360428094.4833455,3291821.133333197,162736,0,283,0.3816222258387752,5029360183,-259176,-259176,64314167.03332132,4955.0333334770985,-1186,0,0,0.4666348526744973,-4986406397,2043.8774542214446,771.8144673596441,1272.0629868618005,0.7773853290474082,0.3484800465964864,-1186
1157,2020-03-03,2020,208502,208502,424971562.8999995,3299660.9833333376,162338,0,248,0.8484427007894411,43107949,6176299864,475048,475048,360979423.23334014,3294680.6166665293,163365,0,248,0.3758883312844151,5044498273,-266546,-266546,63992139.666659355,4980.366666808259,-1027,0,0,0.47255436950502594,-5001390324,2038.2133643801953,759.8798926284084,1278.3334717517869,0.7785920518748022,0.3438915646418888,-1027
1158,2020-03-04,2020,204781,204781,424968850.8500001,3286717.383333331,159841,0,271,0.8483794883314368,43062110,6179786010,483862,483862,361359699.61667395,3281913.3999998644,160947,0,271,0.36277492342857803,5057951693,-279081,-279081,63609151.23332614,4803.983333466575,-1106,0,0,0.4856045649028588,-5014889583,2075.2357437945907,746.8238870104988,1328.411856784092,0.7805460467523843,0.33262996474201323,-1106
1159,2020-03-05,2020,213042,213042,425440104.91666675,3308019.116666666,164616,0,191,0.8370133588682044,43069705,6190048701,501967,501967,362059050.1000113,3303150.849999889,165821,0,191,0.3591869585052499,5076316111,-288925,-288925,63381054.81665546,4868.266666777432,-1205,0,0,0.4778264003629545,-5033246406,1996.9776143514741,721.2805823889046,1275.6970319625696,0.772692708480018,0.330342432869093,-1205
1160,2020-03-06,2020,219629,219629,425457837.38333404,3384937.0333333355,169311,0,172,0.8398162355608784,43917689,6193137799,517865,517865,362367214.5166856,3379930.8999998495,170445,0,172,0.3597443349135445,5088927120,-298236,-298236,63090622.866648436,5006.133333486039,-1134,0,0,0.48007190064733385,-5045009431,1937.1660271791704,699.7329700147444,1237.433057164426,0.7708954646244348,0.3291301787145299,-1134
1161,2020-03-07,2020,214999,214999,425550219.78333354,3386994.8166666636,165378,0,93,0.8396829752696531,43696572,6200204574,523677,523677,362696771.1166756,3382478.333333197,166705,0,96,0.34883716489362865,5104920225,-308678,-308678,62853448.666657925,4516.483333466575,-1327,0,-3,0.4908458103760244,-5061223653,1979.3125539343603,692.5963353683198,1286.7162185660404,0.7692035776910591,0.31833553889133953,-1327
1162,2020-03-08,2020,211294,211294,425678040.1499995,3359789.2666666694,164188,0,47,0.8472128882031672,43755203,6206199457,533805,533805,363082986.9833416,3354976.9499998596,165345,0,47,0.3389739698953735,5123825366,-322511,-322511,62595053.166657925,4812.316666809842,-1157,0,0,0.5082389183077938,-5080070163,2014.624362972917,680.1790672311829,1334.445295741734,0.7770594527057086,0.3097479416640908,-1157
1163,2020-03-09,2020,214515,214515,426756382.95000064,3385891.5333333304,167850,0,77,0.8505465818241148,43520237,6226129901,545114,545114,364278382.88334596,3381135.3666665107,169065,0,77,0.338496167774074,5139163871,-330599,-330599,62478000.06665468,4756.166666819714,-1215,0,0,0.5120504140500408,-5095643634,1989.4011278931573,668.2609195202214,1321.1402083729358,0.7824627648416195,0.31014613457001655,-1215
1164,2020-03-10,2020,213269,213269,426995182.36666685,3380365.816666667,167418,0,238,0.8542357304624668,43218012,6232134297,567662,567662,364746552.4500048,3400914.7166665234,174638,0,239,0.33518361278366726,5149401728,-354393,-354393,62248629.91666204,-20548.899999856483,-7220,0,-1,0.5190521176787996,-5106183716,2002.1436887999046,642.5417809365517,1359.6019078633528,0.7850086041571912,0.30764433765163074,-7220
1165,2020-03-11,2020,220883,220883,427635722.08333284,3432303.433333332,172078,0,238,0.8474758129869662,43926417,6243004996,573982,573982,360549862.8333477,3428534.3499998776,174868,0,238,0.33209926443686166,5040582239,-353099,-353099,67085859.24998516,3769.0833334545605,-2790,0,0,0.5153765485501045,-4996655822,1936.0282234637018,628.1553477867733,1307.8728756769285,0.7790459202383162,0.30465763734751267,-2790
1166,2020-03-12,2020,221885,221885,428031356.8833337,3466092.116666665,172008,0,164,0.8452802127228068,44161124,6251927783,578749,578749,360787828.0000134,3463409.9999997793,173264,0,164,0.32748393517742413,5036578746,-356864,-356864,67243528.88332027,2682.1166668855585,-1256,0,0,0.5177962775453827,-4992417622,1929.068467374242,623.3925726005806,1305.6758947736612,0.7752123847939247,0.2993767591823053,-1256
1167,2020-03-13,2020,221509,221509,428196419.2666667,3433739.8166666664,171177,0,150,0.8418077820765741,43286834,6256371757,587754,587754,361252941.4500138,3429750.1166664935,172243,0,152,0.32054396907549765,5055727235,-366245,-366245,66943477.816652894,3989.7000001729466,-1066,0,-2,0.5212638130010765,-5012440401,1933.0881330630662,614.6328930981564,1318.4552399649097,0.7727767269050017,0.29305287586303114,-1066
1168,2020-03-14,2020,214980,214980,428133154.4499995,3400874.3166666664,168642,0,236,0.8574658107730954,42925434,6259798194,597001,597001,361506488.76667935,3397652.0666665225,169997,0,236,0.31225575836556396,5074788136,-382021,-382021,66626665.683320165,3222.2500001438893,-1355,0,0,0.5452100524075314,-5031862702,1991.5022534654363,605.5374928462086,1385.9647606192277,0.7844543678481719,0.2847516168314626,-1355
1169,2020-03-15,2020,215667,215667,428382652.3833335,3404546.1333333347,166867,0,64,0.8468425860238246,43084204,6269208483,606589,606589,361771138.01667476,3400315.566666479,168275,0,64,0.30512587600500335,5086207859,-390922,-390922,66611514.36665875,4230.566666855477,-1408,0,0,0.5417167100188212,-5043123655,1986.3152563133604,596.402404291332,1389.9128520220283,0.7737252338095304,0.27741188844505915,-1408
1170,2020-03-16,2020,225420,225420,429060705.2833335,3478068.483333334,171716,0,94,0.8307204329695671,43322469,6280878400,624467,624467,362629444.30001247,3472658.5166664473,173036,0,94,0.3033995391269696,5106626777,-399047,-399047,66431260.98332101,5409.966666886583,-1320,0,0,0.5273208938425975,-5063304308,1903.3834854198096,580.7023338303104,1322.6811515894992,0.7617602697187472,0.27709390568276626,-1320
1171,2020-03-17,2020,229346,229346,429475411.38333356,3551813.399999998,174766,0,202,0.8392559713271653,44038072,6284935773,634187,634187,363312514.61667156,3547580.2666661856,176264,0,202,0.30733048769526744,5117514960,-404841,-404841,66162896.766662,4233.133333812468,-1498,0,0,0.5319254836318978,-5073476888,1872.6091206445003,572.8791580664246,1299.7299625780756,0.7620189582552126,0.2779369491963727,-1498
1172,2020-03-18,2020,227723,227723,430183877.9833337,3527533.0500000017,172033,0,186,0.8277863896049138,43994151,6297835839,642883,642883,364179620.6500095,3522385.0333331465,173364,0,186,0.29695294478154893,5132249220,-415160,-415160,66004257.333324194,5148.016666855197,-1331,0,0,0.5308334448233649,-5088255069,1889.0664446864555,566.4788470841654,1322.58759760229,0.7554485054210598,0.2696664867479775,-1331
1173,2020-03-19,2020,221284,221284,429988251.1499999,3456913.449999998,170064,0,191,0.840110446304297,42908648,6298559045,651223,651223,364256380.01668096,3451674.0833331794,171167,0,191,0.28808411250830745,5144244851,-429939,-429939,65731871.13331896,5239.366666818503,-1103,0,0,0.5520263337959895,-5101336203,1943.1511141790636,559.3420072950141,1383.8091068840495,0.7685327452504473,0.2628393038943649,-1103
1174,2020-03-20,2020,225462,225462,430281513.43333334,3496923.2166666645,171902,0,207,0.8347082878711266,43165633,6305315140,664985,664985,364753951.9500096,3491819.399999855,173116,0,207,0.2861147243922825,5158770202,-439523,-439523,65527561.48332375,5103.816666809376,-1214,0,0,0.5485935634788441,-5115604569,1908.443611044581,548.5145558922526,1359.9290551523286,0.7624433385670313,0.2603306841507703,-1214
1175,2020-03-21,2020,222560,222560,430344972.5999996,3478404.499999998,169580,0,143,0.8320767433501078,42582943,6307417269,670345,670345,365123984.60000527,3473299.183333167,170690,0,146,0.2788250826067166,5170822120,-447785,-447785,65220987.99999434,5105.316666831262,-1110,0,-3,0.5532516607433913,-5128239177,1933.6132845075467,544.6807011315148,1388.932583376032,0.7619518332135155,0.2546300785416465,-1110
1176,2020-03-22,2020,221351,221351,430431938.26666653,3458259.4833333394,167023,0,239,0.8276673699237854,43292360,6312113257,686157,686157,365418856.05000776,3461507.099999861,170232,0,239,0.2732013227293394,5191935768,-464806,-464806,65013082.21665877,-3247.6166665214114,-3209,0,0,0.554466047194446,-5148643408,1944.56739868655,532.5586652180299,1412.00873346852,0.75456175937764,0.24809482377939743,-3209
1177,2020-03-23,2020,226199,226199,430996729.8500001,3486567.8666666667,169193,0,242,0.8187038846325595,43563061,6325873136,699183,699183,364130834.61668164,3483378.0999998357,171327,0,244,0.268909570169764,5159027267,-472984,-472984,66865895.23331845,3189.766666830983,-2134,0,-2,0.5497943144627955,-5115464206,1905.3874236844551,520.7947484659691,1384.592675218486,0.7479829707469972,0.24503885248926247,-2134
1178,2020-03-24,2020,228913,228913,431498702.9999997,3513545.899999995,170064,0,207,0.8155500124501451,43525040,6334996268,708999,708999,364272420.5500118,3508014.8166664606,171276,0,207,0.2662274558920394,5150437954,-480086,-480086,67226282.44998789,5531.083333534189,-1212,0,0,0.5493225565581057,-5106912914,1884.9899437777658,513.7841104853629,1371.205833292403,0.742919799225033,0.24157438868037895,-1212
1179,2020-03-25,2020,226038,226038,431593073.19999975,3501574.349999995,171003,0,216,0.8276572965607545,43288015,6340405254,714896,714896,364634556.4333408,3496409.249999579,172119,0,216,0.26406078646405634,5166043780,-488858,-488858,66958516.76665896,5165.100000415929,-1116,0,0,0.5635965100966982,-5122755765,1909.3828170484599,510.05259007371814,1399.3302269747417,0.7565232394553129,0.24076089389225847,-1116
1180,2020-03-26,2020,221587,221587,431940504.08333343,3456197.233333334,168884,0,138,0.8329414631724789,43786851,6349583638,722395,722395,365224771.93333,3450458.766666628,169794,0,137,0.2572581482429986,5180819665,-500808,-500808,66715732.15000343,5738.466666705906,-910,0,1,0.5756833149294802,-5137032814,1949.304354873406,505.5748889919365,1443.7294658814694,0.7621566247117385,0.23504315506059703,-910
1181,2020-03-27,2020,218560,218560,431994912.1500001,3414813.1500000027,166768,0,174,0.8359672401171301,43680280,6355835103,732853,732853,365492547.6500131,3409069.8999995594,168059,0,174,0.2518636070262386,5195406523,-514293,-514293,66502364.499987006,5743.25000044331,-1291,0,0,0.5841036330908915,-5151726243,1976.5506595442903,498.7255938776441,1477.8250656666462,0.7630307467057101,0.2293215692642317,-1291
1182,2020-03-28,2020,215719,215719,431831280.1333332,3408104.7000000007,164813,0,150,0.8378214250946824,43361241,6359156725,742525,742525,365653136.1666771,3403411.1999996547,166007,0,151,0.24583010673040742,5211484024,-526806,-526806,66178143.96665609,4693.500000345986,-1194,0,-1,0.591991318364275,-5168122783,2001.8231130931129,492.44555559297953,1509.3775575001332,0.7640170777724725,0.223570923537928,-1194
1183,2020-03-29,2020,219109,219109,432019413.8833331,3425101.883333335,167246,0,148,0.8389659940942644,43261423,6365682673,754082,754082,366062052.1499962,3419772.7666666266,168561,0,151,0.24624642943340422,5224832039,-534973,-534973,65957361.733336866,5329.116666708607,-1315,0,-3,0.5927195646608602,-5181570616,1971.7100341991113,485.44064458506665,1486.2693896140447,0.7633004577630312,0.22353139313761633,-1315
1184,2020-03-30,2020,225336,225336,432833732.21666694,3503881.733333337,170428,0,133,0.8309724145276385,43723718,6377277623,766350,766350,367039240.149995,3499823.099999919,171809,0,133,0.24688458276244532,5243207116,-541014,-541014,65794492.06667191,4058.6333334180526,-1381,0,0,0.5840878317651932,-5199483398,1920.8370265588585,478.9446599464932,1441.8923666123653,0.7563283274754145,0.22419129640503685,-1381
1185,2020-03-31,2020,229010,229010,433412781.9666666,3488810.6499999943,170981,0,221,0.8220427055587086,43566516,6386282693,776419,776419,367861545.3166616,3484543.7833333053,172179,0,221,0.2446913329014352,5253090356,-547409,-547409,65551236.65000498,4266.866666689049,-1198,0,0,0.5773513726572734,-5209523840,1892.549591575331,473.7925595801514,1418.7570319951797,0.7466093183703768,0.2217604154457838,-1198
1186,2020-04-01,2020,219005,219005,433378673.6000001,3434562.58333333,167997,0,248,0.8432775507408499,43292066,6391199123,499596,499596,368116615.5166832,3429992.2666664557,169473,0,248,0.3737059544111658,5200883192,-280591,-280591,65262058.08331686,4570.316666874569,-1476,0,0,0.4695715963296841,-5157591126,1978.8528736786834,736.828588532901,1242.0242851457824,0.7670920755233899,0.3392200898325847,-1476
1187,2020-04-02,2020,219417,219417,433831710.7000003,3463224.3333333335,167171,0,260,0.8365851324190926,43524212,6398926932,508818,508818,368765483.8833487,3459057.683333155,168697,0,260,0.3650892853633327,5215459580,-289401,-289401,65066226.81665158,4166.650000178721,-1526,0,0,0.4714958470557599,-5171935368,1977.201906415639,724.7492893005922,1252.452617115047,0.7618871828527416,0.3315468399309773,-1526
1188,2020-04-03,2020,218380,218380,434391945.5166669,3418525.4500000016,166787,0,57,0.8341285832035908,43832256,6411388578,517031,517031,369460721.466681,3412783.833333164,168235,0,57,0.3561604623320418,5232090735,-298651,-298651,64931224.049985886,5741.616666837595,-1448,0,0,0.47796812087154905,-5188258479,1989.1562666758261,714.5813722323826,1274.5748944434436,0.7637466800989101,0.3253866789418816,-1448
1189,2020-04-04,2020,207439,207439,434312389.85000014,3345209.099999994,161456,0,59,0.8470441913044321,42752179,6415211948,522306,522306,369629265.7666805,3340466.883333177,162697,0,59,0.3395231913858967,5245542363,-314867,-314867,64683124.083319664,4742.216666817199,-1241,0,0,0.5075209999185354,-5202790184,2093.6872519150215,707.6871905868983,1386.0000613281231,0.7783300150887731,0.3114974746604481,-1241
1190,2020-04-05,2020,213607,213607,434657674.83333284,3431138.2666666633,164361,0,59,0.8404125332971305,44024288,6423381408,536267,536267,370143473.68334115,3425022.849999818,165545,0,59,0.33767134654938674,5266434737,-322660,-322660,64514201.14999169,6115.416666845325,-1184,0,0,0.5027411867477438,-5222410449,2034.847522943222,690.2223587939238,1344.6251641492981,0.769455120852781,0.3086988384517414,-1184
1191,2020-04-06,2020,223763,223763,435800868.96666694,3516291.716666666,170299,0,62,0.8297037490559215,44100897,6439411633,554820,554820,371458420.78334737,3523005.433333156,173125,0,62,0.34072672218016714,5283490697,-331057,-331057,64342448.18331957,-6713.716666490305,-2826,0,0,0.48897702687575434,-5239389800,1947.6002241955414,669.5115907561865,1278.088633439355,0.7610686306493925,0.3120381384953679,-2826
1192,2020-04-07,2020,228798,228798,436174503.18333334,3526978.283333332,169563,0,49,0.7983985874002393,43931081,6449351569,566706,566706,371558512.9666778,3521845.0666665277,170654,0,49,0.3250362621888632,5283372871,-337908,-337908,64615990.21665555,5133.216666804161,-1091,0,0,0.47336232521137606,-5239441790,1906.3737584390306,655.6459839258413,1250.7277745131892,0.7411035061495292,0.3011332154591623,-1091
1193,2020-04-08,2020,224758,224758,436175760.19999945,3532157.3166666664,168064,0,73,0.8033262442271234,44147730,6460662985,569372,569372,371697601.9333433,3527524.199999819,169261,0,73,0.320214200909068,5303344488,-344614,-344614,64478158.26665616,4633.116666847374,-1197,0,0,0.4831120433180554,-5259196758,1940.6462070315604,652.8203036562095,1287.825903375351,0.7477553635465701,0.29727664865852205,-1197
1194,2020-04-09,2020,221781,221781,436460097.9166667,3484012.516666668,166298,0,77,0.8048931152803892,43245681,6468450681,579791,579791,372207035.31668127,3479343.033333103,167469,0,77,0.3105343132266585,5315614671,-358010,-358010,64253062.59998542,4669.483333564829,-1171,0,0,0.49435880205373073,-5272368990,1967.9778606673551,641.9675974906152,1326.01026317674,0.7498297870421722,0.28884373851956996,-1171
1195,2020-04-10,2020,222712,222712,437119519.35000056,3475678.433333334,166942,0,74,0.8098306332842414,44360298,6483392148,593418,593418,372965606.6666759,3471724.3666664776,168037,0,75,0.30647705327441355,5335822614,-370706,-370706,64153912.683324635,3954.066666856408,-1095,0,-1,0.5033535800098279,-5291462316,1962.7120197834,628.504033694084,1334.207986089316,0.7495869104493695,0.2831680198443593,-1095
1196,2020-04-11,2020,223734,223734,437463503.8666657,3480141.7,168003,0,96,0.8116245184013151,44208137,6492637301,605394,605394,373437884.80001223,3476042.633333113,169175,0,95,0.302531904842142,5352143314,-381660,-381660,64025619.06665349,4099.066666887142,-1172,0,1,0.5090926135591731,-5307935177,1955.2839705483552,616.8509843176712,1338.432986230684,0.7509050926546703,0.2794461127794461,-1172
1197,2020-04-12,2020,217484,217484,437823916.3999999,3419996.5500000017,161789,0,149,0.803774070736238,44412342,6506711398,615166,615166,373903763.36667675,3415450.983333172,162855,0,149,0.28649015062600847,5371103419,-397682,-397682,63920153.03332317,4545.566666829865,-1066,0,0,0.5172839201102295,-5326691077,2013.1316161188865,607.8095398098671,1405.3220763090194,0.7439121958396939,0.26473342154800494,-1066
1198,2020-04-13,2020,230219,230219,438843572.2833329,3552620.3666666686,170813,0,227,0.8060889848361779,44858922,6523392152,636534,636534,375075070.1333438,3548181.766666511,171856,0,227,0.2939827251961533,5393673400,-406315,-406315,63768502.14998907,4438.600000157487,-1043,0,0,0.5121062596400245,-5348814478,1906.2004972801242,589.2459320842937,1316.9545651958306,0.7419587436310643,0.2699871491546406,-1043
1199,2020-04-14,2020,234460,234460,439623527.4499996,3634744.800000001,174065,0,148,0.8011771730785641,45078918,6534345522,647849,647848,376024117.2166778,3631532.849999795,175621,0,148,0.29318714700492615,5405345881,-413389,-413388,63599410.233321786,3211.9500002060086,-1556,0,0,0.5079900260736379,-5360266963,1875.0470333958865,580.420279474009,1294.6267539218775,0.7424080866672353,0.27108323081458796,-1556
1200,2020-04-15,2020,238544,238544,440608315.94999975,3661743.216666666,175251,0,96,0.795027332483734,45301960,6548156751,656895,656895,377095137.6000018,3657311.549999529,176191,0,96,0.29073748468173133,5417169210,-418351,-418351,63513178.34999794,4431.666667136829,-940,0,0,0.5042898478020027,-5371867250,1847.0735627389486,574.056946087277,1273.0166166516715,0.7346694949359447,0.26821790392680717,-940
1201,2020-04-16,2020,236171,236171,440676525.5666665,3608583.350000005,173198,0,190,0.7942253706001166,44263955,6554949170,668291,668291,377443089.0500176,3607862.4833331117,174857,0,190,0.2838075030188939,5430935177,-432120,-432120,63233436.51664889,720.8666668934748,-1659,0,0,0.5104178675812227,-5386671222,1865.9214110397402,564.7885263306218,1301.1328847091183,0.733358456372713,0.26164799466100847,-1659
1202,2020-04-17,2020,232406,232406,441252812.4833336,3558940.5666666618,173426,0,199,0.8027976902489614,44269306,6567089794,687224,687224,378227570.7166855,3563722.7833331516,177068,0,199,0.27726912913401985,5448448212,-454818,-454818,63025241.766648114,-4782.21666648984,-3642,0,0,0.5255285611149416,-5404178906,1898.6291768858532,550.3701423650592,1348.259034520794,0.7462199771090248,0.2576568920759461,-3642
1203,2020-04-18,2020,226049,226049,441230340.0166665,3555227.9166666646,169587,0,225,0.8113152458095365,45047939,6568684191,691226,691226,377022503.4666773,3552316.7333331886,170536,0,227,0.26710656138513866,5414955677,-465177,-465177,64207836.549989164,2911.183333476074,-949,0,-2,0.5442086844243978,-5369907738,1951.9234326038447,545.4402806993332,1406.4831519045115,0.7502222969356201,0.24671525665990574,-949
1204,2020-04-19,2020,224848,224848,441712968.61666673,3530269.650000005,168850,0,205,0.8134295168291468,44869385,6581023062,692935,692935,377674628.11667544,3527239.366666463,169860,0,205,0.26574931270609203,5434935693,-468087,-468087,64038340.4999913,3030.2833335418254,-1010,0,0,0.5476802041230547,-5390066308,1964.4958755099744,545.0361550746829,1419.4597204352915,0.7509517540738633,0.24513121721373576,-1010
1205,2020-04-20,2020,224347,224347,442202660.29999965,3499759.5666666683,168230,0,183,0.8085510392383236,44388648,6592839149,705613,705613,378329976.0000142,3494258.0166664748,169242,0,183,0.25895639677840776,5453347789,-481266,-481266,63872684.29998547,5501.550000193529,-1012,0,0,0.5495946424599158,-5408959141,1971.0656273540526,536.172060322038,1434.8935670320147,0.7498651642321938,0.2398510231529181,-1012
1206,2020-04-21,2020,218004,218004,442182528.11666656,3452548.7500000033,165734,0,185,0.8181547127575639,44605012,6598600294,709517,709517,378594044.2000133,3450943.1999998237,166774,0,185,0.25343437859840057,5460539895,-491513,-491513,63588483.916653275,1605.550000179559,-1040,0,0,0.5647203341591633,-5415934883,2028.3230037828048,533.5940424260634,1494.7289613567414,0.7602337571787674,0.2350528599032863,-1040
1207,2020-04-22,2020,222062,222062,442636207.73333377,3484831.899999997,168386,0,73,0.8151552269186081,44402583,6609333597,723169,723169,379267956.249995,3482200.116666586,169392,0,73,0.2521139595309008,5476369597,-501107,-501107,63368251.48333877,2631.7833334109746,-1006,0,0,0.5630412673877072,-5431967014,1993.3001041751122,524.4527299289585,1468.8473742461538,0.7582837225639686,0.23423570424064086,-1006
1208,2020-04-23,2020,222214,222214,442629289.0833333,3528019.8833333324,169373,0,76,0.8171402341886634,44488699,6612702688,730532,730532,379526807.6500106,3526597.233332961,170406,0,77,0.2505051113435138,5488753080,-508318,-508318,63102481.43332273,1422.6500003715046,-1033,0,-1,0.5666351228451496,-5444264381,1991.905501378551,519.5211265899517,1472.3843747885994,0.762206701647961,0.23326288239255774,-1033
1209,2020-04-24,2020,229340,229340,443157013.7833336,3545092.316666666,172018,0,59,0.8043690590389815,45052979,6621587059,745169,745169,380270138.74999696,3542788.9666665588,173140,0,60,0.24950850075620298,5499796477,-515829,-515829,62886875.03333664,2303.3500001071952,-1122,0,-1,0.5548605582827785,-5454743498,1932.3145277026842,510.3139539486975,1422.0005737539868,0.7500566843987093,0.2323499769850866,-1122
1210,2020-04-25,2020,230542,230542,442989313.3833326,3596235.516666669,172499,0,84,0.8077400213410137,45414221,6623862148,757440,757440,380320821.34999835,3592680.366666572,173639,0,84,0.24781896915927365,5516225668,-526898,-526898,62668492.033334255,3555.1500000967644,-1140,0,0,0.5599210521817402,-5470811447,1921.5124072114088,502.11346291455214,1419.3989442968566,0.7482324261956607,0.22924456062526405,-1140
1211,2020-04-26,2020,234519,234519,444007524.2833341,3665820.3666666686,174275,0,89,0.8032654070672319,45730790,6639394751,767185,767185,381525499.1499953,3661132.0333332596,175519,0,89,0.24778638789861868,5536846360,-532666,-532666,62482025.13333875,4688.333333408926,-1244,0,0,0.5554790191686132,-5491115570,1893.2688792095057,497.3057334932191,1395.9631457162866,0.7431167623945182,0.22878314878419156,-1244
1212,2020-04-27,2020,243117,243117,445199961.44999987,3722544.850000001,179142,0,114,0.8021775523719026,46238372,6656040616,782354,782354,382889917.71666276,3718001.216666528,180293,0,114,0.25138236655017876,5557866963,-539237,-539237,62310043.733337104,4543.633333473001,-1151,0,0,0.5507951858217238,-5511628591,1831.2169097594979,489.407503146482,1341.8094066130159,0.7368550944606918,0.2304493873617314,-1151
1213,2020-04-28,2020,233124,233124,445694258.45000005,3652505.450000002,175405,0,101,0.809273176506923,45543523,6666749502,787000,787000,383555244.1333489,3647010.316666232,176640,0,101,0.24186658195679425,5564592320,-553876,-553876,62139014.316651165,5495.133333770093,-1235,0,0,0.5674065945501288,-5519048797,1911.83343821314,487.36371554428064,1424.4697226688593,0.7524107342015408,0.22444726810673443,-1235
1214,2020-04-29,2020,238328,238328,446310263.71666694,3685867.9666666714,177876,0,77,0.8015340203417137,45907270,6676642083,800790,800790,384368285.9666617,3681145.9833332044,179075,0,77,0.2406061514254639,5582215306,-562462,-562462,61941977.750005245,4721.98333346704,-1199,0,0,0.5609278689162498,-5536308036,1872.672383088294,479.98637091704654,1392.6860121712475,0.7463495686616763,0.2236229223641654,-1199
1215,2020-04-30,2020,238502,238502,446918945.4333335,3674055.866666666,179448,0,48,0.8087605135386706,46024345,6686527603,811615,811615,385156501.2166741,3670201.7499995925,180884,0,48,0.24026293254807105,5601783257,-573113,-573113,61762444.21665943,3854.1166670736857,-1436,0,0,0.5684975809905995,-5555758912,1873.8582713492278,474.55567136718037,1399.3025999820475,0.752396206321121,0.2228692175477289,-1436
1216,2020-05-01,2020,223479,223479,446615420.75000024,3521091.8166666627,169839,0,61,0.8141973071295282,45204472,6693220069,490609,490609,385089091.88334316,3516389.749999841,171375,0,61,0.3751847193997658,5565917741,-267130,-267130,61526328.86665708,4702.0666668214835,-1536,0,0,0.4390125877297624,-5520713269,1998.4670629007658,784.9205617576179,1213.546501143148,0.759977447545407,0.34931075459276123,-1536
1217,2020-05-02,2020,210757,210757,446305166.74999934,3456441.466666664,164071,0,50,0.827654597474818,44407249,6696702421,494841,494841,384991823.8833388,3451609.133333168,165207,0,50,0.35556471674740564,5582000573,-284084,-284084,61313342.866660535,4832.333333496004,-1136,0,0,0.4720898807274123,-5537593324,2117.6291499214703,778.0111669876562,1339.6179829338141,0.7784842259094598,0.3338587546302752,-1136
1218,2020-05-03,2020,213841,213841,446603343.5333331,3446957.083333335,164811,0,99,0.8191179427705632,44864848,6704154669,507095,507095,385521222.233348,3442732.68333318,165978,0,99,0.34854810242656276,5602875256,-293254,-293254,61082121.29998511,4224.400000154972,-1167,0,0,0.4705698403440004,-5558010408,2088.483235363345,760.2544340475612,1328.228801315784,0.7707174957094289,0.3273114505171615,-1167
1219,2020-05-04,2020,219569,219569,447648188.93333304,3512972.3333333316,168150,0,149,0.8155613952789331,45011623,6722372167,521951,521951,386686385.2000091,3508424.649999841,169350,0,150,0.3463965008209622,5618075825,-302382,-302382,60961803.73332393,4547.6833334905095,-1200,0,-1,0.46916489445797094,-5573064202,2038.7586086074675,740.8480589174254,1297.910549690042,0.7658184898596796,0.3244557439299858,-1200
1220,2020-05-05,2020,220954,220954,448365414.01666677,3529026.583333333,169282,0,199,0.8204648931451791,45171868,6734864328,530217,530217,387609775.8833406,3524771.3833331903,170496,0,201,0.34519074265819566,5630229644,-309263,-309263,60755638.13332617,4255.200000142679,-1214,0,-2,0.47527415048698346,-5585057776,2029.225151011825,731.0398872222894,1298.1852637895354,0.7661413687916941,0.3215589088995638,-1214
1221,2020-05-06,2020,224600,224600,448937803.9166668,3537599.9666666696,169905,0,123,0.8108771148708811,45644610,6742645952,544509,544509,388361994.4333434,3532911.0499998415,171305,0,123,0.3380403262388627,5649386766,-319909,-319909,60575809.483323395,4688.916666828096,-1400,0,0,0.4728367886320184,-5603742156,1998.8326087117846,713.2333798584475,1285.599228853337,0.7564781834372217,0.31460453362570684,-1400
1222,2020-05-07,2020,218967,218967,449512274.5833334,3487665.88333333,167675,0,54,0.8159448684048278,45094940,6753886196,552460,552460,389099392.45001173,3482840.999999836,168917,0,54,0.32670238569308147,5665843523,-333493,-333493,60412882.13332164,4824.883333493955,-1242,0,0,0.48924248271174636,-5620748583,2052.876801451056,704.3032843101976,1348.5735171408585,0.765754657094448,0.3057542627520545,-1242
1223,2020-05-08,2020,214735,214735,449528460.96666735,3423770.4500000044,165377,0,52,0.8167508789903829,44965997,6759863668,563077,563077,389301286.83334595,3419987.833333155,166690,0,52,0.31535473833951877,5683537170,-348342,-348342,60227174.133321404,3782.616666849237,-1313,0,0,0.5013961406508641,-5638571173,2093.4103009135324,691.3819723294433,1402.0283285840892,0.7701445968286492,0.2960341125636458,-1313
1224,2020-05-09,2020,215026,215026,449619825.2833337,3420629.0666666706,165113,0,54,0.8141899119176287,45104370,6767141009,576465,576465,389551110.20001197,3416380.2166664917,166485,0,54,0.3074132861491997,5701798901,-361439,-361439,60068715.08332175,4248.850000178907,-1372,0,0,0.506776625768429,-5656694531,2091.002135943252,675.7584765770896,1415.2436593661625,0.7678745826086147,0.28880330982800345,-1372
1225,2020-05-10,2020,214907,214907,449919567.05000013,3424885.033333334,162819,0,37,0.8092430679317095,45183247,6778568956,586363,586363,389994539.01667756,3420731.3999998327,164289,0,37,0.3004913338665643,5719240878,-371456,-371456,59925028.03332257,4153.633333501406,-1470,0,0,0.5087517340651453,-5674057631,2093.55473321018,665.107687587173,1428.447045623007,0.7576253914483939,0.2801830947723509,-1470
1226,2020-05-11,2020,218296,218296,450995527.6666666,3491729.4833333315,165397,0,49,0.8041100157584198,45058722,6797171121,599043,599043,391207843.6166755,3487685.2999998606,166683,0,49,0.2962258135058693,5734867736,-380747,-380747,59787684.04999113,4044.1833334709518,-1286,0,0,0.5078842022525505,-5689809014,2065.981638081626,653.054694932877,1412.926943148749,0.757673067761205,0.2782488068469208,-1286
1227,2020-05-12,2020,219038,219038,451929236.78333354,3513994.5333333383,168261,0,51,0.8182507144878984,44983941,6809962635,606034,606034,392304344.6166741,3509374.0333331246,169451,0,51,0.29872086384592494,5744600665,-386996,-386996,59624892.166659415,4620.5000002137385,-1190,0,0,0.5195298506419734,-5699616724,2063.2458148053465,647.3305864302566,1415.91522837509,0.7681817766780193,0.2796064247220453,-1190
1228,2020-05-13,2020,220215,220215,452753928.6166662,3517032.233333333,168955,0,47,0.8164384805758008,45033953,6822673433,616003,616003,393260119.1000134,3512415.7833331116,170221,0,47,0.29475018790493007,5764661049,-395788,-395788,59493809.51665282,4616.450000221375,-1266,0,0,0.5216882926708708,-5719627096,2055.963166072548,638.4061751322856,1417.5569909402625,0.7672274822332721,0.27633144643776086,-1266
1229,2020-05-14,2020,217910,217910,452830352.56666684,3488868.633333338,170024,0,50,0.8306181451057777,44291603,6826476408,625833,625832,393398206.91667575,3484752.8499998134,171336,0,50,0.29225208641922334,5776437613,-407923,-407922,59432145.649991095,4115.783333524596,-1312,0,0,0.5383660586865544,-5732146010,2078.061367384089,628.6003382963411,1449.4610290877479,0.7802487265384792,0.2737727157244824,-1312
1230,2020-05-15,2020,221088,221088,452015987.766667,3461288.1500000004,171979,0,45,0.8273266753509914,43841538,6816804125,639621,639621,392749219.7333433,3456795.549999832,173133,0,45,0.2882300612393925,5773773825,-418533,-418533,59266768.033323705,4492.600000168197,-1154,0,0,0.5390966141115989,-5729932287,2044.5071092355397,614.0342792580971,1430.4728299774426,0.7778757779707628,0.27068060617146716,-1154
1231,2020-05-16,2020,223506,223506,449177840.7666664,3478163.6499999985,172891,0,46,0.8221613737438822,44627083,6771485876,652882,652881,390099144.23333955,3473157.316666481,174246,0,46,0.2841692679534769,5744033301,-429376,-429375,59078696.533326864,5006.333333517425,-1355,0,0,0.5379921057904054,-5699406218,2009.69030257204,597.5042070964533,1412.1860954755866,0.7735407550580298,0.2668874314194602,-1355
1232,2020-05-17,2020,222988,222988,445980859.9333324,3453895.1833333364,173267,0,47,0.8252910470518594,43971950,6716207423,661383,661383,387332479.2500104,3448112.1999998223,174579,0,47,0.2807798204671136,5702852769,-438395,-438395,58648380.68332201,5782.983333514072,-1312,0,0,0.5445112265847458,-5658880819,2000.0217945958186,585.6402103622415,1414.381584233577,0.7770238757242542,0.26396051909408014,-1312
1233,2020-05-18,2020,241951,241951,443105022.61666757,3485815.9333333336,175107,0,48,0.7695607788353831,44957906,6665452538,692921,692921,385518553.4500153,3480522.549999863,176536,0,48,0.2713888018980508,5674448308,-450970,-450970,57586469.16665226,5293.383333470672,-1429,0,0,0.4981719769373323,-5629490402,1831.3833074327758,556.3672531933876,1275.0160542393883,0.723729184834946,0.254770745871463,-1429
1234,2020-05-19,2020,251706,251706,441058988.6833339,3540532.2666666643,179281,0,168,0.7558262417264577,45435863,6628512460,726913,726913,383927386.56666166,3535223.8833332723,180510,0,168,0.26406736432007655,5643656063,-475207,-475207,57131602.11667222,5308.383333391976,-1229,0,0,0.4917588774063812,-5598220200,1752.2784068847538,528.161398360824,1224.1170085239298,0.712263513781952,0.2483240772967329,-1229
1235,2020-05-20,2020,235556,235556,438674427.26666653,3602469.249999997,181689,0,206,0.8169182699655286,46010298,6584277594,736335,736335,382423508.299997,3597587.1666665813,182979,0,206,0.26361099227933643,5609293985,-500779,-500779,56250918.96666956,4882.083333415911,-1290,0,0,0.5533072776861923,-5563283687,1862.2935831253142,519.3607641902082,1342.9328189351058,0.7713197710947716,0.2484996638758174,-1290
1236,2020-05-21,2020,231621,231621,436673353.9166674,3603264.9,180454,0,52,0.822045496738205,46269620,6543886822,738766,738766,381089565.2499991,3598306.566666523,181723,0,52,0.26004039168018767,5581194358,-507145,-507145,55583788.666668296,4958.333333476912,-1269,0,0,0.5620051050580174,-5534924738,1885.292585372947,515.8461072247493,1369.446478148198,0.7790917058470519,0.24598181291505022,-1269
1237,2020-05-22,2020,224547,224547,436156355.21666664,3564802.4833333325,174489,0,53,0.8200866633711424,45381345,6537748164,742668,742668,380857590.06667334,3560166.9833328426,175515,0,53,0.24983034141769622,5587269114,-518121,-518121,55298765.1499933,4635.500000489876,-1026,0,0,0.5702563219534462,-5541887769,1942.3833550065983,512.8234824533619,1429.5598725532363,0.7770711699555104,0.23633036565463975,-1026
1238,2020-05-23,2020,222027,222027,436144628.63333297,3543685.4166666707,172108,0,51,0.8188013169569466,44532697,6539324748,750635,750635,381017360.71666443,3540174.366666602,173103,0,52,0.2438748526247817,5597135156,-528608,-528608,55127267.916668534,3511.0500000687316,-995,0,-1,0.5749264643321649,-5552602459,1964.3765336347965,507.59338522273066,1456.7831484120659,0.7751669841956158,0.23060875125726885,-995
1239,2020-05-24,2020,221006,221006,436336424.1333326,3509811.6499999976,171165,0,54,0.8237423418368737,44856205,6547365371,760274,760274,381385506.2999959,3505550.7999999127,172140,0,54,0.24113937869768026,5612240459,-539268,-539268,54950917.83333671,4260.8500000848435,-975,0,0,0.5826029631391934,-5567384254,1974.319358448787,501.64217939847464,1472.6771790503124,0.7744812358035529,0.22641837021915784,-975
1240,2020-05-25,2020,225774,225774,436949217.8000006,3575937.36666667,174377,0,57,0.8219502688529237,44697676,6555408044,773020,773020,382224315.4499979,3570873.8833332094,175399,0,57,0.242033841297763,5627881413,-547246,-547246,54724902.350002706,5063.483333460521,-1022,0,0,0.5799164275551607,-5583183737,1935.3389575416152,494.4559202219838,1440.8830373196315,0.7723519980157149,0.22690098574422396,-1022
1241,2020-05-26,2020,223726,223726,437224178.99999976,3551322.8499999964,172372,0,54,0.8182196079132515,44667216,6558878052,778014,778014,382723571.23332775,3547674.866666534,173276,0,54,0.23684535239725893,5632442421,-554288,-554288,54500607.766672015,3647.9833334623836,-904,0,0,0.5813742555159926,-5587775205,1954.284164558432,491.92375874126657,1462.3604058171654,0.7704602951825,0.2227157866053824,-904
1242,2020-05-27,2020,227668,227668,437869747.1166672,3585523.3166666655,174737,0,163,0.8166145439851014,45195731,6567042031,790812,790812,383593891.1666616,3581087.8333332734,175694,0,163,0.23684896030915392,5643577834,-563144,-563144,54275855.95000559,4435.483333392069,-957,0,0,0.5797655836759474,-5598382103,1923.2819154060614,485.0633161442437,1438.2185992618179,0.7675079501730591,0.22216911225423994,-957
1243,2020-05-28,2020,232602,232602,438464257.43333304,3620195.7166666724,177981,0,52,0.8179551336617916,44928286,6574473721,804007,804007,384236953.14999735,3615369.116666558,178963,0,52,0.23853896794430934,5653448576,-571405,-571405,54227304.283335686,4826.60000011418,-982,0,0,0.5794161657174823,-5608520290,1885.0407882706643,477.90249730412467,1407.1382909665397,0.7651739881858282,0.22258885805720596,-982
1244,2020-05-29,2020,234182,234182,438941237.8499995,3623248.783333333,180184,0,96,0.8239104628024357,45528385,6582227982,816508,816508,384876005.61667514,3618549.69999959,181108,0,96,0.23792418445379043,5668091580,-582326,-582326,54065232.23332435,4699.0833337432705,-924,0,0,0.5859862783486454,-5622563195,1874.3594206642674,471.36832170251256,1402.991098961755,0.7694186572836512,0.22180799208335986,-924
1245,2020-05-30,2020,227796,227796,438485404.55,3599745.3999999976,176398,0,87,0.8240311506786777,44973881,6576857532,821597,821597,384621736.29999954,3595370.3666662904,177513,0,87,0.23034163951426295,5676577629,-593801,-593801,53863668.25000048,4375.033333707135,-1115,0,0,0.5936895111644147,-5631603748,1924.9038813236405,468.1391683513931,1456.7647129722473,0.7743682944388839,0.21605848122619728,-1115
1246,2020-05-31,2020,228200,228200,438599486.0333329,3592290.9999999995,178078,0,102,0.8321165644171776,45028310,6579088468,830875,830875,384948220.0833291,3587345.9833332268,179172,0,103,0.2305027832104713,5692185310,-602675,-602675,53651265.9500038,4945.016666772775,-1094,0,-1,0.6016137812067064,-5647157000,1921.9959948875237,463.30461270748197,1458.6913821800417,0.7803593339176161,0.2156425455092523,-1094
1247,2020-06-01,2020,233671,233671,439373767.78333336,3650983.649999999,181354,0,56,0.8265595645159212,46127724,6591024496,496777,496777,385763376.2166696,3647658.099999535,182641,0,57,0.39224239447478576,5655899536,-263106,-263106,53610391.56666374,3325.550000464078,-1287,0,-1,0.4343171700411354,-5609771812,1880.3093571017941,776.5322795070416,1103.7770775947524,0.7761082890046261,0.3676518840445512,-1287
1248,2020-06-02,2020,232357,232357,439815882.1166664,3626673.266666665,181018,0,81,0.8275928850863117,44788537,6598741208,507525,507525,386297867.216667,3622087.7666662373,182164,0,81,0.3818215851435867,5657729296,-275168,-275168,53518014.89999938,4585.500000427943,-1146,0,0,0.44577129994272496,-5612940759,1892.8454151011865,761.1405688718132,1131.7048462293733,0.7790512013840771,0.3589261612728437,-1146
1249,2020-06-03,2020,233005,233005,438524561.7166672,3630051.266666667,181648,0,140,0.8328147464646685,46139665,6579113125,518839,518839,385256647.35000193,3625052.6999996738,183065,0,140,0.3778031335346743,5646642429,-285834,-285834,53267914.366665244,4998.5666669933125,-1417,0,0,0.45501161292999415,-5600502764,1882.0392769110842,742.5360224462731,1139.503254464811,0.779588420849338,0.35283585081306534,-1417
1250,2020-06-04,2020,229439,229439,436473917.93333316,3608868.466666668,179114,0,115,0.8333413238377082,46008796,6541597222,526785,526784,383614662.8000026,3603371.5499995584,180486,0,117,0.36651385290014166,5619071796,-297346,-297345,52859255.13333058,5496.916667109821,-1372,0,-2,0.46682747093756655,-5573063000,1902.352773213504,728.2200347770672,1174.1327384364367,0.7806606549017386,0.34261795609214385,-1372
1251,2020-06-05,2020,227884,227884,434328703.3999999,3595937.2500000023,177392,0,47,0.828224008706184,46541598,6505361768,534868,534868,382176829.03334105,3591539.349999789,178779,0,47,0.356400083758983,5605472055,-306984,-306984,52151874.36665887,4397.90000021318,-1387,0,0,0.47182392494720093,-5558930457,1905.9201321725084,714.5255072902867,1191.3946248822217,0.7784311316283723,0.33424882400891437,-1387
1252,2020-06-06,2020,225194,225194,432787508.6999998,3590989.499999992,175633,0,53,0.8283790864765488,46456555,6481387388,543096,543096,381173551.9333435,3585944.2666664617,177049,0,53,0.34655935598862486,5593630121,-317902,-317902,51613956.76665628,5045.23333353037,-1416,0,0,0.4818197304879239,-5547173566,1921.842982939154,701.8529908770154,1219.9899920621385,0.7799186479213478,0.3259994549766524,-1416
1253,2020-06-07,2020,227161,227161,431599891.81666696,3583670.2500000005,176480,0,55,0.8239442509937883,46855733,6458705072,554357,554357,380368643.5166714,3578845.983333008,177932,0,55,0.34099686664008666,5589374451,-327196,-327196,51231248.29999554,4824.2666669925675,-1452,0,0,0.48294738435370166,-5542518718,1899.9735509910017,686.1438450613439,1213.8297059296578,0.7768939210515889,0.32097006080918977,-1452
1254,2020-06-08,2020,231287,231287,431173229.9833325,3629012.5666666683,179402,0,57,0.8231245162936088,46077722,6450217532,566361,566361,380240101.61667216,3624020.4999996573,180763,0,57,0.3391935532284236,5588133921,-335074,-335074,50933128.36666036,4992.066667011008,-1361,0,0,0.48393096306518524,-5542056199,1864.2346088769905,671.3740911126863,1192.8605177643042,0.7756683255003524,0.31916569114045634,-1361
1255,2020-06-09,2020,231098,231098,430240283.3500002,3615829.666666667,180508,0,59,0.8262598551263965,45272845,6430369488,571603,571603,379729318.43334025,3610695.1999998507,181816,0,59,0.33713608920876675,5574965639,-340505,-340505,50510964.91665995,5134.466666816268,-1308,0,0,0.4891237659176298,-5529692794,1861.722227583104,664.3235225031013,1197.3987050800029,0.7810885425230855,0.31808090580350346,-1308
1256,2020-06-10,2020,231205,231205,429151507.8000002,3611652.9499999997,181157,0,53,0.8322873640275947,45341403,6411987393,580142,580142,379047767.7333451,3607006.383333193,182280,0,53,0.33412509351158354,5564287070,-348937,-348937,50103740.0666551,4646.566666806582,-1123,0,0,0.4981622705160112,-5518945667,1856.1515010488536,653.370670858764,1202.7808301900895,0.7835340931208236,0.31419893750150824,-1123
1257,2020-06-11,2020,233913,233913,428435066.8333332,3644370.4666666673,181649,0,232,0.8276752467797855,45607499,6389684214,589972,589972,378707552.2166699,3639347.616666437,182698,0,235,0.33050382052028615,5548730796,-356059,-356059,49727514.61666328,5022.85000023013,-1049,0,-3,0.4971714262594994,-5503123297,1831.6000685440022,641.9076705617723,1189.69239798223,0.7765665012205393,0.3096723234322985,-1049
1258,2020-06-12,2020,236332,236332,427200534.08333266,3649529.6833333382,184311,0,55,0.8309708376351919,45223091,6359454283,601414,601414,378062364.33334404,3644116.349999802,185430,0,55,0.3291060733537919,5536372331,-365082,-365082,49138169.749988616,5413.333333536051,-1119,0,0,0.5018647642814,-5491149240,1807.6288191329684,628.6224868947913,1179.006332238177,0.7798816918572178,0.30832338455706054,-1119
1259,2020-06-13,2020,231393,231393,426304507.2166662,3623327.8166666636,182189,0,50,0.8357426542721689,45458025,6344690450,606870,606870,377491370.15001047,3618510.766666471,183316,0,50,0.32125166839685326,5533524503,-375477,-375477,48813137.066655755,4817.0500001925975,-1127,0,0,0.5144909858753156,-5488066478,1842.3396870979943,622.0300396295919,1220.3096474684025,0.7873574395076774,0.30206798820175657,-1127
1260,2020-06-14,2020,230933,230933,425364329.9833339,3604063.4000000013,182072,0,57,0.8364633898143612,46133088,6327998001,616588,616588,376971782.48334193,3599466.9999998184,183199,0,57,0.3158494813392392,5533404861,-385655,-385655,48392547.49999195,4596.400000182912,-1127,0,0,0.520613908475122,-5487271773,1841.9382677371093,611.3835859331384,1230.5546818039709,0.7884191518752193,0.2971173619986117,-1127
1261,2020-06-15,2020,231229,231229,424967222.6000003,3639671.683333332,180637,0,60,0.8264058573967804,45443481,6318915722,626305,626305,376961064.28334,3634893.3499998534,181889,0,60,0.3077398392157178,5526837056,-395076,-395076,48006158.316660345,4778.333333478775,-1252,0,0,0.5186660181810626,-5481393575,1837.862995558517,601.8809753767573,1235.9820201817597,0.7812039147338785,0.29041601136826306,-1252
1262,2020-06-16,2020,231627,231627,424414077.3999999,3654253.1833333336,180078,0,52,0.8234014169332592,45443226,6306344134,630803,630802,376737186.516683,3649081.216666431,181217,0,52,0.3046561287755498,5515649247,-399176,-399175,47676890.883316934,5171.966666902415,-1139,0,0,0.5187452881577094,-5470206021,1832.3169466426623,597.2352442076642,1235.081702434998,0.7774482249478688,0.2872798639194804,-1139
1263,2020-06-17,2020,229961,229961,424110823.7833331,3610466.63333333,178916,0,66,0.8239788485873681,44732973,6301871400,639241,639241,376770900.5833431,3606322.016666465,180229,0,66,0.29897331366418034,5516275508,-409280,-409280,47339923.199990034,4144.616666865069,-1313,0,0,0.5250055349231878,-5471542535,1844.2728279287928,589.4035279078518,1254.869300020941,0.778027578589413,0.2819421783020801,-1313
1264,2020-06-18,2020,227236,227236,422385042.4500004,3573623.099999998,176717,0,61,0.8208470488830986,44591094,6288812106,648192,648192,375225318.06668115,3569065.566666475,177652,0,61,0.28952995408768106,5520371019,-420956,-420956,47159724.38331926,4557.533333523199,-935,0,0,0.5313170947954176,-5475779925,1858.7945679821878,578.8798968001474,1279.9146711820404,0.7776804731644634,0.2740731141390205,-935
1265,2020-06-19,2020,234501,234501,421551701.3500005,3610471.516666662,180631,0,73,0.8152673122929112,44738227,6279732125,663608,663608,374555270.85001564,3608715.6999998153,182410,0,73,0.2912864221046175,5517982907,-429107,-429107,46996430.49998486,1755.8166668466292,-1779,0,0,0.5239808901882936,-5473244680,1797.654173542972,564.4224765976535,1233.2316969453186,0.7702781651250954,0.2748761316922038,-1779
1266,2020-06-20,2020,232814,232814,420587400.48333347,3602637.7166666663,181667,0,58,0.8253584406436036,44273527,6268125843,669913,669913,373699233.7833457,3597670.249999835,182625,0,58,0.28875540555266915,5510529560,-437099,-437099,46888166.69998777,4967.466666831169,-958,0,0,0.5366030350909345,-5466256033,1806.5382686751375,557.8324853874245,1248.705783287713,0.7803096033743675,0.27261002548092067,-958
1267,2020-06-21,2020,229647,229647,419892794.49999976,3557498.3166666687,178634,0,63,0.8221444216558447,44920817,6258041447,648020,648020,356706870.3333348,2716657.566666588,99691,0,63,0.15893953890312168,5494681335,-418373,-418373,63185924.16666496,840840.7500000806,78943,0,0,0.663204882752723,-5449760518,1828.4270837415675,550.4565759287287,1277.9705078128386,0.7778634164609161,0.15383938767321997,78943
1268,2020-06-22,2020,228276,228276,419557279.8166666,3589102.1333333296,177524,0,52,0.8224386269253013,45041628,6254346429,699458,699458,357936051.5000074,3585652.1333328052,178282,0,52,0.269907556994121,5508266022,-471182,-471182,61621228.31665921,3450.0000005243346,-758,0,0,0.5525310699311803,-5463224394,1837.9386348835033,511.73344432404434,1326.205190559459,0.7776726418896424,0.2548859259598146,-758
1269,2020-06-23,2020,232639,232639,419213795.5666669,3611749.7666666615,182373,0,50,0.8293450367307289,44209210,6245260438,687226,687226,358426064.55000734,3606471.2499997886,183323,0,51,0.2825504273703217,5423323685,-454587,-454587,60787731.01665956,5278.5166668728925,-950,0,-1,0.5467946093604072,-5379114475,1801.9927680512162,521.55486630309,1280.4379017481263,0.7839313270775752,0.26675795153268356,-950
1270,2020-06-24,2020,234655,234655,418777130.6333328,3648069.916666669,186020,0,53,0.838678059278516,44398253,6234348290,696462,696462,358589449.2166785,3642566.266666487,187109,0,53,0.2846587466365739,5410143027,-461807,-461807,60187681.41665429,5503.65000018198,-1089,0,0,0.5540193126419422,-5365744774,1784.6503617367318,514.8729567681776,1269.7774049685543,0.7927382753403933,0.26865643782431775,-1089
1271,2020-06-25,2020,235423,235423,418007445.68333316,3634029.8166666613,184593,0,55,0.8290948632886326,45598308,6222634487,706315,706315,358158145.10000664,3628985.3999995287,185750,0,55,0.27835739011631194,5403172615,-470892,-470892,59849300.58332652,5044.416667132638,-1157,0,0,0.5507374731723207,-5357574307,1775.5590816671827,507.07990783150103,1268.4791738356816,0.7840907642838635,0.2629846456609303,-1157
1272,2020-06-26,2020,238067,238067,416524564.5833333,3664840.5833333298,185451,0,50,0.8217980652505394,46264339,6199030752,716351,716349,357350481.2166745,3658727.3166661607,186483,0,51,0.27509838054249247,5392380311,-478284,-478282,59174083.36665881,6113.266667169053,-1032,0,-1,0.546699684708047,-5346115972,1749.610675076064,498.8496964701207,1250.7609786059431,0.7789865878093142,0.2603235006302776,-1032
1273,2020-06-27,2020,235888,235888,415764423.3333335,3654894.8666666723,183101,0,53,0.8195075629112123,46057552,6187757039,720852,720852,357001254.1000002,3650033.333332887,183961,0,54,0.26970723532709306,5386011010,-484964,-484964,58763169.23333329,4861.533333785366,-860,0,-1,0.5498003275841192,-5339953458,1762.550122657081,495.2490304528533,1267.3010922042276,0.7762200705419521,0.25519940292875654,-860
1274,2020-06-28,2020,232399,232399,415154814.63333356,3595829.5166666647,180981,0,47,0.8255715386038672,45038643,6179010527,727077,727077,356763122.5666848,3591507.3499994506,181818,0,50,0.2653694175444979,5386834999,-494678,-494678,58391692.06664878,4322.166667214129,-837,0,-3,0.5602021210593693,-5341796356,1786.3881283195433,490.68134814701165,1295.7067801725316,0.7787511994457808,0.2500670492946414,-837
1275,2020-06-29,2020,225834,225834,414513077.83333284,3557631.799999996,175903,0,54,0.8234278275193279,44378674,6173485250,733104,733104,356711784.4833396,3552276.3166661705,176912,0,54,0.2554166939479323,5393089253,-507270,-507270,57801293.34999323,5355.483333825599,-1009,0,0,0.5680111335713955,-5348710579,1835.4768450868019,486.5773266594366,1348.8995184273654,0.7789039737152067,0.2413191034287086,-1009
1276,2020-06-30,2020,228636,228636,413654617.41666687,3583354.1833333303,177619,0,55,0.8207718819433509,44493792,6159807545,741262,741261,356403582.13332677,3578217.416666608,178520,0,55,0.254824879732132,5384655666,-512626,-512625,57251035.2833401,5136.766666722484,-901,0,0,0.565947002211219,-5340161874,1809.2278443318937,480.8071409845207,1328.420703347373,0.7768636610157631,0.2408325261513473,-901
1277,2020-07-01,2020,234417,234417,413470813.23333424,3630032.283333335,181435,0,53,0.8175345644727129,45154829,6156137990,503486,503486,356654869.733333,3624683.5666662953,182586,0,54,0.38372268543712656,5339622188,-269069,-269069,56815943.50000125,5348.7166670397855,-1151,0,-1,0.4338118790355863,-5294467359,1763.8260588324833,708.370977014918,1055.4550818175653,0.7739839687394685,0.3626436484827781,-1151
1278,2020-07-02,2020,235171,235171,412926566.2666662,3653179.2500000014,184576,0,58,0.8284694966641291,45499711,6149745389,512018,512018,356592128.716668,3647894.0333329528,185598,0,58,0.3832228554464889,5336934462,-276847,-276847,56334437.549998164,5285.216667048633,-1022,0,0,0.4452466412176402,-5291434751,1755.8566586299594,696.4445170221907,1059.4121416077687,0.7848586773028987,0.3624833501947197,-1022
1279,2020-07-03,2020,233204,233204,412556076.23333305,3562273.2666666643,184706,0,48,0.8369967925078476,44371828,6143507668,518482,518482,356712930.683333,3557268.666666322,185580,0,48,0.37894083111852783,5337603070,-285278,-285278,55843145.55000007,5004.600000342354,-874,0,0,0.4580559613893198,-5293231242,1769.0780442588166,687.9948208102364,1081.0832234485802,0.7920361571842679,0.35792949417723274,-874
1280,2020-07-04,2020,228977,228977,411890768.6833335,3596751.83333333,180763,0,69,0.8356472484135967,44024635,6135038500,527413,527413,356478584.7500013,3591655.1666663447,181624,0,69,0.3648715522749733,5342550204,-298436,-298436,55412183.933332205,5096.666666985489,-861,0,0,0.4707756961386234,-5298525569,1798.8303134521525,675.9002617493337,1122.9300517028187,0.789437367071802,0.3443676966627671,-861
1281,2020-07-05,2020,227140,227140,411343758.28333306,3572546.8166666618,179978,0,72,0.838680989697984,44673340,6127104537,534046,534046,356353870.0666698,3567967.2999996543,180798,0,72,0.35900465502971485,5348635789,-306906,-306906,54989888.21666324,4579.516667007469,-820,0,0,0.47967633466826914,-5303962449,1810.9701430101834,667.2718643462732,1143.69827866391,0.7923659417099587,0.3385438707527067,-820
1282,2020-07-06,2020,229478,229478,411203119.9666667,3605040.6833333364,181535,0,60,0.8367163736828809,44714075,6125153308,545850,545850,356596648.0166749,3599907.616666355,182470,0,60,0.35397087111844666,5351543083,-316372,-316372,54606471.94999182,5133.066666981205,-935,0,0,0.4827455025644342,-5306829008,1791.9065006957821,653.2868883698358,1138.6196123259465,0.7910780118355573,0.3342859760007328,-935
1283,2020-07-07,2020,230849,230849,410808761.7833335,3621342.633333334,182338,0,56,0.8333066203449008,44777796,6114083856,553737,553737,356592019.4000099,3617022.149999686,183543,0,57,0.35024027652116085,5344140758,-322888,-322888,54216742.38332361,4320.483333647717,-1205,0,-1,0.4830663438237399,-5299362962,1779.556167812438,643.9736181617083,1135.5825496507296,0.7898583056456818,0.3314624090497836,-1205
1284,2020-07-08,2020,232356,232356,410169370.5333332,3633587.150000006,183428,0,60,0.8316634818984664,44625502,6103147999,562017,562017,356429713.26668406,3627618.483333138,184262,0,61,0.3458151621748098,5344034337,-329661,-329661,53739657.26664913,5968.666666868143,-834,0,-1,0.4858483197236566,-5299408835,1765.2626595970544,634.1973877421574,1131.065271854897,0.7894265695742739,0.3278584099769224,-834
1285,2020-07-09,2020,232414,232414,409616990.43333364,3627562.1999999983,185337,0,60,0.8411068180057998,43982742,6088378279,570229,570229,356495693.66666853,3622534.0833329074,186142,0,60,0.34467205280684954,5342708226,-337815,-337815,53121296.7666651,5028.116667090915,-805,0,0,0.49643476519895025,-5298725484,1762.4454225362226,625.179872764571,1137.2655497716516,0.7974433553916718,0.3264337660834507,-805
1286,2020-07-10,2020,235794,235794,408979413.4499995,3626385.933333335,187803,0,47,0.8383249785830019,44545947,6077912838,581531,581531,356295533.9000101,3621548.24999989,188591,0,47,0.34179261294754487,5341514885,-345737,-345737,52683879.5499894,4837.683333444875,-788,0,0,0.49653236563545705,-5296968938,1734.4776094811552,612.685366558292,1121.7922429228634,0.7964706481080943,0.3243008541247156,-788
1287,2020-07-11,2020,234417,234417,408225014.28333336,3632551.0000000033,187150,0,48,0.8421829474824782,44467099,6065607195,587880,587880,355982653.86667883,3627890.833333209,188008,0,48,0.3378308498333051,5342151410,-353463,-353463,52242360.41665453,4660.166666794103,-858,0,0,0.5043520976491731,-5297684311,1741.4479934617939,605.5362554716589,1135.911737990135,0.7983635999095628,0.31980676328502416,-858
1288,2020-07-12,2020,234956,234956,408068134.61666673,3627135.283333332,188641,0,47,0.847460801171283,44494408,6061468205,596188,596188,356256414.5666789,3621996.999999904,189420,0,47,0.33589236952102697,5346946724,-361232,-361232,51811720.04998785,5138.283333427738,-779,0,0,0.511568431650256,-5302452316,1736.7853326438428,597.5571708365128,1139.22816180733,0.8028779856654011,0.317718571994069,-779
1289,2020-07-13,2020,235627,235627,408115168.3166664,3632723.516666667,188346,0,54,0.8455525045941259,44148492,6060794000,606839,606839,356584369.7333472,3627842.0166665576,189221,0,54,0.33043855124670907,5352185472,-371212,-371212,51530798.58331925,4881.50000010943,-875,0,0,0.5151139533474168,-5308036980,1732.0390630813379,587.6095137809982,1144.4295493003397,0.7993396342524414,0.31181417146887397,-875
1290,2020-07-14,2020,233726,233726,407570506.21666676,3624548.9666666663,184691,0,50,0.834233247477815,44070951,6049374294,611706,611706,356327118.9500114,3619806.849999856,185539,0,50,0.3206262485573156,5340225871,-377980,-377980,51243387.266655385,4742.116666810121,-848,0,0,0.5136069989204994,-5296154920,1743.796181069572,582.5136895011842,1161.2824915683877,0.7902030582819198,0.3033140103252216,-848
1291,2020-07-15,2020,234819,234819,407344582.38333386,3626794.800000002,185455,0,49,0.8325007771943487,43457538,6042646721,620505,620505,356495501.7833419,3622436.16666649,186283,0,51,0.3169837471092064,5337564653,-385686,-385686,50849080.59999198,4358.633333512116,-828,0,-2,0.5155170300851423,-5294107115,1734.7173030433391,574.5247851078426,1160.1925179354967,0.7897785102568361,0.3002119241585483,-828
1292,2020-07-16,2020,236249,236249,406851762.89999986,3665135.500000001,186817,0,53,0.8356352831123094,44245751,6036046869,629770,629770,356395341.5833436,3660450.1666664667,187870,0,53,0.31571684900836755,5338362630,-393521,-393521,50456421.31665623,4685.333333534189,-1053,0,0,0.5199184341039418,-5294116879,1722.1311535710197,565.9134947414829,1156.217658829537,0.7907631355053355,0.2983152579513156,-1053
1293,2020-07-17,2020,239578,239578,406336137.6500003,3677220.116666667,190072,0,46,0.8355065991034241,43633572,6025386948,640695,640693,356332961.45001036,3671366.5666663945,191363,0,46,0.3150578668477133,5335613033,-401117,-401115,50003176.199989915,5853.550000272691,-1291,0,0,0.5204487322557108,-5291979461,1696.0494605097308,556.1680265743661,1139.8814339353648,0.7933616609204518,0.29868033931902077,-1291
1294,2020-07-18,2020,239620,239620,405839203.8833329,3679103.300000002,190133,0,45,0.8360529171187717,44895105,6018821690,648637,648637,355961459.40001035,3673943.199999794,191016,0,45,0.310919666932347,5331315455,-409017,-409017,49877744.48332256,5160.100000208244,-883,0,0,0.5251332501864248,-5286420350,1693.6783402192343,548.7837718169181,1144.894568402316,0.7934771721892997,0.294488288518848,-883
1295,2020-07-19,2020,237101,237101,405441311.9333338,3640517.1166666667,188716,0,54,0.836074078135478,44494990,6012389786,654497,654497,355804240.0000117,3635196.616666439,189551,0,54,0.30463546815341036,5337304488,-417396,-417396,49637071.93332213,5320.500000227708,-835,0,0,0.5314386099820676,-5292809498,1709.9941034973865,543.6300548360217,1166.364048661365,0.7959308480352255,0.28961324498049645,-835
1296,2020-07-20,2020,239867,239867,404444933.6666673,3705517.949999998,189832,0,45,0.837051365965306,44621119,5998337452,666766,666766,355396518.80001354,3701318.7833331004,190662,0,45,0.30266840240804943,5334761936,-426899,-426899,49048414.86665374,4199.166666897479,-830,0,0,0.5343829635572566,-5290140817,1686.1216160066506,533.0153589115425,1153.106257095108,0.7914052370688757,0.28595039339138467,-830
1297,2020-07-21,2020,240891,240891,404285968.2999996,3729319.6333333375,190730,0,44,0.8362039262571047,45327190,5993622240,670628,670628,355543953.11667067,3725259.433333137,191614,0,44,0.3022331307371533,5323305865,-429737,-429737,48742015.18332893,4060.2000002004206,-884,0,0,0.5339707955199514,-5277978675,1678.2942006965789,530.1656851737039,1148.128515522875,0.7917688913242918,0.28572323255217497,-884
1298,2020-07-22,2020,240732,240732,404179614.5666663,3729398.133333334,189743,0,28,0.8314806506820864,45190777,5990253785,678479,678479,355693836.30000865,3723307.833333169,190635,0,28,0.29665914494036616,5321588754,-437747,-437747,48485778.26665765,6090.300000164658,-892,0,0,0.5348215057417203,-5276397977,1678.960896626399,524.2517989503119,1154.7090976760871,0.7881918481963345,0.2809740610984275,-892
1299,2020-07-23,2020,238525,238525,404128758.93333375,3706872.0166666657,189079,0,24,0.8379331306990884,45229074,5989132169,686105,686105,355845299.41667557,3701455.516666469,190196,0,24,0.29365476129746904,5325373600,-447580,-447580,48283459.51665819,5416.500000196509,-1117,0,0,0.5442783694016193,-5280144526,1694.28260741362,518.6455417416803,1175.6370656719398,0.7927009747405932,0.27721121402700755,-1117
1300,2020-07-24,2020,242267,242267,403846240.7000002,3705994.3333333316,191053,0,23,0.8333780498375752,44864103,5985637993,697834,697834,355896965.7499962,3701147.8833331643,192086,0,23,0.2918330147284292,5328928533,-455567,-455567,47949274.95000404,4846.450000167359,-1033,0,0,0.541545035109146,-5284064430,1666.9469663635584,510.00232970877914,1156.9446366547793,0.7886051340050441,0.27526030545946456,-1033
1301,2020-07-25,2020,241331,241331,403576744.4999998,3731578.766666668,190247,0,47,0.832043956226097,44764725,5981577573,704709,704709,355985974.0333387,3725905.399999544,191224,0,47,0.2871397981294421,5333873521,-463378,-463378,47590770.466661096,5673.366667123977,-977,0,0,0.5449041580966548,-5289108796,1672.2954966415414,505.15315404420653,1167.1423425973348,0.7883239202588975,0.271351721065007,-977
1302,2020-07-26,2020,238842,238842,403613028.48333365,3690064.866666669,188114,0,50,0.8280830004773022,44978258,5980061757,710148,710148,356269466.8666603,3684510.216666585,189160,0,50,0.2806246021956049,5343641505,-471306,-471306,47343561.61667335,5554.650000084192,-1046,0,0,0.5474583982816973,-5298663247,1689.8745969441457,501.68340524321735,1188.1911917009284,0.7876085445608394,0.2663670108202797,-1046
1303,2020-07-27,2020,238407,238407,403608583.9333336,3706598.8666666695,188146,0,51,0.8312801218085033,44690624,5976603138,719897,719897,356470318.4666685,3701273.199999542,189162,0,52,0.2771424245412791,5347329407,-481490,-481490,47138265.46666509,5325.666667127516,-1016,0,-1,0.5541376972672243,-5302638783,1692.9393177773034,495.16850114206403,1197.7708166352393,0.7891798479071503,0.26276258964824134,-1016
1304,2020-07-28,2020,237222,237222,403272975.76666653,3714606.1333333314,187973,0,181,0.8370345077606632,44591922,5968549002,724575,724575,356550114.2833261,3708869.5666665724,189068,0,181,0.275943829141223,5339875266,-487353,-487353,46722861.48334044,5736.566666759085,-1095,0,0,0.5610906786194403,-5295283344,1699.981349818594,492.08172278001047,1207.8996270385835,0.7923927797590443,0.26093641099955145,-1095
1305,2020-07-29,2020,241451,241451,402986229.78333324,3757869.9666666654,191042,0,187,0.8343307751883394,45452722,5962928890,734946,734946,356610254.1166626,3751433.9166665412,192107,0,188,0.27597673842704057,5338633400,-493495,-493495,46375975.66667062,6436.050000124145,-1065,0,-1,0.5583540367612989,-5293180678,1669.0186819824032,485.2196679982783,1183.799013984125,0.7912247205437128,0.26138927213700053,-1065
1306,2020-07-30,2020,247234,247234,403148873.26666635,3777577.1000000006,194230,0,126,0.8289232063551133,45044702,5961899627,745977,745977,356998033.2999935,3771526.7999999323,195281,0,128,0.2763597269084704,5337436847,-498743,-498743,46150839.96667284,6050.300000068266,-1051,0,-2,0.552563479446643,-5292392145,1630.636859277714,478.56439715968924,1152.0724621180248,0.7856120112929451,0.2617788484095354,-1051
1307,2020-07-31,2020,249348,249348,402857753.9166662,3809427.9000000004,196467,0,101,0.8317492019186044,44935804,5953425665,757777,757777,357059439.4333271,3804338.0999998767,197494,0,101,0.2753857665249773,5333381670,-508429,-508429,45798314.48333913,5089.80000012368,-1027,0,0,0.5563634353936271,-5288445866,1615.6446168273505,471.19329226583426,1144.4513245615162,0.7879229029308437,0.26062284814661835,-1027
1308,2020-08-01,2020,251197,251197,402210563.13333344,3849905.283333328,198491,0,73,0.8384295990796078,45526299,5945149770,357523,357523,356878121.1500138,3845397.4666663483,199557,0,48,0.5939002525711664,5219512083,-106326,-106326,45332441.98331964,4507.816666979808,-1066,0,25,0.24452934650844138,-5173985784,1601.1758226942736,998.1962591218294,602.9795635724442,0.7901806152143537,0.5581654886538768,-1066
1309,2020-08-02,2020,241218,241218,402327543.0833337,3781852.6666666674,190269,0,39,0.8403684633816711,45642260,5949708750,324471,324469,357196624.90001166,3776890.749999747,191133,0,38,0.6293228054279087,5214311128,-83253,-83251,45130918.18332201,4961.916666920297,-864,0,1,0.2110456579537624,-5168668868,1667.9001694870767,1100.8651824982098,567.0349869888669,0.7887844190732035,0.5890603474578622,-864
1310,2020-08-03,2020,237962,237962,402717483.8166665,3756817.416666661,186514,0,40,0.8341962162025875,45144126,5961253454,318737,318737,357772850.3500086,3752285.499999585,187389,0,41,0.6263094651703403,5224378781,-80775,-80775,44944633.46665788,4531.916667075828,-875,0,-1,0.2078867510322473,-5179234655,1692.360476952902,1122.4704077343033,569.8900692185987,0.7837974130323329,0.5879110363716795,-875
1311,2020-08-04,2020,234269,234269,402858736.80000037,3749237.3333333284,184155,0,83,0.8371615535986401,44997468,5968890788,310580,310580,358088215.11667866,3743036.1166663254,185055,0,83,0.6351600231824275,5233370463,-76311,-76311,44770521.683321714,6201.216667002998,-900,0,0,0.2020015304162126,-5188372995,1719.6416802906076,1152.9661121665229,566.6755681240847,0.7860835193730284,0.5958368214308712,-900
1312,2020-08-05,2020,243616,243616,403497762.8666667,3770404.783333336,190854,0,38,0.833693189281492,44867205,5979568163,317555,317555,358943696.13334507,3765816.866666351,191781,0,38,0.6435452126403226,5244157381,-73939,-73939,44554066.73332161,4587.916666985024,-927,0,0,0.19014797664116945,-5199290176,1656.2859699964972,1130.335520251122,525.9504497453752,0.7834214501510574,0.603930027869188,-927
1313,2020-08-06,2020,249614,249614,403748544.7666673,3860864.2999999956,195204,0,29,0.8326536171849341,44600348,5979665785,326330,326330,359451034.0500135,3855216.8666663216,196183,0,31,0.641157723776543,5249496594,-76716,-76716,44297510.716653824,5647.43333367398,-979,0,-2,0.19149589340839113,-5204896246,1617.49158607557,1101.4955230901649,515.9960629854052,0.7820234441978414,0.601179787331842,-979
1314,2020-08-07,2020,254255,254255,404439771.66666734,3876454.233333333,197986,0,23,0.8266346777841133,44450486,5985955633,331465,331465,360496041.78334475,3870297.0333330245,198948,0,23,0.6388879670553377,5255773210,-77210,-77210,43943729.8833226,6157.200000308454,-962,0,0,0.18774671072877558,-5211322724,1590.685617457542,1087.5840338598184,503.1015835977237,0.7786906845489764,0.6002081667747726,-962
1315,2020-08-08,2020,252173,252173,404817870.0000003,3862767.5833333344,196950,0,37,0.8320557712364124,44346827,5988352826,334698,334698,361017821.1833463,3856561.3999996083,198030,0,37,0.6324985509324836,5262720531,-82525,-82525,43800048.81665403,6206.183333726134,-1080,0,0,0.19955722030392875,-5218373704,1605.3180554619262,1078.6375215368669,526.6805339250593,0.7810114484897273,0.5916677123854938,-1080
1316,2020-08-09,2020,252259,252259,405184757.73333406,3831726.6499999994,196783,0,29,0.8305114981031404,44595944,5995176617,334549,334549,361565265.5833467,3826230.2166663557,197745,0,29,0.6315636872326618,5273682667,-82290,-82290,43619492.14998734,5496.433333643712,-962,0,0,0.19894781087047864,-5229086723,1606.2251802050039,1080.7542858694742,525.4708943355297,0.7800831684895286,0.5910793336701051,-962
1317,2020-08-10,2020,245060,245060,405582966.4333333,3754436.4166666633,191817,0,196,0.8314331184199785,44943745,6006902664,332176,332176,362051591.9166825,3749891.1166662974,192825,0,196,0.617446775203505,5284787954,-87116,-87116,43531374.516650796,4545.3000003658235,-1008,0,0,0.21398634321647347,-5239844209,1655.0353645365758,1089.9390441112016,565.0963204253742,0.7827348404472374,0.5804904628871441,-1008
1318,2020-08-11,2020,244494,244494,405306082.85000044,3767663.6166666653,192052,0,303,0.8353701931335753,45671672,6014489265,326829,326829,361863505.38334775,3763198.1666663047,192938,0,304,0.6290108894865517,5293073383,-82335,-82335,43442577.46665269,4465.450000360608,-886,0,-1,0.2063593036470236,-5247401711,1657.7342709841569,1107.1952164078089,550.539054576348,0.7855080288268833,0.5903331711690211,-886
1319,2020-08-12,2020,246397,246397,405942257.8333336,3821473.8666666695,193152,0,222,0.8344906796754824,46007775,6022676140,323670,323670,362629366.9000075,3815529.7666663514,194135,0,224,0.6390953749189048,5302672010,-77273,-77273,43312890.933326125,5944.10000031814,-983,0,-2,0.19539530475657763,-5256664235,1647.5129885239414,1120.3675561528948,527.1454323710466,0.7839056482018856,0.5997929990422344,-983
1320,2020-08-13,2020,248763,248763,406582251.64999986,3844080.233333337,193902,0,122,0.8311324433295951,45402110,6030965326,327061,327061,363478537.75000834,3839198.149999676,194892,0,122,0.6359455881318709,5311999388,-78298,-78298,43103713.89999151,4882.083333661314,-990,0,0,0.19518685519772427,-5266597278,1634.4160974501829,1111.3478456618438,523.068251788339,0.7794647917897758,0.5958888403080771,-990
1321,2020-08-14,2020,251964,251964,407236499.7166671,3874317.8833333333,195324,0,57,0.8253440967757294,44373122,6039552045,330148,330148,364334695.28334415,3869794.2166662477,196194,0,57,0.6340520009208043,5319335374,-78184,-78184,42901804.433322966,4523.666667085607,-870,0,0,0.19129209585492513,-5274962252,1616.2487486969055,1103.5496058838587,512.6991428130468,0.7752059818069248,0.5942607557822552,-870
1322,2020-08-15,2020,250240,250240,407791349.46666604,3881117.9833333394,194220,0,105,0.8255195012787723,44100754,6048060096,331469,331469,365026517.71667653,3875927.8999996297,195036,0,105,0.6270691980245479,5328013624,-81229,-81229,42764831.74998951,5190.083333709743,-816,0,0,0.1984503032542244,-5283912870,1629.6009809249763,1101.2387816558307,528.3621992691455,0.7761349104859335,0.5883989151323351,-816
1323,2020-08-16,2020,258905,258905,408584705.81666636,3959350.3833333347,200762,0,243,0.8300689442073345,44853946,6055925187,338082,338082,366052299.48332554,3953689.4833331206,201742,0,246,0.6403091557669381,5339047388,-79177,-79177,42532406.33334082,5660.900000214111,-980,0,-3,0.18975978844039632,-5294193442,1578.1259760014923,1082.7322941869888,495.39368181450345,0.7754272802765493,0.5967250548683456,-980
1324,2020-08-17,2020,253417,253417,409073275.08333284,3914241.200000004,196686,0,90,0.827059747372908,44570205,6066179358,340939,340939,366697073.4333478,3909499.6499996623,197603,0,90,0.6190227577367222,5352689713,-87522,-87522,42376201.649985015,4741.550000341609,-917,0,0,0.20803698963618578,-5308119508,1614.229807326789,1075.5503871171904,538.6794202095984,0.7761357762107515,0.5795846177762004,-917
1325,2020-08-18,2020,251082,251082,409490803.9999999,3885768.833333337,195137,0,39,0.8246150659943765,44228611,6074280109,332780,332780,367341046.183342,3881033.7999997446,195930,0,39,0.6259991586032784,5359229711,-81698,-81698,42149757.8166579,4735.0333335925825,-793,0,0,0.19861590739109813,-5315001100,1630.9046606287982,1103.8555387443416,527.0491218844566,0.7771843461498634,0.5887673538073201,-793
1326,2020-08-19,2020,254174,254174,409995737.70000076,3924081.0166666624,197446,0,144,0.8263945171418007,44760217,6080793908,335582,335582,368017303.53334606,3919026.283332926,198369,0,144,0.6302334451788275,5370280957,-81408,-81408,41978434.166654706,5054.733333736192,-923,0,0,0.19616107196297317,-5325520740,1613.0514438927694,1096.6538835019342,516.3975603908352,0.7768143083084816,0.5911193091405379,-923
1327,2020-08-20,2020,254541,254541,410511379.6333335,3931762.9166666646,196883,0,83,0.8242837106792236,45258523,6091238061,335538,335538,368644372.66667753,3925773.083333148,197804,0,83,0.6291656980729456,5378642676,-80997,-80997,41867006.96665597,5989.833333516493,-921,0,0,0.19511801260627792,-5333384153,1612.751500282208,1098.6665375208695,514.0849627613386,0.7734824645145576,0.5895129612741329,-921
1328,2020-08-21,2020,251033,251033,410423424.0333334,3923263.1166666644,195144,0,38,0.828313408994036,45192451,6090008167,332813,332813,368750447.683342,3917845.3833330516,195987,0,39,0.6283889150964779,5379621840,-81780,-81780,41672976.34999144,5417.733333612792,-843,0,-1,0.19992449389755818,-5334429389,1634.9381317728482,1107.9809012368567,526.9572305359916,0.7773639322320173,0.5888802420578523,-843
1329,2020-08-22,2020,253753,253753,410968776.3000002,3935320.35,196712,0,25,0.8305320528230209,46255854,6098760195,334318,334318,369370343.31667566,3929135.699999664,197651,0,25,0.6344049677253442,5388022608,-80565,-80565,41598432.98332453,6184.650000336114,-939,0,0,0.19612708509767673,-5341766754,1619.562236899663,1104.8473109933527,514.7149259063103,0.7752105393827856,0.5912065757751602,-939
1330,2020-08-23,2020,254798,254798,411449326.1333337,3955501.816666666,198078,0,69,0.8349555334029323,45997368,6108070267,335116,335116,370037541.2166777,3950983.166666301,198893,0,69,0.6382864440969757,5397990527,-80318,-80318,41411784.91665596,4518.650000364985,-815,0,0,0.1966690893059566,-5351993159,1614.8059487646437,1104.2073228872323,510.59862587741145,0.7773922872236045,0.5935049356043878,-815
1331,2020-08-24,2020,251954,251954,411954488.8333332,3936872.6333333366,194825,0,88,0.8290005318431141,45234753,6119000359,335675,335675,370665519.03334546,3931419.183332977,195627,0,88,0.6257659938928983,5410136969,-83721,-83721,41288969.79998773,5453.450000359677,-802,0,0,0.20323453795021573,-5364902216,1635.0384944606285,1104.239276184838,530.7992182757905,0.7732562293116998,0.5827869218738363,-802
1332,2020-08-25,2020,245061,245061,412319008.1499991,3881496.133333334,191602,0,37,0.8384402250868147,44756217,6127766864,325022,325022,371141150.6166774,3876255.583332916,192416,0,37,0.6358400354437613,5419729381,-79961,-79961,41177857.53332168,5240.550000417978,-814,0,0,0.20260018964305337,-5374973164,1682.5158150419654,1141.8954735884874,540.620341453478,0.781854313823905,0.5920091563032657,-814
1333,2020-08-26,2020,246619,246619,412322915.39999974,3846069.8000000003,194015,0,50,0.8405962233242371,44528075,6130886376,325022,325022,371213822.5333473,3840842.216666188,194905,0,50,0.6417873251656839,5428139457,-78403,-78403,41109092.86665243,5227.583333812188,-890,0,0,0.19880889815855318,-5383611382,1671.9024706125633,1142.1190643505588,529.7834062620045,0.7866993216256655,0.5996670994578829,-890
1334,2020-08-27,2020,246859,246859,412510543.5666673,3838305.3833333356,193381,0,26,0.8341401366772121,44171788,6136386400,326962,326962,371524784.6666836,3833737.3999998868,194190,0,21,0.6332570757458018,5435237335,-80103,-80103,40985758.899983704,4567.983333448879,-809,0,5,0.20088306093141028,-5391065547,1671.0370841924635,1136.293467334686,534.7436168577774,0.7833662131014061,0.593922229494559,-809
1335,2020-08-28,2020,254138,254138,413136643.8333332,3927710.8833333286,196874,0,28,0.8276448228915008,44184715,6142639371,330328,330328,372267869.26667464,3922701.4833329944,197527,0,28,0.639412947131335,5436262081,-76190,-76190,40868774.56665856,5009.400000334252,-653,0,0,0.18823187576016576,-5392077366,1625.6389986280415,1126.9643180919409,498.6746805361006,0.7746736025309084,0.5979723184229009,-653
1336,2020-08-29,2020,250920,250920,413157886.98333347,3939093.2833333313,194301,0,38,0.8296150167384021,43932063,6143915169,331268,331268,372490157.5166771,3934269.6499995925,194873,0,38,0.6307611963727222,5445506716,-80348,-80348,40667729.46665639,4823.633333738893,-572,0,0,0.1988538203656799,-5401574653,1646.5721623757909,1124.4374872208516,522.1346751549393,0.7743543758967002,0.5882638830191869,-572
1337,2020-08-30,2020,254097,254097,413615923.1666666,3902194.5500000003,197216,0,40,0.8294273446754585,43899058,6150417099,333744,333744,372962256.7666778,3896979.1666662777,197999,0,40,0.6347679658660559,5449811665,-79647,-79647,40653666.39998883,5215.383333722595,-783,0,0,0.19465937880940265,-5405912607,1627.787510937424,1117.5099979825188,510.2775129549052,0.7761445432256185,0.5932660961695192,-783
1338,2020-08-31,2020,257337,257337,414033457.35000014,3957155.18333333,198720,0,63,0.8302692578214552,44064622,6156421606,342124,342124,373518739.3500154,3952174.6166663277,199429,0,63,0.6273982532648944,5457642959,-84787,-84787,40514717.99998474,4980.56666700216,-709,0,0,0.20287100455656082,-5413578337,1608.9153808041601,1091.7642122447282,517.1511685594319,0.7722169761829818,0.5829143819200057,-709
1339,2020-09-01,2020,260362,260362,414390715.46666634,4083947.483333336,201228,0,51,0.833961945291555,44204874,6157221195,341962,341962,373984722.33334506,4078843.866666509,201867,0,51,0.6376995104719277,5463156039,-81600,-81600,40405993.133321285,5103.616666827351,-639,0,0,0.19626243481962724,-5418951165,1591.5944548999714,1093.6440959327208,497.9503589672506,0.772877762499904,0.590319977073476,-639
1340,2020-09-02,2020,265725,265725,415210359.0000002,4057109.3333333284,203563,0,131,0.8276300686800266,44236621,6166793125,347395,347395,374940167.4166821,4051478.9499996956,204212,0,131,0.6356050029505323,5468817946,-81670,-81670,40270191.583318055,5630.3833336327225,-649,0,0,0.1920250657294943,-5424581325,1562.5566243296648,1079.2906271439776,483.2659971856872,0.7660664220528742,0.5878380517854316,-649
1341,2020-09-03,2020,260914,260914,415213001.65000045,4004893.6333333324,200731,0,230,0.8264830557195084,44263530,6149758299,350796,350795,375161372.0833458,3999793.766666335,201547,0,232,0.6180372638228563,5460298927,-89882,-89881,40051629.56665468,5099.866666997317,-816,0,-2,0.20844579189665213,-5416035397,1591.3787748070263,1069.4604315436245,521.9183432634018,0.7693377894631948,0.5745418989954275,-816
1342,2020-09-04,2020,269148,269148,416099946.61666656,4097490.2166666677,205913,0,180,0.8187651403688677,44493114,6161179712,351754,351754,376133273.0666758,4093505.249999539,206448,0,180,0.6287689692228028,5465470252,-82606,-82606,39966673.54999077,3984.966667128727,-535,0,0,0.18999617114606493,-5420977138,1545.9893687364074,1069.307735140683,476.6816335957244,0.7650549140249974,0.5869101701757479,-535
1343,2020-09-05,2020,270532,270532,416453925.23333365,4135720.2166666663,206658,0,180,0.8223685183268533,44475094,6167990713,357676,357676,376554404.0166798,4131169.0666662687,207308,0,180,0.6244478242878939,5476458678,-87144,-87144,39899521.216653824,4551.150000397582,-650,0,0,0.1979206940389594,-5431983584,1539.38877926949,1052.780740157796,486.6080391116941,0.7638948442328449,0.5795971773336763,-650
1344,2020-09-06,2020,268949,268949,417119126.75,4129140.066666668,206664,0,150,0.8283466382102178,44357207,6174935954,356193,356193,377380575.1166761,4124523.566666482,207399,0,150,0.6282605216834706,5485303446,-87244,-87244,39738551.63332391,4616.500000185799,-735,0,0,0.20008611652674724,-5440946239,1550.9227650967284,1059.4834124103395,491.43935268638893,0.7684133423065339,0.5822657941060043,-735
1345,2020-09-07,2020,267581,267581,417562776.39999956,4052377.4666666742,205012,0,80,0.8218782350017375,45018209,6184277146,359319,359319,377911694.4166787,4047749.149999629,205778,0,79,0.6151720337638735,5497499758,-91738,-91738,39651081.98332083,4628.316667045467,-766,0,1,0.20670620123786398,-5452481549,1560.509813477039,1051.74425626443,508.7655572126089,0.766168001464977,0.5726888920430036,-766
1346,2020-09-08,2020,259682,259682,417626445.3166653,4014474.0500000035,196369,0,84,0.813221555594919,45035099,6188571343,350232,350232,378117037.4666798,4009481.833332931,197090,0,84,0.6059469151876484,5502546952,-90550,-90550,39509407.84998548,4992.216667072382,-721,0,0,0.20727464040727062,-5457511853,1608.2225387846108,1079.6187597554758,528.603779029135,0.7561902634760976,0.562741268644784,-721
1347,2020-09-09,2020,261137,261137,418258263.6333333,4034282.766666665,198758,0,33,0.8175976594661032,44460015,6194211927,343052,343052,378805997.46667814,4030007.566666416,199315,0,26,0.6247944917971673,5507784281,-81915,-81915,39452266.16665518,4275.200000249315,-557,0,7,0.1928031676689359,-5463324266,1601.6813535934523,1104.2232590589128,497.45809453453944,0.7611253862914868,0.5810052120378252,-557
1348,2020-09-10,2020,259324,259324,418932482.88333327,4013825.88333333,196041,0,40,0.8103569280128333,45262181,6202182226,341938,341938,379625591.7000109,4010069.8333329023,196693,0,40,0.6170650819739235,5516202593,-82614,-82614,39306891.18332237,3756.0500004277565,-652,0,0,0.1932918460389098,-5470940412,1615.4790257875602,1110.217617521337,505.26140826622327,0.7559693665067637,0.5752300124583989,-652
1349,2020-09-11,2020,255748,255748,419044180.8833338,3959396.400000005,197130,0,38,0.8301374790809696,46226386,6209303121,340834,340834,379775588.1666749,3955015.9333328456,197905,0,33,0.62646038834154,5522453117,-85086,-85086,39268592.71665889,4380.4666671594605,-775,0,5,0.20367709073942952,-5476226731,1638.5042341810447,1114.253824931418,524.2504092496267,0.7707978166007163,0.5806492310039492,-775
1350,2020-09-12,2020,253486,253486,418868589.91666687,3945206.833333332,196517,0,44,0.8303141001869925,46342960,6207806710,338083,338083,379748586.9000139,3939945.3166662324,197310,0,33,0.6258788522344991,5528637076,-84597,-84597,39120003.01665294,5261.51666709967,-793,0,11,0.20443524795249335,-5482294116,1652.4328361987127,1123.2407039100278,529.1921322886849,0.7752578051647823,0.5836140829322977,-793
1351,2020-09-13,2020,252692,252692,419289023.7166665,3927469.100000001,195178,0,35,0.8277863960869352,46306071,6219973094,334518,334518,380221025.56667423,3923137.949999485,196066,0,35,0.6291948415332006,5536335510,-81826,-81826,39067998.14999229,4331.15000051586,-888,0,0,0.19859155455373456,-5490029439,1659.288872289849,1136.6235167215941,522.6653555682549,0.7723948522311747,0.5861149474766679,-888
1352,2020-09-14,2020,257956,257956,419956982.98333323,3988588.500000003,196325,0,27,0.8176743320566295,46243513,6232723496,346861,346861,380973591.3500196,3989332.8499994827,199595,0,25,0.6187608292658956,5548614437,-88905,-88905,38983391.633313656,-744.3499994799495,-3270,0,2,0.19891350279073394,-5502370924,1628.0178905834066,1098.3465749969573,529.6713155864493,0.7610794088914389,0.5754322336613226,-3270
1353,2020-09-15,2020,260448,260448,420389001.16666675,3992888.2000000025,196635,0,30,0.8154871605848387,46565974,6239412323,347871,347871,379888060.51667655,3988587.699999565,197335,0,30,0.6133969201226903,5507711413,-87423,-87423,40500940.6499902,4300.500000437722,-700,0,0,0.2020902404621484,-5461145439,1614.0995560214199,1092.037164686555,522.062391334865,0.7549875598967932,0.5672648769227674,-700
1354,2020-09-16,2020,262362,262362,421038654.38333416,3992684.916666668,199951,0,29,0.8206447580061139,46335024,6251150541,346870,346870,380558214.9166775,3988100.4499995233,200594,0,31,0.6233026782368075,5510119014,-84508,-84508,40480439.466656685,4584.466667144559,-643,0,-2,0.1973420797693064,-5463783990,1604.8004451228994,1097.12057807443,507.67986704846953,0.7621187519534078,0.5782973448265921,-643
1355,2020-09-17,2020,254798,254798,421399692.88333315,3981613.5666666664,195291,0,101,0.8254421149302588,46882858,6258517111,342269,342269,381045568.66667736,3977349.1166661372,195851,0,101,0.6167634229217354,5520271331,-87471,-87471,40354124.21665579,4264.4500005291775,-560,0,0,0.2086786920085234,-5473388473,1653.8579301381217,1113.292669411128,540.5652607269938,0.7664542107865839,0.5722136681966523,-560
1356,2020-09-18,2020,253834,253834,421636469.6333335,3969218.4166666656,195194,0,29,0.8251179904977256,47243212,6266733993,336523,336523,381400468.35001004,3964955.7999994582,195924,0,31,0.6253539876917797,5530549661,-82689,-82689,40236001.28332347,4262.6166672073305,-730,0,-2,0.19976400280594586,-5483306449,1661.0716831997822,1133.3563184388884,527.7153647608939,0.7689828785741862,0.58220091940224,-730
1357,2020-09-19,2020,257564,257564,422071033.51666665,4031454.733333336,197010,0,32,0.8193109285459144,47269975,6274838622,337435,337435,381942316.26667595,4026484.0999994054,197676,0,32,0.6280765184405886,5539714765,-79871,-79871,40128717.2499907,4970.633333930746,-666,0,0,0.19123441010532571,-5492444790,1638.7035203548114,1131.898932436398,506.8045879184135,0.7648972682517743,0.5858194911612606,-666
1358,2020-09-20,2020,255154,255154,422558073.43333286,3941337.8833333333,195606,0,133,0.8203359539728939,47207424,6285081892,336649,336649,382517773.71667767,3937225.299999469,196155,0,133,0.624190180276789,5550663588,-81495,-81495,40040299.716655195,4112.583333864342,-549,0,0,0.19614577369610497,-5503456164,1656.0903353791548,1136.251032133402,519.8393032457527,0.766619374965707,0.582669189571334,-549
1359,2020-09-21,2020,254103,254103,423157503.4166666,3940057.250000008,193124,0,219,0.8225444012860929,47019877,6298243500,340955,340955,383143973.0166798,3935731.049999778,193677,0,219,0.6151750230968953,5561548313,-86852,-86852,40013530.3999868,4326.200000229757,-553,0,0,0.20736937818919754,-5514528436,1665.2991244364162,1123.7376575110493,541.5614669253669,0.7600225105567427,0.5680427035825842,-553
1360,2020-09-22,2020,257370,257370,423867133.6999999,3971738.6833333327,195724,0,48,0.8220305396899404,47728715,6309503930,337822,337822,384014200.3000171,3967181.2833330836,196262,0,48,0.6284789030909796,5576258318,-80452,-80452,39852933.39998281,4557.400000249036,-538,0,0,0.1935516365989608,-5528529603,1646.9174095659941,1136.7353230399947,510.18208652599947,0.7604771340871119,0.5809627555339795,-538
1361,2020-09-23,2020,252524,252524,424528607.9000004,3969348.3166666725,194168,0,32,0.829445914051733,48324942,6319430392,334101,334101,384656211.6833401,3965927.7833328415,194600,0,32,0.6287230508139796,5586004440,-81577,-81577,39872396.21666032,3420.533333831001,-432,0,0,0.20072286323775335,-5537679498,1681.1416257464653,1151.3171516497707,529.8244740966945,0.7689090937891052,0.5824585978491534,-432
1362,2020-09-24,2020,252014,252014,424858957.616667,3959741.766666672,195403,0,27,0.8382232733102128,47798493,6325897879,331685,331685,385132974.4333449,3955958.766666272,195939,0,27,0.6392299923119863,5599236365,-79671,-79671,39725983.18332207,3783.000000400003,-536,0,0,0.19899328099822655,-5551437872,1685.8545859224764,1161.1407643798932,524.7138215425832,0.7753656542890475,0.5907382004009829,-536
1363,2020-09-25,2020,249174,249174,425410959.00000024,3922613.5500000007,192755,0,130,0.8342764493887811,47236681,6336122473,328795,328795,385832844.7500139,3918470.3666662117,193271,0,130,0.6346629358718918,5611192003,-79621,-79621,39578114.24998635,4143.183333788998,-516,0,0,0.19961351351688927,-5563955322,1707.2847046642114,1173.4754018461774,533.809302818034,0.7735758947562748,0.5878161164251281,-516
1364,2020-09-26,2020,246688,246688,425309822.01666725,3901247.0666666655,191145,0,36,0.8322496432740949,47608983,6339260613,326125,326125,385794514.86667717,3896358.816666135,191726,0,36,0.6322177079340753,5620709904,-79437,-79437,39515307.14999008,4888.250000530388,-581,0,0,0.20003193534001962,-5573100921,1724.0798985628294,1182.9651663217392,541.1147322410902,0.7748451485276949,0.5878911460329628,-581
1365,2020-09-27,2020,247608,247608,425836018.38333356,3889786.1500000036,191291,0,32,0.8292300733417336,47437000,6351337999,326210,326210,386472741.7666811,3885658.3333328036,191898,0,30,0.6319947273228816,5627548134,-78602,-78602,39363276.61665249,4127.816667200066,-607,0,2,0.19723534601885195,-5580111134,1719.799111431511,1184.7360343541923,535.0630770773187,0.7725558140286259,0.5882652279206646,-607
1366,2020-09-28,2020,251848,251848,426544537.26666653,3933707.5999999973,193329,0,39,0.8262602839808144,47444063,6365030022,330594,330594,387270818.5500108,3928990.8999997526,193997,0,41,0.6322256302292226,5641547043,-78746,-78746,39273718.71665573,4716.700000244658,-668,0,-2,0.1940346537515918,-5594102980,1693.6586245142566,1171.4393441805078,522.2192803337489,0.7676415933420159,0.5868134327906738,-668
1367,2020-09-29,2020,249810,249810,426655485.5,3905638.2499999967,193647,0,39,0.8358072134822467,47217176,6371751720,329307,329307,387469360.8333424,3900839.816666212,194351,0,39,0.6369983024958414,5652587271,-79497,-79497,39186124.66665763,4798.4333337848075,-704,0,0,0.1988089109864053,-5605370095,1707.9199611704896,1176.620481293572,531.2994798769175,0.775177134622313,0.590181806035098,-704
1368,2020-09-30,2020,244628,244628,426555274.1166665,3837067.449999995,190259,0,26,0.8414531451837083,47465341,6378207040,326175,326175,387489496.4000147,3832503.3999994583,191071,0,26,0.6347819422089355,5663694176,-81547,-81547,39065777.7166518,4564.050000536721,-812,0,0,0.20667120297477282,-5616228835,1743.6894963645473,1187.980367594128,555.7091287704193,0.7777482544925356,0.5857929025829692,-812
1369,2020-10-01,2020,237785,237785,426565377.566667,3777975.5999999987,184684,0,40,0.8376768929915684,47798015,6387034863,317516,317516,387569716.5166839,3773545.2999995025,185306,0,40,0.6302013126897563,5671105609,-79731,-79731,38995661.049983144,4430.300000496209,-622,0,0,0.20747558030181212,-5623307594,1793.9120531853018,1220.6305084363744,573.2815447489274,0.7766848203208782,0.5836115345368422,-622
1370,2020-10-02,2020,246511,246511,426864634.78333366,3859004.500000001,189541,0,33,0.8336382554936704,48166117,6395758132,321777,321777,388019990.71667695,3854895.8499994967,190227,0,33,0.6418793139348137,5680350871,-75266,-75266,38844644.06665671,4108.650000504218,-686,0,0,0.19175894155885675,-5632184754,1731.6250990151907,1205.8661455501076,525.7589534650831,0.7688946943544102,0.591176498009491,-686
1371,2020-10-03,2020,250609,250609,427227881.8333327,3900206.683333331,191077,0,32,0.828844933741405,48982865,6408005981,327009,327009,388390643.5500116,3895027.266666177,191733,0,33,0.6380344271870279,5689069943,-76400,-76400,38837238.28332114,5179.416667153593,-656,0,-1,0.19081050655437715,-5640087078,1704.7587350547376,1187.7062819372297,517.0524531175079,0.762450670167472,0.5863233122024164,-656
1372,2020-10-04,2020,248922,248922,427406811.69999987,3839366.48333333,190174,0,255,0.8308626798756236,49728174,6416619305,330891,330891,388690182.2500117,3833684.6999997026,190900,0,255,0.628282425330406,5703636009,-81969,-81969,38716629.44998819,5681.783333627507,-726,0,0,0.20258025454521755,-5653907835,1717.0310848378201,1174.6774081193253,542.3536767184949,0.7639903262869493,0.5769271451928278,-726
1373,2020-10-05,2020,244774,244774,427623412.68333334,3835706.116666669,189103,0,77,0.8338794152973759,49472376,6430719217,332950,332950,388959006.5333413,3830908.4999995716,189829,0,77,0.6162486859888909,5717726374,-88176,-88176,38664406.14999205,4797.616667097434,-726,0,0,0.21763072930848493,-5668253998,1747.0132149792598,1168.2204731441395,578.7927418351203,0.7725616282775132,0.5701426640636732,-726
1374,2020-10-06,2020,241809,241809,428075334.383334,3870662.799999998,186227,0,80,0.8312924663680836,49778589,6438705284,318189,318189,389577707.1833435,3866319.249999516,186966,0,81,0.6349245259892682,5731456058,-76380,-76380,38497627.19999045,4343.550000481773,-739,0,-1,0.19636794037881544,-5681677469,1770.3035634874384,1224.3594441773396,545.9441193100988,0.7701408963272666,0.5875941657316878,-739
1375,2020-10-07,2020,246697,246697,428940643.9166671,3906336.2333333367,191143,0,88,0.8419599751922409,49710588,6453169201,320468,320468,390449815.916677,3901526.0999996504,191904,0,88,0.651634484566326,5739675380,-73771,-73771,38490827.999990106,4810.1333336862735,-761,0,0,0.19032549062591486,-5689964792,1738.7347390388497,1218.373803052651,520.3609359861987,0.7748087735156893,0.5988242195788659,-761
1376,2020-10-08,2020,243374,243374,429531556.01666725,3908079.7666666685,188245,0,107,0.8395391455126677,49696247,6464635753,319368,319368,391157773.0000155,3903061.749999502,188982,0,108,0.6434865108589403,5753781731,-75994,-75994,38373783.01665175,5018.016667166259,-737,0,-1,0.19605263465372746,-5704085484,1764.9032189825834,1224.7869949400551,540.1162240425283,0.7734803224666562,0.5917374314270685,-737
1377,2020-10-09,2020,253948,253948,429890182.3999998,3922791.283333332,196538,0,252,0.8400263045977918,49763625,6473067964,329880,329880,391652723.56667805,3917749.349999548,197304,0,254,0.6503182975627438,5767005816,-75932,-75932,38237458.83332175,5041.933333783876,-766,0,-2,0.18970800703504798,-5717242191,1692.8275962007963,1187.2581652924641,505.56943090833215,0.77393009592515,0.5981084030556566,-766
1378,2020-10-10,2020,245908,245908,429700059.0666669,3862197.116666673,189805,0,187,0.8328602566813593,48378359,6475766505,330496,330496,391427555.03334427,3858725.5999995586,190479,0,187,0.6226338594113111,5776099624,-84588,-84588,38272504.03332263,3471.5166671145707,-674,0,0,0.21022639727004822,-5727721265,1747.4017074136136,1184.3639712230836,563.03773619053,0.7718537013842576,0.5763428301704105,-674
1379,2020-10-11,2020,248804,248804,429827809.21666676,3810419.699999997,191596,0,77,0.8322052700117363,49886156,6487672413,327836,327836,391600495.9500128,3805629.6999995005,192163,0,77,0.6344666235556794,5783307700,-79032,-79032,38227313.266653955,4790.000000496395,-567,0,0,0.19773864645605688,-5733421544,1727.5759602605535,1194.5012016679461,533.0747585926074,0.7700680053375347,0.5861558828194585,-567
1380,2020-10-12,2020,242814,242814,429428679.01666737,3780000.016666663,186337,0,52,0.8309982126236535,49721445,6472087210,327367,327367,391543385.36667395,3776396.8333328785,187218,0,52,0.6203252007685549,5773005801,-84553,-84553,37885293.64999342,3603.183333784342,-881,0,0,0.21067301185509857,-5723284356,1768.549914818204,1196.0380409958057,572.5118738223982,0.7674063274769989,0.571890263832335,-881
1381,2020-10-13,2020,239210,239210,429554636.55000025,3756789.4333333266,183833,0,61,0.8347142677981689,50223615,6483833745,318169,318169,391709512.98334455,3752567.1333328937,184564,0,61,0.6310011346171436,5783489660,-78959,-78959,37845123.566655695,4222.300000432879,-731,0,0,0.20371313318102535,-5733266045,1795.7219035575447,1231.1366380236432,564.5852655339015,0.7685004807491326,0.58008165471809,-731
1382,2020-10-14,2020,241439,241439,430017874.3666667,3788435.3833333375,186349,0,77,0.8368780520131375,50707738,6496262943,318268,318268,392224011.6333431,3783577.833332918,187201,0,78,0.6385216232860396,5795706514,-76829,-76829,37793862.733323574,4857.550000419375,-852,0,-1,0.1983564287270979,-5744998776,1781.0621911400672,1232.3702402797112,548.691950860356,0.771826424065706,0.5881866854349165,-852
1383,2020-10-15,2020,244717,244717,430671723.56666636,3828230.366666668,189410,0,86,0.8391407217316327,50404415,6510425000,321439,321439,392886105.8500146,3824024.966666205,190219,0,86,0.6425200426830687,5809097676,-76722,-76722,37785617.71665174,4205.40000046324,-809,0,0,0.19662067904856395,-5758693261,1759.8766067198696,1222.27267335331,537.6039333665597,0.7739960852740104,0.5917732446902834,-809
1384,2020-10-16,2020,247249,247249,431069404.16666645,3847432.033333333,191508,0,77,0.8404078479589399,50673803,6519006837,324689,324689,393318326.6833389,3842347.0166662266,192354,0,77,0.6438099227260542,5818107582,-77440,-77440,37751077.48332757,5085.0166671066545,-846,0,0,0.19659792523288566,-5767433779,1743.4626799973566,1211.3694233045742,532.0932566927825,0.7745552054811142,0.5924253670435401,-846
1385,2020-10-17,2020,243647,243647,431250769.7333338,3836987.3833333347,188800,0,73,0.8381510956424656,51172322,6530525964,323690,323690,393628680.8666754,3830986.9333328176,189430,0,73,0.6337792332169623,5830885687,-80043,-80043,37622088.86665845,6000.45000051707,-630,0,0,0.20437186242550331,-5779713365,1769.981857906454,1216.0668567662744,553.9150011401796,0.7748915439139411,0.5852204269517131,-630
1386,2020-10-18,2020,241395,241395,431442475.5500003,3808289.6833333313,187476,0,219,0.8394912902089932,50939992,6537379466,319071,319071,393955799.3666768,3804674.9999995106,188270,0,221,0.6392370350172814,5843603156,-77676,-77676,37486676.1833235,3614.6833338206634,-794,0,-2,0.2002542551917118,-5792663164,1787.2883678203787,1234.6963508644685,552.5920169559101,0.7766358043870005,0.5900567585270989,-794
1387,2020-10-19,2020,244564,244564,432090869.55000013,3841481.4833333306,188222,0,105,0.8316350730279197,51315360,6549859806,325005,325005,394719001.383348,3838794.549999523,189585,0,109,0.6313041337825619,5853694629,-80441,-80441,37371868.16665214,2686.933333807625,-1363,0,-4,0.20033093924535783,-5802379269,1766.780350133299,1214.501319620769,552.27903051253,0.7696226754550956,0.5833294872386579,-1363
1388,2020-10-20,2020,246103,246103,432535446.7499999,3833994.783333335,188755,0,37,0.82953072494037,51130472,6562084911,325679,325679,395175040.5333462,3829109.399999504,189628,0,37,0.6304981285253172,5863564063,-79576,-79576,37360406.216653705,4885.383333831094,-873,0,0,0.19903259641505278,-5812433591,1757.5382939257136,1213.388153775178,544.1501401505357,0.7669756159006594,0.582254305619951,-873
1389,2020-10-21,2020,245467,245467,432733196.3999997,3835132.5166666694,188565,0,61,0.8323970228177309,50786092,6572951954,324807,324807,395418964.3166821,3830330.9666662556,189308,0,61,0.6324740538227333,5874526428,-79340,-79340,37314232.08331758,4801.550000413787,-743,0,0,0.19992296899499762,-5823740336,1762.8976457120496,1217.3966826967464,545.5009630153031,0.7681887993090721,0.5828322665459796,-743
1390,2020-10-22,2020,240306,240306,432881267.10000074,3804346.4833333306,185618,0,126,0.8325842883656668,51069163,6582578999,320018,320018,395684327.6333437,3800083.866666235,186347,0,125,0.6283677793124152,5887220218,-79712,-79712,37196939.46665704,4262.616667095572,-729,0,1,0.20421650905325162,-5836151055,1801.3751928790823,1236.4439738806682,564.9312189984141,0.7724234933792747,0.5823016205338449,-729
1391,2020-10-23,2020,245377,245377,433139604.28333336,3817777.2666666717,189993,0,134,0.8359748468682884,50556955,6592639847,323405,323405,396039470.90001523,3813516.9666661704,190734,0,136,0.6375473477528099,5897865212,-78028,-78028,37100133.383318126,4260.300000501331,-741,0,-2,0.19842749911547852,-5847308257,1765.200504869378,1224.5929126018932,540.6075922674847,0.7742901738956789,0.5897682472441675,-741
1392,2020-10-24,2020,246281,246281,433144959.5666662,3827193.0500000054,189562,0,61,0.8281109789224507,50354298,6599454894,326786,326786,396049044.8666793,3823174.016666171,190349,0,61,0.6275789048490442,5906826026,-80505,-80505,37095914.699986875,4019.0333338342607,-787,0,0,0.20053207407340645,-5856471728,1758.7428976115339,1211.9523017102304,546.7905959013035,0.7696980278624823,0.5824882338900688,-787
1393,2020-10-25,2020,247693,247693,433775366.9999998,3872216.6333333342,189926,0,86,0.8244480062012256,50708152,6614016125,327188,327188,396694544.9666765,3867303.1333328616,190743,0,87,0.6275046762106182,5912286283,-79495,-79495,37080822.03332335,4913.500000472646,-817,0,-1,0.19694332999060737,-5861578131,1751.2621147953305,1212.436106968093,538.8260078272374,0.7667798444041616,0.5829767595388584,-817
1394,2020-10-26,2020,251649,251649,434785836.2333327,3904222.599999996,192168,0,87,0.8244578758508883,50451073,6630230951,330129,330129,397756797.0666784,3902805.366666163,193262,0,88,0.6327465929985036,5927220944,-78480,-78480,37029039.16665429,1417.23333383305,-1094,0,-1,0.1917112828523847,-5876769871,1727.7471248975069,1204.852639624748,522.8944852727589,0.7636350631236365,0.5854135807517667,-1094
1395,2020-10-27,2020,250881,250881,435494942.2333325,3853192.7333333353,190965,0,114,0.8228323388379354,50096189,6645147921,331882,331882,398469540.4666804,3848967.0166661595,191583,0,114,0.624468937754976,5937358798,-81001,-81001,37025401.76665211,4225.716667175759,-618,0,0,0.19836340108295936,-5887262609,1735.862589169098,1200.636191377298,535.2263977918001,0.7611776101020006,0.577262400491741,-618
1396,2020-10-28,2020,244863,244863,435543995.9666673,3817340.7166666663,187626,0,78,0.8270543120030384,49296369,6651123804,327557,327557,398573645.0166818,3812952.666666221,188294,0,78,0.6209789441227073,5951118247,-82694,-82694,36970350.949985504,4388.050000445452,-668,0,0,0.2060753678803311,-5901821878,1778.7252298904584,1216.8069832630101,561.9182466274483,0.7662488820279095,0.574843462359223,-668
1397,2020-10-29,2020,247005,247005,436168889.13333327,3863570.466666669,189750,0,88,0.8282544887755305,49833543,6663997461,325187,325187,399222975.10001093,3859528.9499995233,190408,0,88,0.6321900936999373,5957312356,-78182,-78182,36945914.033322334,4041.51666714577,-658,0,0,0.19606439507559326,-5907478813,1765.8302023575768,1227.6720013408005,538.1582010167763,0.7682030728122913,0.5855338620547562,-658
1398,2020-10-30,2020,250896,250896,436436928.9333329,3860495.283333336,193270,0,143,0.8372313627957403,50948365,6671024560,329087,329087,399549867.1166805,3856307.649999546,193927,0,145,0.6414473984083264,5972239607,-78191,-78191,36887061.81665242,4187.633333790116,-657,0,-2,0.19578396438741386,-5921291242,1739.5133000658955,1214.1162279782566,525.3970720876389,0.7703191760729545,0.5892879390556297,-657
1399,2020-10-31,2020,248316,248316,435092924.9499999,3793438.6666666693,188582,0,49,0.8187833244736544,50990859,6670121631,334065,334065,398455986.3333411,3788442.3833328965,189375,0,50,0.6119437833954411,5981791305,-85749,-85749,36636938.61665881,4996.283333772793,-793,0,-1,0.20683954107821334,-5930800446,1752.1743461959759,1192.7498730287252,559.4244731672507,0.7594436121715878,0.5668806968703696,-793
1400,2020-11-01,2020,245979,245979,434581591.4333333,3789402.6499999994,184715,0,43,0.8120286691140302,51142939,6672369787,330173,330173,398115488.8833451,3785880.6166661736,185657,0,44,0.6091352109348734,5983825036,-84194,-84194,36466102.54998815,3522.033333825879,-942,0,-1,0.20289345817915672,-5932682097,1766.7426545897547,1205.778452154916,560.9642024348386,0.7509380882107822,0.5623021870352815,-942
1401,2020-11-02,2020,244889,244889,434642293.3166671,3733008.400000001,183071,0,105,0.8097015382479401,50888379,6686186499,328726,328726,398267837.48334086,3729101.483332929,183833,0,105,0.6066663421816371,5987176334,-83837,-83837,36374455.83332622,3906.9166670716368,-762,0,0,0.20303519606630305,-5936287955,1774.854294462663,1211.5495503347495,563.3047441279134,0.7475672651691174,0.5592286585180363,-762
1402,2020-11-03,2020,239489,239489,433928515.71666646,3712600.800000006,179470,0,246,0.808667621477395,49710404,6686839248,324723,324723,397666555.8833456,3707989.2833328815,180198,0,248,0.5995602405742702,5997059692,-85234,-85234,36261959.833320856,4611.51666712435,-728,0,-2,0.20910738090312486,-5947349288,1811.8933049812997,1224.6331669864642,587.2601379948355,0.7493872369920956,0.5549283543204516,-728
1403,2020-11-04,2020,245911,245911,434102976.5000004,3742992.949999998,182210,0,232,0.7955154507118433,49807265,6694559542,325194,325194,397907735.43334985,3738403.4666661043,183029,0,228,0.6051649169418838,5999490532,-79283,-79283,36195241.06665057,4589.483333893586,-819,0,4,0.19035053376995947,-5949683267,1765.2849059212497,1223.6010979087862,541.6838080124635,0.7409591274892136,0.562830187518835,-819
1404,2020-11-05,2020,243323,243323,434133604.43333304,3740636.599999996,179706,0,226,0.7946186755875925,49825431,6701687732,324919,324919,398014471.3666795,3736924.8333328334,180440,0,226,0.5983614377737241,6006676389,-81596,-81596,36119133.06665355,3711.766667162534,-734,0,0,0.1962572378138684,-5956850958,1784.1864699733812,1224.9652109192737,559.2212590541076,0.738549171266177,0.5553384074184643,-734
1405,2020-11-06,2020,248679,248679,434385205.93333334,3766156.4,181430,0,99,0.7837412889709213,49857111,6712385526,330115,330115,398230413.6500102,3762024.099999558,182225,0,100,0.5941384063129602,6017957286,-81436,-81436,36154792.28332311,4132.300000441726,-795,0,-1,0.1896028826579611,-5968100175,1746.7707604314533,1206.338438574467,540.4323218569862,0.7295750746946867,0.552004604456023,-795
1406,2020-11-07,2020,236291,236291,434216892.8166663,3654254.566666669,174732,0,27,0.7929967709307594,49224068,6720258717,322689,322689,398146095.23334247,3650459.1833328633,175377,0,27,0.5837974024525161,6024592397,-86398,-86398,36070797.58332384,3795.3833338059485,-645,0,0,0.20919936847824327,-5975368329,1837.6361893456217,1233.83844888838,603.7977404572416,0.7394780165135363,0.5434861430045648,-645
1407,2020-11-08,2020,233345,233345,434054337.48333323,3613956.01666667,172355,0,29,0.7914632839786581,49084002,6726501877,316292,316292,398106475.3333417,3609160.749999525,173002,0,30,0.5868817421875987,6034474368,-82947,-82947,35947862.14999151,4795.266667144839,-647,0,-1,0.20458154179105936,-5985390366,1860.1398679351742,1258.6675456013486,601.4723223338256,0.7386273543465683,0.5469692562568765,-647
1408,2020-11-09,2020,237664,237664,434738234.99999994,3697007.683333341,175704,0,61,0.7900523428032853,49597087,6742416371,315839,315839,398825717.5500081,3693280.899999514,176374,0,61,0.5975766134011419,6046034710,-78175,-78175,35912517.44999182,3726.78333382681,-670,0,0,0.19247572940214341,-5996437623,1829.21365877878,1262.750064273279,566.4635945055011,0.7392958125757372,0.5584300862148119,-670
1409,2020-11-10,2020,245371,245371,435300122.0166671,3820357.950000001,187551,0,56,0.8176434868016194,50206141,6749937108,320413,320413,399435523.76668334,3816185.983332889,188170,0,57,0.6289632443128108,6058324482,-75042,-75042,35864598.24998379,4171.966667111963,-619,0,-1,0.18868024248880855,-6008118341,1774.0487751880505,1246.6270836909966,527.4216914970539,0.7643568310843579,0.5872733003966756,-619
1410,2020-11-11,2020,244775,244775,435914318.53333384,3813636.2999999956,185444,0,52,0.811414564395875,50225443,6756723610,320960,320960,400138689.4666784,3809487.4333328735,186205,0,52,0.6218936939182432,6069527274,-76185,-76185,35775629.06665546,4148.866667122114,-761,0,0,0.18952087047763178,-6019301831,1780.8776163143043,1246.6933246095414,534.1842917047629,0.7576100500459606,0.5801501744765702,-761
1411,2020-11-12,2020,244607,244607,436266539.5166674,3793248.966666667,183345,0,27,0.8053898702817174,50270780,6769124072,323519,323519,400634544.6500106,3788757.6666661967,184068,0,28,0.6121804283519714,6077797094,-78912,-78912,35631994.86665684,4491.300000470132,-723,0,-1,0.19320944192974598,-6027526314,1783.5406980040123,1238.3648090220686,545.1758889819437,0.7495492770035199,0.5689557645764236,-723
1412,2020-11-13,2020,244160,244160,436461778.6666669,3764848.183333332,181905,0,34,0.7991726736566181,51270961,6780464469,324078,324078,400928459.83334386,3760359.3999995347,182574,0,34,0.6049778139830491,6090718960,-79918,-79918,35533318.83332306,4488.7833337974735,-669,0,0,0.1941948596735691,-6039447999,1787.6055810397563,1237.1356890419709,550.4698919977855,0.74502375491481,0.5633643752429971,-669
1413,2020-11-14,2020,243981,243981,436230339.98333377,3742832.399999996,178941,0,33,0.7888892987568701,51903006,6786922958,325661,325660,400800536.7333467,3738620.1166661265,179847,0,33,0.5949990941500459,6101184405,-81680,-81679,35429803.249987066,4212.283333869651,-906,0,0,0.19389020460682416,-6049281399,1787.9684892812709,1230.7330858359844,557.2354034452865,0.7334218648173423,0.5522521886255953,-906
1414,2020-11-15,2020,246366,246366,436626732.6333328,3764534.8999999934,180453,0,42,0.7912008962275643,51840647,6800978080,327977,327977,401170867.5500145,3761881.549999491,181231,0,43,0.5986273427709888,6110008825,-81611,-81611,35455865.08331829,2653.3500005025417,-778,0,-1,0.19257355345657545,-6058168178,1772.2686272997605,1223.1676841669218,549.1009431328387,0.7324590243783639,0.552572284032112,-778
1415,2020-11-16,2020,250015,250015,436913733.96666664,3779502.9000000055,182137,0,31,0.7871567705937642,51457326,6810081143,332737,332737,401454632.2000117,3774827.2166661266,182894,0,30,0.5955033555030002,6118646183,-82722,-82722,35459101.76665497,4675.683333878871,-757,0,1,0.19165341509076406,-6067188857,1747.5500828616948,1206.522365111219,541.0277177504759,0.7285042897426155,0.5496653513134998,-757
1416,2020-11-17,2020,247323,247323,436998000.6333341,3773187.5666666706,182130,0,35,0.7956073636499644,51147029,6818601879,331524,331524,401564891.9166794,3767713.2333327993,182631,0,35,0.596412326106104,6127199554,-84201,-84201,35433108.71665472,5474.333333871327,-501,0,0,0.19919503754386048,-6076052525,1766.9120972709134,1211.2694463045793,555.642650966334,0.7364054293373443,0.5508831939769067,-501
1417,2020-11-18,2020,242615,242615,437149515.066666,3737336.3499999964,178258,0,59,0.795128083589226,51441461,6829504609,325236,325236,401780548.5500102,3732641.2333328743,178911,0,59,0.5972524566776135,6134633811,-82621,-82621,35368966.5166558,4695.116667122114,-653,0,0,0.19787562691161253,-6083192350,1801.8239394376524,1235.3507869670339,566.4731524706185,0.7347361045277497,0.5500959303398147,-653
1418,2020-11-19,2020,241928,241928,437060984.7999994,3709797.333333332,176635,0,83,0.7948025858933239,50749823,6833249532,322233,322233,401756645.8500101,3705748.8999994732,177416,0,83,0.6011674781912517,6147404037,-80305,-80305,35304338.94998932,4048.4333338588476,-781,0,0,0.19363510770207215,-6096654214,1806.5746205482599,1246.7892669279995,559.7853536202604,0.7301139181905361,0.5505829632595047,-781
1419,2020-11-20,2020,242501,242501,437247784.53333294,3654485.9499999997,177446,0,79,0.7895018989612412,50480982,6844224474,330988,330988,402028647.3666799,3657527.649999608,180309,0,79,0.5896739458832356,6156721509,-88487,-88487,35219137.16665304,-3041.6999996080995,-2863,0,0,0.1998279530780056,-6106240527,1803.0762121943123,1214.632093509976,588.4441186843364,0.7317330650182886,0.5447599308736268,-2863
1420,2020-11-21,2020,238723,238723,437113108.5666664,3643909.9499999997,173451,0,47,0.785919245317795,51228121,6847259293,335330,335330,401180206.75001997,3651356.9166661887,179281,0,48,0.5791250410043794,6137302729,-96607,-96607,35932901.81664646,-7446.966666189022,-5830,0,-1,0.20679420431341555,-6086074608,1831.0473166249856,1196.3743379656457,634.6729786593398,0.7265785031186773,0.5346405033847255,-5830
1421,2020-11-22,2020,234568,234568,437158033.51666707,3602369.633333334,170985,0,81,0.7949805600081858,52088904,6856075167,324703,324703,398289570.83334494,3597740.4666661303,171909,0,81,0.5799884817818144,6045599082,-90135,-90135,38868462.68332213,4629.166667203419,-924,0,0,0.21499207822637145,-5993510178,1863.6729371298177,1226.6273204539068,637.0456166759109,0.728935745711265,0.5294345909954635,-924
1422,2020-11-23,2020,238540,238540,437453562.64999956,3622264.3999999943,172311,0,176,0.7819988261926722,51995768,6873060772,321084,321084,398589714.050009,3618277.5833328045,172992,0,176,0.5851833165153061,6052379586,-82544,-82544,38863848.59999055,3986.8166671898216,-681,0,0,0.19681550967736616,-6000383818,1833.8792766412323,1241.387655722518,592.4916209187143,0.7223568374276851,0.5387749000261614,-681
1423,2020-11-24,2020,237368,237368,438047700.8,3658984.8333333354,172496,0,201,0.7825738937009195,50404538,6887646907,319247,319247,399205659.45001614,3653936.099999503,173314,0,204,0.5861762209198551,6063948343,-81879,-81879,38842041.34998387,5048.733333832119,-818,0,-3,0.19639767278106435,-6013543805,1845.4370462741397,1250.4601748803157,594.976871393824,0.7267028411580331,0.5428837232612993,-818
1424,2020-11-25,2020,238916,238916,438540038.2499998,3678865.866666666,173775,0,204,0.7866070083209163,52680110,6899160222,317680,317680,399761365.7666773,3674157.2499995376,174731,0,204,0.5978217073784957,6078927939,-78764,-78764,38778672.4833225,4708.616667128634,-956,0,0,0.18878530094242063,-6026247829,1835.540684801352,1258.377504931621,577.163179869731,0.7273476870531902,0.5500220347519517,-956
1425,2020-11-26,2020,243667,243667,439080836.11666673,3682651.1333333314,175567,0,136,0.7831425675204278,53548163,6915632529,322275,322275,400285140.43333876,3677325.633332778,176437,0,136,0.5973376774493871,6092643572,-78608,-78608,38795695.68332797,5325.500000553671,-870,0,0,0.18580489007104062,-6039095409,1801.970870559685,1242.0607879399233,559.9100826197616,0.7205202181665962,0.5474734310759445,-870
1426,2020-11-27,2020,232980,232980,439141150.2000007,3597878.1499999994,169373,0,39,0.787436689844624,52103768,6924248574,318791,318791,400378685.4500128,3593743.9499994586,170280,0,41,0.5805465022538293,6106402804,-85811,-85811,38762464.7499879,4134.200000540819,-907,0,-2,0.2068901875907947,-6054299036,1884.8877594643347,1255.9284466939557,628.959312770379,0.7269851489398231,0.5341430592457127,-907
1427,2020-11-28,2020,228891,228891,438802682.55000013,3556747.7833333374,165730,0,91,0.777557876893368,51179567,6927373550,310612,310612,400137178.266681,3552890.1999995443,166476,0,91,0.5774374460742017,6109634396,-81721,-81721,38665504.283319116,3857.5833337930962,-746,0,0,0.2001204308191663,-6058454829,1917.0814167005262,1288.2218918350902,628.859524865436,0.7240564286057556,0.5359612635699844,-746
1428,2020-11-29,2020,222078,222078,439282887.76666677,3521911.600000002,162472,0,124,0.7843100172011641,50754310,6943022976,298608,298607,400715656.1833341,3517708.8166661304,163246,0,127,0.5880251031452668,6115142158,-76530,-76529,38567231.58333266,4202.783333871514,-774,0,-3,0.19628491405589732,-6064387848,1978.0567537832057,1341.949974995007,636.1067787881987,0.7315988076261494,0.5466899748164818,-774
1429,2020-11-30,2020,235850,235850,440258245.54999983,3678714.999999997,180019,0,134,0.8236294254822982,52343015,6962664893,308120,308120,401744914.7666808,3674401.049999561,180807,0,137,0.6353888095547141,6136133002,-72270,-72270,38513330.783319056,4313.950000436045,-788,0,-3,0.18824061592758412,-6083789987,1866.6874943820217,1303.8586095244734,562.8288848575482,0.7632775068899724,0.5868070881474751,-788
1430,2020-12-01,2020,240495,240495,441063603.8500006,3744298.3333333316,183583,0,129,0.8253310879644071,52863198,6979135433,313278,313278,402610672.18334323,3741970.316666216,184491,0,130,0.6391192487183885,6151348053,-72783,-72783,38452931.66665739,2328.016667115502,-908,0,-1,0.18621183924601858,-6098484855,1833.9824272853932,1285.154630019801,548.8277972655922,0.763354747499948,0.5889050619577499,-908
1431,2020-12-02,2020,232407,232407,441494944.0333328,3588366.150000001,176289,0,88,0.813516804571291,45002967,6985526858,314194,314194,403309981.7500105,3683634.2166662146,179274,0,89,0.6171155400803329,6165207379,-81787,-81787,38184962.283322334,-95268.0666662138,-2985,0,-1,0.19640126449095818,-6120204412,1899.6628502296953,1283.6336204701888,616.0292297595065,0.7585356723334495,0.5705837794483662,-2985
1432,2020-12-03,2020,228006,228006,441528480.2000002,3585262.9833333367,172855,0,85,0.8162679929475545,47003314,6992688491,309261,309261,403667652.8833414,3645775.5499994736,175155,0,86,0.6139894781430576,6183168402,-81255,-81255,37860827.316658854,-60512.56666613696,-2300,0,-1,0.20227851480449688,-6136165088,1936.4774619966151,1305.2653030396377,631.2121589569774,0.7581160144908468,0.5663662731479236,-2300
1433,2020-12-04,2020,234549,234549,442144151.8833331,3644944.0833333344,176390,0,89,0.810747434438007,52068551,7004774624,309699,309699,404225224.71667945,3639546.1166662215,177130,0,90,0.6182325419197374,6192532338,-75150,-75150,37918927.16665363,5397.966667112894,-740,0,-1,0.1925148925182696,-6140463787,1885.0822296549254,1305.2196639856102,579.8625656693152,0.7520390195652081,0.5719424344282674,-740
1434,2020-12-05,2020,237200,237200,442412489.3833332,3644609.5499999975,175745,0,69,0.7948145025295119,51387286,7013074524,315036,315036,404513515.9666699,3642241.1499995077,176844,0,69,0.604219835193435,6208074720,-77836,-77836,37898973.41666329,2368.4000004897825,-1099,0,0,0.19059466733607688,-6156687434,1865.1454021219781,1284.0231464552303,581.1222556667478,0.7409148397976392,0.5613453700529464,-1099
1435,2020-12-06,2020,231212,231212,442361125.1999999,3599249.833333328,172260,0,27,0.801424666539799,52208152,7020720769,311720,311720,404535302.3000136,3595120.666666416,173238,0,29,0.600359296804816,6218717087,-80508,-80508,37825822.89998633,4129.166666911915,-978,0,-2,0.201065369734983,-6166508935,1913.2273636316452,1297.7521567432748,615.4752068883704,0.7450305347473315,0.5557487488771975,-978
1436,2020-12-07,2020,230796,230796,443087546.13333344,3588288.2500000037,170923,0,49,0.7975224873914623,51567444,7039456995,309010,309010,405317395.3166769,3584031.5333328694,171928,0,49,0.6020646581016796,6229895939,-78214,-78214,37770150.81665653,4256.716667134315,-1005,0,0,0.19545782928978261,-6178328495,1919.8233337377314,1311.664332276227,608.1590014615044,0.7405804260039168,0.556383288566713,-1005
1437,2020-12-08,2020,230538,230538,443300048.06666684,3536338.4666666645,170139,0,29,0.7951574143958912,51704372,7049645047,306619,306619,405599090.38334614,3532521.099999568,171107,0,29,0.6037558011734374,6242109934,-76081,-76081,37700957.6833207,3817.366667096503,-968,0,0,0.19140161322245375,-6190405562,1922.8936143571423,1322.8113404040394,600.0822739531029,0.7380084845014705,0.5580443481976003,-968
1438,2020-12-09,2020,247230,247230,444288414.5666669,3774965.083333332,188107,0,30,0.8269789265056829,53648077,7066904260,322594,322594,406520755.5333463,3771865.0666662804,189200,0,31,0.6400615014538421,6254956107,-75364,-75364,37767659.033320606,3100.0166670517065,-1093,0,-1,0.18691742505184084,-6201308030,1797.0651400180677,1260.162171439476,536.9029685785918,0.7608583100756381,0.5864957190772302,-1093
1439,2020-12-10,2020,244160,244160,445106734.41666675,3802939.3499999987,184182,0,93,0.8202408256880737,54057664,7081556436,321914,321914,407406027.9500104,3798671.5833328133,185233,0,93,0.6286306280559353,6267839013,-77754,-77754,37700706.46665633,4267.766667185351,-1051,0,0,0.19161019763213838,-6213781349,1823.0125098978815,1265.5741221258174,557.4383877720641,0.7543496068152031,0.5754114452928422,-1051
1440,2020-12-11,2020,242425,242425,445791779.85000044,3735737.13333333,181281,0,235,0.8130555842012999,54221294,7091545172,321942,321942,408055216.80000424,3731741.483332843,182628,0,235,0.6192854613563942,6283906784,-79517,-79517,37736563.0499962,3995.6500004869886,-1347,0,0,0.1937701228449057,-6229685490,1838.8853453645474,1267.4805300333733,571.4048153311742,0.7477817881819119,0.5672698809102261,-1347
1441,2020-12-12,2020,240077,240077,445913155.1666668,3663281.983333335,179570,0,147,0.8116937482557686,52976824,7103876518,322848,322848,408160122.63334143,3658446.366666189,180429,0,147,0.608509267519085,6293251131,-82771,-82771,37753032.533325374,4835.616667145863,-859,0,0,0.2031844807366836,-6240274307,1857.3755718651382,1264.248570947757,593.1270009173813,0.7479683601511182,0.5588667112696997,-859
1442,2020-12-13,2020,229580,229580,445912964.94999945,3582246.8000000003,171622,0,47,0.8105322763306916,52117949,7116499515,312545,312545,408154723.90001273,3577674.4666661834,172407,0,48,0.5999648050680731,6304713276,-82965,-82965,37758241.04998672,4572.333333816845,-785,0,-1,0.21056747126261843,-6252595327,1942.2988280773563,1305.9070658625565,636.3917622147999,0.7475476957923164,0.5516229662928538,-785
1443,2020-12-14,2020,225443,225443,446010135.21666694,3550963.4666666677,169097,0,45,0.8085192265894249,51883869,7131765602,304863,304863,408244199.4500097,3546569.54999952,169747,0,47,0.6015095305104267,6318832764,-79420,-79420,37765935.76665723,4393.91666714754,-650,0,-2,0.20700969607899822,-6266948895,1978.3720728373332,1339.1070725211314,639.2650003162018,0.7500654267375789,0.5567976435316847,-650
1444,2020-12-15,2020,227368,227368,446267309.666667,3565590.8166666627,169315,0,60,0.7993737025438936,51902897,7144518293,298463,298463,408602812.03332883,3560905.3499998627,169845,0,59,0.6120457142091306,6329239967,-71095,-71095,37664497.63333815,4685.46666679997,-530,0,1,0.18732798833476305,-6277337070,1962.7533763179822,1369.0233363375992,593.730039980383,0.7446738327293199,0.5690655123080582,-530
1445,2020-12-16,2020,229396,229396,446708207.9000001,3573540.6500000022,170168,0,52,0.7970452841374734,52355249,7156046873,302247,302247,409069552.4500102,3570011.849999511,170961,0,51,0.6093294557100711,6342279212,-72851,-72851,37638655.449989915,3528.8000004910864,-793,0,1,0.1877158284274023,-6289923963,1947.3234402517921,1353.4279991199587,593.8954411318334,0.7418089243055677,0.5656334057906282,-793
1446,2020-12-17,2020,231559,231559,447091261.74999964,3600025.249999997,171342,0,112,0.7940524877029184,52738676,7170085375,306556,306556,409600210.2333419,3595912.649999506,172146,0,112,0.6043985438223304,6356585214,-74997,-74997,37491051.51665777,4112.600000491366,-804,0,0,0.18965394388058798,-6303846538,1930.7876685855426,1336.13502992387,594.6526386616727,0.7399496456626605,0.5615482978640118,-804
1447,2020-12-18,2020,227515,227515,447303740.6500003,3539012.816666665,168828,0,183,0.8020921697470499,51727754,7180464992,304736,304736,409858492.15000933,3534529.849999577,169486,0,182,0.6025149637719162,6368328257,-77221,-77221,37445248.49999094,4482.966667088214,-658,0,1,0.19957720597513373,-6316600503,1966.040659516956,1344.9624991796484,621.0781603373077,0.7420521723842384,0.556173212223039,-658
1448,2020-12-19,2020,219710,219710,447265957.0333335,3490600.7166666645,162995,0,205,0.7992854216922296,50837977,7188638581,297097,297097,409804671.63332856,3486542.666666464,163661,0,196,0.5949605684338837,6378596517,-77387,-77387,37461285.40000492,4058.0500002005138,-666,0,9,0.20432485325834593,-6327758540,2035.7105140108938,1379.3632101075693,656.3473039033245,0.7418642756360657,0.5508672251823479,-666
1449,2020-12-20,2020,218999,218999,447620667.8833331,3507025.1999999993,161722,0,89,0.794145178745108,51162207,7202026301,289154,289154,410201182.56667626,3503305.083332793,162565,0,86,0.6065591345788046,6384479101,-70155,-70155,37419485.31665683,3720.116667206399,-843,0,3,0.18758604416630342,-6333316894,2043.9393233911255,1418.6253088896444,625.3140145014811,0.7384599929680045,0.5622090650656744,-843
1450,2020-12-21,2020,226222,226222,448350810.3166667,3556750.799999998,167276,0,25,0.7931589323761619,51223244,7218382403,294187,294187,410956032.86666137,3551601.7833330464,167901,0,25,0.6141127922035949,6397681065,-67965,-67965,37394777.45000535,5149.016666951589,-625,0,0,0.17904614017256693,-6346457821,1981.9063146673034,1396.9211177470838,584.9851969202196,0.7394329463977862,0.5707288221437385,-625
1451,2020-12-22,2020,232902,232902,448810276.0666673,3610574.949999998,171015,0,38,0.7860001202222393,51993107,7228946891,303010,303010,411434638.75001186,3606725.683332828,171843,0,38,0.6093132239860061,6412934592,-70108,-70108,37375637.31665546,3849.2666671699844,-828,0,0,0.17668689623623324,-6360941485,1927.0348733229741,1357.8252821689446,569.2095911540296,0.7342787953731612,0.5671198970331012,-828
1452,2020-12-23,2020,232121,232121,449315678.0333324,3611792.866666669,170626,0,70,0.7923582958887819,53537595,7242424194,306803,306803,411967456.5000106,3609121.3333328534,171315,0,70,0.6035469014318545,6425767748,-74682,-74682,37348221.5333218,2671.5333338156343,-689,0,0,0.1888113944569274,-6372230153,1935.695943207777,1342.7751896168245,592.9207535909525,0.7350735176912041,0.5583876298471657,-689
1453,2020-12-24,2020,221429,221429,449438874.5666666,3518488.966666665,162653,0,45,0.7922358859950587,53336428,7248248356,299986,299986,412218073.9666779,3515482.2999994904,163548,0,45,0.5901742081297111,6437865213,-78557,-78557,37220800.5999887,3006.666667174548,-895,0,0,0.20206167786534757,-6384528785,2029.7200211655502,1374.1243723596365,655.5956488059137,0.7345605137538443,0.5451854419872927,-895
1454,2020-12-25,2020,219693,219693,449156968.83333313,3468990.35,159510,0,53,0.782860628240317,52598851,7252204409,294312,294312,411998708.38333726,3465607.1499994327,160394,0,54,0.5911175894968658,6447893931,-74619,-74619,37158260.449995875,3383.2000005673617,-884,0,-1,0.19174303874345122,-6395295080,2044.4755583169838,1399.870574028029,644.6049842889547,0.7260586363698434,0.5449794775612276,-884
1455,2020-12-26,2020,223553,223553,449936418.71666735,3544841.2999999993,162160,0,26,0.7814567462749317,52680809,7271214313,293721,293721,412807526.19999605,3539562.516666407,163126,0,25,0.602360743698949,6459073903,-70168,-70168,37128892.5166713,5278.783333592117,-966,0,1,0.17909600257598268,-6406393094,2012.6610634465535,1405.4409667677696,607.2200966787839,0.7253760853131025,0.5553773819372806,-966
1456,2020-12-27,2020,229660,229660,450584591.8000001,3573985.850000003,165995,0,22,0.7787816772620398,53465370,7288082534,299487,299487,413439624.5499971,3566247.299999815,166881,0,22,0.6044035300363678,6471815063,-69827,-69827,37144967.25000298,7738.550000187941,-886,0,0,0.17437814722567202,-6418349693,1961.9637368283552,1380.492724392034,581.4710124363212,0.7227858573543499,0.5572228510753389,-886
1457,2020-12-28,2020,234247,234247,451579139.59999985,3575686.966666665,169601,0,221,0.7835319128953631,53263696,7311224207,308860,308860,414387413.1333419,3571041.4499994842,170604,0,221,0.601447257657192,6489502302,-74613,-74613,37191726.46665794,4645.516667180695,-1003,0,0,0.18208465523817108,-6436238606,1927.790492941211,1341.6674646549955,586.1230282862155,0.7240263482563277,0.5523667681150035,-1003
1458,2020-12-29,2020,220832,220832,451871095.4833331,3481072.3666666676,161330,0,257,0.7951972540211556,52886297,7328446373,298459,298459,414768575.61666507,3477082.199999647,162418,0,258,0.5962963087057208,6502720420,-77627,-77627,37102519.866668046,3990.166667020414,-1088,0,-1,0.19890094531543479,-6449834123,2046.2210888065729,1389.700346167028,656.5207426395448,0.7305553542964788,0.5441886490271696,-1088
1459,2020-12-30,2020,204743,204743,451237149.2499996,3390644.8833333324,150765,0,187,0.7989577177241708,53024528,7339282429,279749,279749,414159878.70000577,3386409.8166661295,151777,0,188,0.5928135578679478,6520330418,-75006,-75006,37077270.54999381,4235.06666720286,-1012,0,-1,0.20614415985622303,-6467305890,2203.9197884665145,1480.469559140536,723.4502293259786,0.7363621711120771,0.5425470689796925,-1012
1460,2020-12-31,2020,213261,213261,451570772.89999986,3438632.4500000016,154630,0,143,0.7819104290048344,53287446,7356819346,277719,277719,414514853.93334126,3434699.2166661574,155640,0,144,0.6076249734443872,6533528899,-64458,-64458,37055918.96665859,3933.233333844226,-1010,0,-1,0.17428545556044728,-6480241453,2117.455947876076,1492.5693018242946,624.8866460517816,0.7250739703930864,0.5604225854190746,-1010
1461,2021-01-01,2021,221597,221597,451574291.31666666,3414480.2500000023,158426,0,146,0.7670591208364733,50661817,7362097304,287002,287002,414504785.4166758,3410447.499999448,159302,0,148,0.5976752775242001,6542448520,-65405,-65405,37069505.89999086,4032.750000554137,-876,0,-2,0.16938384331227319,-6491786703,2037.8177110550535,1444.25748049378,593.5602305612736,0.714928451197444,0.5550553654678365,-876
1462,2021-01-02,2021,217606,217606,451862683.8833336,3432008.3500000024,158254,0,185,0.7830896206906056,52829969,7377937372,297865,297865,414873880.4666581,3434666.233333211,162042,0,188,0.5872660433417813,6553171649,-80259,-80259,36988803.41667551,-2657.883333208505,-3788,0,-3,0.19582357734882427,-6500341680,2076.517577104187,1392.8252076163972,683.6923694877896,0.7272501677343456,0.5440115488560254,-3788
1463,2021-01-03,2021,215365,215365,452414306.16666603,3419412.866666672,156888,0,153,0.7849371996378233,52736751,7395013469,293017,293017,415154798.1333426,3419235.0999994697,159882,0,154,0.5894913946972288,6558512496,-77652,-77652,37259508.03332341,177.76666720211506,-2994,0,-1,0.1954458049405945,-6505775745,2100.6863054194787,1416.8283687749947,683.857936644484,0.7284749146797298,0.5456406966148721,-2994
1464,2021-01-04,2021,222157,222157,453306053.68333334,3491109.4999999986,162680,0,97,0.7882983655702949,53524329,7415788963,293173,293173,415304422.816666,3487487.483333063,163435,0,97,0.6022723784250129,6550494649,-71016,-71016,38001630.86666733,3622.016666935757,-755,0,0,0.18602598714528196,-6496970320,2040.4761213166064,1416.5848247166896,623.8912965999168,0.7322749226898094,0.5574694804773973,-755
1465,2021-01-05,2021,222266,222266,453796429.4333336,3484121.4166666674,161502,0,113,0.7848568831940118,53590342,7428257440,294052,294052,415837343.56667703,3480845.733332806,162905,0,113,0.6008563111286408,6561109043,-71786,-71786,37959085.86665654,3275.6833338616416,-1403,0,0,0.18400057206537102,-6507518701,2041.6817211509344,1414.16260922108,627.5191119298545,0.7266158566762347,0.5540006529457375,-1403
1466,2021-01-06,2021,213372,213372,454092162.0833332,3416394.383333329,156908,0,110,0.7954792568846892,53050378,7440408372,286525,286525,416133483.4000101,3412536.9333328274,157855,0,110,0.5991728470465054,6571628319,-73153,-73153,37958678.683323085,3857.4500005017035,-947,0,0,0.19630640983818382,-6518577941,2128.171278721356,1452.3461596719662,675.8251190493897,0.7353729636503383,0.5509292382863624,-947
1467,2021-01-07,2021,213455,213455,454437442.75000006,3475953.3000000026,166188,0,120,0.8431378979175939,53061060,7452718983,282056,282056,416533696.916676,3471154.099999545,166929,0,121,0.6433686927418703,6585279264,-68601,-68601,37903745.833324075,4799.200000457466,-741,0,-1,0.1997692051757236,-6532218204,2128.9613396266195,1476.7765866234931,652.1847530031264,0.778562226230353,0.5918292821283717,-741
1468,2021-01-08,2021,220607,220607,455628980.2500001,3577172.833333334,171125,0,105,0.8379924481090817,54383149,7472803111,281470,281470,417726941.7833425,3572727.5333328573,171829,0,105,0.6608341919209898,6596802922,-60863,-60863,37902038.46665764,4445.300000476651,-704,0,0,0.1771582561880919,-6542419773,2065.3423520105894,1484.0904600253757,581.2518919852137,0.7757006803954544,0.6104700323302661,-704
1469,2021-01-09,2021,225252,225252,456147289.9500003,3520919.816666668,172459,0,102,0.8249338518636898,54335341,7486057099,290926,290926,418277624.0166635,3517063.0333331497,173199,0,102,0.6435347820407963,6613944705,-65674,-65674,37869665.933336794,3856.7833335180767,-740,0,0,0.18139906982289355,-6559609364,2025.053229050132,1437.7457635847725,587.3074654653594,0.765626942269103,0.5953369585392849,-740
1470,2021-01-10,2021,220044,220044,456552626.24999994,3489525.8666666658,166835,0,118,0.8115422370071445,53346967,7499712998,293976,293976,418687961.83334494,3486065.6999995094,167634,0,118,0.6118322584156504,6624992302,-73932,-73932,37864664.416655004,3460.166667156387,-799,0,0,0.1997099785914941,-6571645335,2074.824245378197,1424.2249769822874,650.5992683959093,0.7581892712366618,0.5702302228753368,-799
1471,2021-01-11,2021,224419,224419,457557723.8833336,3544716.7666666694,169615,0,110,0.8096105944683842,52815687,7524883130,294565,294565,419643137.3999924,3540716.3166663833,170287,0,110,0.6210140376487372,6639354699,-70146,-70146,37914586.48334122,4000.4500002861023,-672,0,0,0.18859655681964704,-6586539012,2038.8546597361792,1424.6198204131258,614.2348393230534,0.7557960778721944,0.5780965152003802,-672
1472,2021-01-12,2021,236674,236674,458144306.9666668,3668567.5499999993,181892,0,115,0.8318826740579857,54986947,7532943098,314139,314139,420353566.7166905,3676587.2499995716,186636,0,115,0.6441352394958937,6658341761,-77465,-77465,37790740.24997634,-8019.6999995722435,-4744,0,0,0.18774743456209197,-6603354814,1935.7610340242984,1338.1132769783137,597.6477570459847,0.7685339327513795,0.5941191638096511,-4744
1473,2021-01-13,2021,237122,237122,458892880.1666659,3709782.433333336,179139,0,93,0.8116750027412042,54665996,7544995570,323626,323626,420018118.8166782,3718842.5666662464,183958,0,93,0.610448480653589,6627628300,-86504,-86504,38874761.349987686,-9060.133332910482,-4819,0,0,0.20122652208761516,-6572962304,1935.2606682073613,1297.8503544729972,637.4103137343641,0.7554718668027429,0.5684277530235519,-4819
1474,2021-01-14,2021,236941,236941,459724638.0499999,3682679.266666668,177540,0,180,0.8060361018143766,55449223,7564252564,320743,320743,418403647.9666747,3678925.8999994686,178370,0,181,0.5989218782639004,6549223829,-83802,-83802,41320990.08332521,3753.366667199414,-830,0,-1,0.20711422355047615,-6493774606,1940.249420952895,1304.4825544647106,635.7668664881844,0.7493004587639961,0.5561150204369231,-830
1475,2021-01-15,2021,238501,238501,460249385.0500003,3648393.949999994,178802,0,240,0.8127261520916055,55093780,7582825238,315921,315921,418717716.0333396,3644556.2499994845,179470,0,247,0.6170624934714681,6557392491,-77420,-77420,41531669.01666069,3837.7000005096197,-668,0,-7,0.19566365862013735,-6502298711,1929.7587223952953,1325.3874102492066,604.3713121460887,0.7496907769778743,0.5680850592394934,-668
1476,2021-01-16,2021,219481,219481,459898968.0999995,3507747.966666672,165947,0,66,0.8151138367330196,54158017,7588745413,302451,302451,418477374.04999727,3503089.566666443,166513,0,66,0.5947409663052688,6573291349,-82970,-82970,41421594.05000222,4658.400000229012,-566,0,0,0.22037287042775078,-6519133332,2095.393077760715,1383.6204014865127,711.7726762742025,0.7560882263157175,0.5505453775983548,-566
1477,2021-01-17,2021,215917,215917,459863132.01666737,3457367.649999998,162286,0,61,0.8048879893662839,53439638,7596457112,288971,288971,418566608.8333434,3454417.3499995223,162743,0,61,0.603673032934095,6583773777,-73054,-73054,41296523.18332398,2950.3000004757196,-457,0,0,0.2012149564321889,-6530334139,2129.8143824556073,1448.4727146784396,681.3416677771677,0.7516128882857764,0.56318108045444,-457
1478,2021-01-18,2021,224567,224567,460591334.4833325,3507837.733333331,167723,0,36,0.802620153450864,53809128,7614490172,293900,293900,419362547.5666783,3503703.533332834,168239,0,36,0.6157298400816661,6599558075,-69333,-69333,41228786.91665423,4134.200000497047,-516,0,0,0.18689031336919792,-6545748947,2051.019671115224,1426.888559260559,624.1311118546648,0.7468728709026705,0.5724362027900647,-516
1479,2021-01-19,2021,226733,226733,460820598.3833329,3525879.4833333353,168068,0,79,0.8061376156095504,53543681,7621092205,297782,297782,419681833.6833292,3521913.5333330957,168665,0,79,0.616941252325525,6612301314,-71049,-71049,41138764.70000368,3965.950000239536,-597,0,0,0.18919636328402545,-6558757633,2032.4372649033573,1409.35930876725,623.0779561361073,0.7412595431631037,0.5664042823273401,-597
1480,2021-01-20,2021,225525,225525,460988597.883334,3553942.66666667,168239,0,86,0.8175368584414151,53427955,7631431900,297379,297379,419943999.35000646,3550286.233332849,168877,0,86,0.6231475659007523,6622208793,-71854,-71854,41044598.53332752,3656.4333338206634,-638,0,0,0.19438929254066284,-6568780838,2044.0687191368318,1412.1508221831618,631.9178969536699,0.7459882496397295,0.5678847531264817,-638
1481,2021-01-21,2021,224491,224491,461428053.98333335,3552141.416666667,166486,0,109,0.8184470646930163,53455061,7644518187,297738,297738,420551357.24999714,3549000.5333331716,168076,0,109,0.6242804076066814,6633973161,-73247,-73247,40876696.73333621,3140.8833334953524,-1590,0,0,0.19416665708633496,-6580518100,2055.4412158319637,1412.4880171492962,642.9531986826676,0.7416154767897154,0.5645097367484164,-1590
1482,2021-01-22,2021,221676,221676,461813095.14999974,3491777.800000002,164068,0,35,0.8219428354896342,53678309,7660256101,295500,295500,420764085.6666599,3487473.4166665045,164681,0,35,0.620209813874778,6646036526,-73824,-73824,41049009.483339846,4304.383333497681,-613,0,0,0.20173302161485618,-6592358217,2083.2796295043204,1423.905535250964,659.3740942533564,0.7401252278099568,0.5572961082910322,-613
1483,2021-01-23,2021,216334,216334,461719333.2333335,3460388.9,160653,0,40,0.8221176514093951,54042343,7669523766,286992,286992,420889876.00000954,3457233.933332829,161258,0,40,0.6229825221608967,6660790416,-70658,-70658,40829457.23332399,3154.966667171102,-605,0,0,0.1991351292484984,-6606748073,2134.289262128623,1466.556127000089,667.7331351285338,0.742615585159984,0.5618902269052796,-605
1484,2021-01-24,2021,214155,214155,461877822.5666659,3395685.7333333334,159089,0,31,0.8205645443720676,54109763,7684928331,283415,283415,421086261.8333248,3392678.149999666,159841,0,32,0.6237108127657441,6676970036,-69260,-69260,40791560.7333411,3007.5833336673677,-752,0,-1,0.19685373160632347,-6622860273,2156.745453370997,1485.7585584154854,670.9868949555116,0.7428684831080292,0.5639821463225305,-752
1485,2021-01-25,2021,218002,218002,462341170.9999998,3446244.1833333345,162961,0,85,0.8259878349739911,54609003,7703832453,286612,286612,421619209.26667297,3443318.099999475,163842,0,85,0.6326706488214003,6695876467,-68610,-68610,40721961.73332685,2926.083333859686,-881,0,0,0.19331718615259075,-6641267464,2120.8116026458465,1471.0452083885984,649.7663942572481,0.747520664948028,0.5716508729571685,-881
1486,2021-01-26,2021,218952,218952,462496443.9,3431417.849999999,163473,0,99,0.8286565091892285,54624902,7716637609,286388,286388,421884378.46667814,3428037.3499994874,164119,0,97,0.6370797659119802,6711061122,-67436,-67436,40612065.43332183,3380.5000005117618,-646,0,2,0.19157674327724827,-6656436220,2112.3188822207608,1473.1217036561522,639.1971785646085,0.7466156965910337,0.5730652122295626,-646
1487,2021-01-27,2021,219913,219913,462829586.3500004,3442511.633333332,164497,0,58,0.840368691255178,54882496,7729702907,289220,289220,422311397.83332604,3438263.533333059,165139,0,58,0.6422930641034579,6729315464,-69307,-69307,40518188.51667434,4248.100000272971,-642,0,0,0.1980756271517201,-6674432968,2104.603121916396,1460.173562801072,644.4295591153241,0.7480094400967655,0.5709805684254201,-642
1488,2021-01-28,2021,209931,209931,462929518.36666584,3409640.2833333313,158117,0,188,0.8453968208601863,54877005,7742447001,279438,279438,422514884.3833406,3405488.0999994995,158784,0,189,0.6388859067127552,6744052608,-69507,-69507,40414633.98332524,4152.183333831839,-667,0,-1,0.20651091414743106,-6689175603,2205.1508274941093,1512.016563185181,693.1342643089283,0.7531855704969728,0.5682262254954588,-667
1489,2021-01-29,2021,211142,211142,463321130.46666586,3363898.133333337,159231,0,142,0.8486042568508407,54709581,7760717318,277391,277391,422972539.60000485,3359629.099999452,160007,0,145,0.650814193683282,6761482573,-66249,-66249,40348590.86666101,4269.033333885018,-776,0,-3,0.19779006316755876,-6706772992,2194.3579698338835,1524.824307926374,669.5336619075094,0.754141762415815,0.5768283758305064,-776
1490,2021-01-30,2021,208620,208620,463412942.1499995,3361132.9333333354,156926,0,151,0.8441616335921779,54321897,7773323134,276091,276091,423109358.55000675,3358524.933332744,157633,0,151,0.6423824029034009,6778501900,-67471,-67471,40303583.59999275,2608.00000059139,-707,0,0,0.201779230688777,-6724180003,2221.3255783242234,1532.4996416036986,688.8259367205249,0.7522097593711053,0.5709458113448103,-707
1491,2021-01-31,2021,207033,207033,463843084.93333316,3360987.650000002,155625,0,110,0.8434838890418438,54218171,7786085198,270668,270668,423611268.41667277,3356656.6666661324,156344,0,111,0.6498071438071777,6796625591,-63635,-63635,40231816.51666039,4330.983333869372,-719,0,-1,0.19367674523466605,-6742407420,2240.4306798111083,1565.058552975131,675.3721268359773,0.7516917592847517,0.5776227703311806,-719
1492,2021-02-01,2021,210688,210688,464334860.83333313,3365726.700000003,157747,0,107,0.8419843560145807,53873898,7797757148,272472,272472,424218306.3499909,3362203.016666384,158461,0,107,0.6558031650958694,6813577551,-61784,-61784,40116554.48334223,3523.683333619032,-714,0,0,0.18618119091871121,-6759703653,2203.8979952979435,1556.9244045259363,646.9735907720071,0.7487232305589308,0.5815680143280777,-714
1493,2021-02-02,2021,204621,204621,464301834.83333325,3300579.7166666654,154623,0,143,0.8498003626216271,53559473,7808339596,271414,271414,424256178.03333765,3296152.43333286,155339,0,145,0.6452062163337079,6827432812,-66793,-66793,40045656.7999956,4427.28333380539,-716,0,-2,0.20459414628791917,-6773873339,2269.0820337762657,1563.1329925255795,705.9490412506862,0.7556555778732388,0.5723323041552757,-716
1494,2021-02-03,2021,206006,206006,464112947.6999996,3344529.749999999,157674,0,52,0.8632661184625693,53717966,7815728098,269346,269346,424031088.68333834,3340105.6666661757,158402,0,54,0.6649922404639331,6838035059,-63340,-63340,40081859.01666123,4424.083333823364,-728,0,-2,0.19827387799863616,-6784317093,2252.909855538186,1574.2988152166297,678.6110403215564,0.765385474209489,0.5880985795222502,-728
1495,2021-02-04,2021,206769,206769,464314596.4833333,3366180.016666665,157387,0,73,0.8574109271699333,53139449,7826747043,266142,266142,424310795.0500071,3362178.5499994243,157980,0,73,0.6696725808027238,6847100038,-59373,-59373,40003801.433326185,4001.466667240951,-593,0,0,0.18773834636720943,-6793960589,2245.571611234437,1594.302271156026,651.269340078411,0.7611730965473548,0.5935928940189823,-593
1496,2021-02-05,2021,205202,205202,464616816.7333337,3337648.800000003,155982,0,36,0.855517977407627,53202361,7842560222,266305,266305,424677251.2833354,3334097.3333328217,156496,0,36,0.6627626218058211,6859439834,-61103,-61103,39939565.44999832,3551.4666671813466,-514,0,0,0.1927553556018059,-6806237473,2264.192438345307,1594.7025075884244,669.4899307568826,0.7601387900702722,0.5876570098195678,-514
1497,2021-02-06,2021,200897,200897,464737535.46666646,3312361.1833333294,151878,0,76,0.8523870441071789,53814528,7855462339,262318,262318,424851300.6166599,3308786.7333331564,152622,0,76,0.6579571359952421,6877450618,-61421,-61421,39886234.85000658,3574.4500001729466,-744,0,0,0.19442990811193683,-6823636090,2313.3124709013396,1619.6040706953388,693.7084002060008,0.7559993429468832,0.5818205384304547,-744
1498,2021-02-07,2021,192992,192992,464830543.7333335,3202248.2833333337,147127,0,39,0.8595434007627252,53097620,7867012908,253331,253330,425074811.7166686,3200522.599999488,147990,0,39,0.6606534533870698,6889567178,-60339,-60338,39755732.01666492,1725.683333845809,-863,0,0,0.19888994737565535,-6836469558,2408.548249322944,1677.9489666311476,730.5992826917961,0.7623476620792572,0.58417643320399,-863
1499,2021-02-08,2021,183363,183363,464827918.03333324,3133273.1166666695,140989,0,43,0.8622841031178593,52960516,7880429525,242534,242534,425100632.93333125,3131478.2999997903,141683,0,44,0.6564316755588913,6909401970,-59171,-59171,39727285.10000199,1794.8166668792255,-694,0,-1,0.20585242755896804,-6856441454,2535.014795969379,1752.7465548472844,782.2682411220947,0.7689064860413497,0.5841778884609993,-694
1500,2021-02-09,2021,179430,179430,464538317.933333,3105831.5666666627,139135,0,59,0.8678258931059464,53230410,7887890235,228781,228781,424971266.8500019,3102329.499999549,139803,0,61,0.6858174411336789,6924371444,-49351,-49351,39567051.08333111,3502.066667113919,-668,0,-2,0.18200845197226745,-6871141034,2588.9668279180346,1857.546154838041,731.4206730799935,0.7754277434096862,0.6110778430026969,-668
1501,2021-02-10,2021,176093,176093,464429726.60000014,3070446.2499999986,137992,0,82,0.8690521485805793,52610061,7899126650,222294,222294,424961870.11666995,3067736.6499995594,138637,0,83,0.6933610443826697,6931613205,-46201,-46201,39467856.48333019,2709.6000004392117,-645,0,-1,0.17569110419790968,-6879003144,2637.4116324896513,1911.7109328936901,725.7006995959612,0.7836313766021363,0.6236650561868516,-645
1502,2021-02-11,2021,170169,170169,463959562.2000002,3017194.1166666653,133991,0,77,0.8699469351056894,53005587,7905926977,215362,215362,424627435.7333416,3014296.6166662583,134673,0,77,0.6924480641895929,6945346384,-45193,-45193,39332126.46665865,2897.500000406988,-682,0,0,0.1774988709160965,-6892340797,2726.4634698446853,1971.6915506604767,754.7719191842086,0.7873995851183235,0.6253331599817981,-682
1503,2021-02-12,2021,172047,172047,463994273.7666669,3033490.9499999993,135099,0,119,0.8727092015553894,53169459,7917102016,214112,214112,424718866.0500003,3030565.5999996923,135704,0,119,0.7065881407861243,6959355076,-42065,-42065,39275407.71666658,2925.350000306964,-605,0,0,0.16612106076926514,-6906185617,2696.904181803036,1983.6294371637289,713.2747446393071,0.7852447296378315,0.6337991331639515,-605
1504,2021-02-13,2021,178982,178982,464356636.46666664,3084283.9000000013,139069,0,198,0.8686013118637629,54567998,7930139011,230865,230865,425154183.3333229,3108294.233332986,146011,0,198,0.7064561540294237,6972958241,-51883,-51883,39202453.133343756,-24010.33333298471,-6942,0,0,0.16214515783433914,-6918390243,2594.432046053048,1841.5705426691914,752.8615033838566,0.7769999217798438,0.6324518658090226,-6942
1505,2021-02-14,2021,184270,184270,464767684.83333355,3140283.433333333,141418,0,132,0.8614533022195683,54272725,7942180151,234582,234582,418582415.0333305,3137669.9333329964,142302,0,118,0.6827633833797878,6756553806,-50312,-50312,46185269.80000305,2613.500000336673,-884,0,14,0.17868991883978047,-6702281081,2522.2102612109056,1784.375676877725,737.8345843331806,0.7674499375915775,0.6066194337161419,-884
1506,2021-02-15,2021,188414,188414,465545287.9666666,3154342.1333333272,144202,0,47,0.857521203307611,52180839,7961151148,237599,237599,419357451.4999929,3150490.9666663054,144910,0,47,0.6850155093245325,6752094856,-49185,-49185,46187836.46667367,3851.166667021811,-708,0,0,0.17250569398307847,-6699914017,2470.8635662247316,1764.9798673394791,705.8836988852524,0.7653465241436411,0.6098931392808892,-708
1507,2021-02-16,2021,189928,189928,465894444.3500001,3176250.566666665,145876,0,43,0.8667653005349396,53552690,7973476170,241334,241334,419720421.366665,3172601.116666459,146677,0,43,0.6878019673978812,6771328887,-51406,-51406,46174022.98333508,3649.4500002060086,-801,0,0,0.17896333313705837,-6717776197,2453.005582905101,1739.168212380622,713.8373705244792,0.7680594751695379,0.6077759453703167,-801
1508,2021-02-17,2021,187495,187495,466390784.93333286,3196263.999999999,144942,0,41,0.8685618283154212,55455723,7992316125,240682,240682,420399040.9000162,3193250.1166662234,145693,0,41,0.6818125161000833,6789027698,-53187,-53187,45991744.03331667,3013.8833337756805,-751,0,0,0.18674931221533786,-6733571975,2487.4838525471764,1746.69913371177,740.7847188354065,0.773044614523054,0.6053340091905501,-751
1509,2021-02-18,2021,199185,199185,467241649.26666707,3267842.549999998,151497,0,41,0.8512488390190026,55486059,8012461328,250005,250005,421380628.09999907,3264054.8833330953,152505,0,41,0.6847023059538786,6808331316,-50820,-50820,45861021.166668,3787.6666669026017,-1008,0,0,0.16654653306512401,-6752845257,2345.767247868399,1685.488802623944,660.278445244455,0.7605843813540176,0.6100077998440031,-1008
1510,2021-02-19,2021,212212,212212,467855419.58333313,3364523.183333336,158606,0,49,0.8354004486079954,55963210,8031765467,267633,267633,422149889.8666642,3361499.266666719,159616,0,51,0.6682247704879414,6832931987,-55421,-55421,45705529.71666896,3023.9166666166857,-1010,0,-2,0.16717567812005407,-6776968777,2204.660526187648,1577.34617878462,627.314347403028,0.7473941153186436,0.596398799849047,-1010
1511,2021-02-20,2021,213953,213953,468301070.69999987,3451390.433333329,159341,0,236,0.8352675587629064,56378982,8047900629,277870,277870,422670842.3833279,3447913.6333331433,160281,0,236,0.6484867024147966,6857059690,-63917,-63917,45630228.31667197,3476.8000001856126,-940,0,0,0.1867808563481098,-6800680708,2188.8034788014184,1521.1100240519952,667.6934547494232,0.7447476782283959,0.5768200957282182,-940
1512,2021-02-21,2021,211441,211441,468758400.0666669,3412505.2499999995,158179,0,100,0.8381250561622389,55883068,8062191800,275269,275269,423295051.76666474,3408932.299999826,159044,0,101,0.6492776157140848,6873575965,-63828,-63828,45463348.30000216,3572.9500001734123,-865,0,-1,0.18884744044815405,-6817692897,2216.9702189578506,1537.7505340836228,679.2196848742278,0.7480999427736342,0.577776647570195,-865
1513,2021-02-22,2021,215611,215611,469507116.6166666,3411552.8999999976,161476,0,36,0.8393542073456365,54558754,8083140462,293956,293956,424264985.43332815,3469560.449999808,169635,0,36,0.6466682088475891,6894246998,-78345,-78345,45242131.18333846,-58007.54999981029,-8159,0,0,0.19268599849804735,-6839688244,2177.565692922284,1443.2941849573683,734.2715079649158,0.7489228286126404,0.5770761610581175,-8159
1514,2021-02-23,2021,212404,212404,469854535.2666666,3404501.7166666663,159437,0,43,0.8411658914144738,55240168,8096527677,292128,292128,422429918.66666365,3402019.099999692,162326,0,43,0.6241544802278469,6851115800,-79724,-79724,47424616.600002944,2482.6166669745,-2889,0,0,0.21701141118662692,-6795875632,2212.079505407933,1446.0439213860489,766.0355840218842,0.7506308732415585,0.555667378683317,-2889
1515,2021-02-24,2021,217225,217225,470498192.73333377,3428889.3333333326,162966,0,54,0.8455288295546092,55495971,8114284036,285691,285691,422075842.8333295,3424876.533333007,163789,0,54,0.6479693094987365,6825724060,-68466,-68466,48422349.90000427,4012.8000003257766,-823,0,0,0.19755952005587263,-6770228089,2165.948637280855,1477.3858568639876,688.5627804168676,0.7502175164000461,0.5733082246203065,-823
1516,2021-02-25,2021,220531,220531,470983773.6833333,3457546.133333334,166369,0,41,0.8503158286136641,55491896,8125117599,287807,287807,422722181.8500017,3453388.9833329543,167330,0,41,0.6578088788667592,6844008202,-67276,-67276,48261591.833331585,4157.150000379421,-961,0,0,0.19250694974690485,-6788516306,2135.6805786185764,1468.76963329593,666.9109453226465,0.7544018754732895,0.5813965608897629,-961
1517,2021-02-26,2021,212159,212159,469352336.5166665,3419385.033333339,160270,0,41,0.8459504428282563,55989614,8107447460,281558,281558,421350823.86666065,3415448.6333330926,161101,0,41,0.6433878632466369,6838977479,-69399,-69399,48001512.65000582,3936.4000002462417,-831,0,0,0.20256257958161938,-6782987865,2212.2669154580594,1496.4974316718426,715.7694837862168,0.7554239980392065,0.5721769582110968,-831
1518,2021-02-27,2021,211792,211792,469421250.13333297,3432047.8833333314,159813,0,58,0.8448005590390575,57027222,8119091762,281389,281389,421627417.4666634,3427895.649999787,161702,0,58,0.645789281030878,6852234303,-69597,-69597,47793832.66666955,4152.23333354434,-1889,0,0,0.19901127800817953,-6795207081,2216.4257863060598,1498.379174262901,718.0466120431588,0.7545752436352647,0.5746564364634013,-1889
1519,2021-02-28,2021,215385,215385,469790375.9499992,3448951.8666666695,161973,0,35,0.8417484968776836,56912240,8134958397,282251,282251,422064671.8500063,3445956.883333197,162891,0,37,0.648004790062756,6870897816,-66866,-66866,47725704.09999293,2994.983333472628,-918,0,-2,0.19374370681492759,-6813985576,2181.1657076862325,1495.3522639423998,685.8134437438327,0.7520161571140052,0.5771139871957938,-918
1520,2021-03-01,2021,217494,217494,470411924.41666627,3443780.8000000035,163010,0,41,0.8434347614187061,56466212,8153102643,284458,284458,422837774.0499979,3440580.599999759,163717,0,42,0.6495756842837886,6891974131,-66964,-66964,47574150.36666834,3200.2000002446584,-707,0,-1,0.19385907713491746,-6835507919,2162.8731110590006,1486.4682098938963,676.4049011651043,0.7494919400075405,0.5755401500397247,-707
1521,2021-03-02,2021,217614,217614,470529409.0333335,3441613.050000001,161640,0,42,0.834904923396473,56410347,8165789738,287656,287656,423076735.59999734,3437790.8833331466,162298,0,42,0.6360618238451586,6913836904,-70042,-70042,47452673.43333614,3822.1666668546386,-658,0,0,0.1988430995513144,-6857426557,2162.220303074864,1470.7731999332443,691.4471031416199,0.7427830929995313,0.5642086380955029,-658
1522,2021-03-03,2021,235420,235420,471163953.53333336,3590108.9166666637,180911,0,34,0.8604366663834845,57215877,8178227672,305463,305463,423921095.39999205,3586725.783333162,181633,0,36,0.6675767605242072,6930167139,-70043,-70043,47242858.13334131,3383.1333335018717,-722,0,-2,0.19285990585927726,-6872951262,2001.376066321185,1387.7985071841501,613.5775591370348,0.768460623566392,0.5946153871336299,-722
1523,2021-03-04,2021,237163,237163,472109213.8166671,3713964.9166666665,183471,0,40,0.8684491257067936,57625748,8193632954,310547,310547,424926559.1499991,3710604.016666385,184313,0,40,0.6677185740000621,6947711569,-73384,-73384,47182654.666668,3360.900000281632,-842,0,0,0.20073055170673149,-6890085821,1990.652900396213,1368.316419575778,622.3364808204351,0.7736071815586748,0.5935108051277262,-842
1524,2021-03-05,2021,234194,234194,472837779.44999945,3644415.6666666674,180892,0,105,0.8700649888553927,57645426,8209353745,309722,309722,425786353.81666,3640099.6666664695,181712,0,105,0.6622939281032644,6966465223,-75528,-75528,47051425.633339465,4316.000000197906,-820,0,0,0.20777106075212837,-6908819797,2019.0003990281539,1374.7371959907916,644.2632030373622,0.7724023672681622,0.5866938738610754,-820
1525,2021-03-06,2021,222808,222808,472954385.61666685,3554195.6333333347,173806,0,169,0.883253743133102,56167323,8223068808,302615,302615,426046808.2000024,3550453.949999901,174633,0,169,0.6557209655833401,6986828546,-79807,-79807,46907577.41666448,3741.683333433699,-827,0,0,0.22753277754976187,-6930661223,2122.699299920411,1407.8839720436938,714.815327876717,0.7800707335463718,0.5770797878492474,-827
1526,2021-03-07,2021,223874,223874,473482053.50000036,3597329.0999999996,173271,0,140,0.8767923028131898,57201152,8240945067,297186,297186,426664300.999994,3593351.6499998653,174052,0,142,0.6656605627451999,7006483692,-73312,-73312,46817752.50000638,3977.4500001342967,-781,0,-2,0.21113174006798985,-6949282540,2114.9488261254114,1435.6810246781274,679.267801447284,0.7739666062159964,0.5856668887498065,-781
1527,2021-03-08,2021,232992,232992,474701083.2000004,3690263.949999997,178169,0,147,0.8589307787391839,57728949,8262670608,302946,302946,427953824.06666297,3687082.4333331147,178990,0,148,0.6654123177067817,7030351775,-69954,-69954,46747259.13333744,3181.5166668822058,-821,0,-1,0.19351846103240222,-6972622826,2037.4136588380734,1412.64061603937,624.7730427987035,0.7647000755390743,0.5908313692869356,-821
1528,2021-03-09,2021,237634,237634,475656177.8999995,3756531.599999997,185241,0,173,0.8775932736897909,57929426,8279613287,308823,308823,429052554.5333312,3752750.516666272,186072,0,174,0.6801695469573155,7051279174,-71189,-71189,46603623.366668284,3781.083333724644,-831,0,-1,0.19742372673247544,-6993349748,2001.6335116187056,1389.3154154105466,612.318096208159,0.7795222905813142,0.6025198900340972,-831
1529,2021-03-10,2021,235838,235838,476563622.466666,3741701.233333333,182575,0,167,0.8695502845173382,57165151,8298786998,310324,310324,430081124.26666105,3738652.5833332255,183373,0,169,0.6659716941003571,7071684030,-74486,-74486,46482498.200004935,3048.6500001074746,-798,0,-2,0.20357859041698112,-7014518879,2020.7244908227935,1385.9099659280657,634.8145248947278,0.7741542923532255,0.5909082120622318,-798
1530,2021-03-11,2021,239414,239414,477383276.6499998,3746140.716666666,183971,0,167,0.8662108314467826,56879642,8313716853,313203,313203,430989799.56666994,3742087.483333118,184960,0,168,0.667420171582014,7095222181,-73789,-73789,46393477.08332986,4053.2333335480653,-989,0,-1,0.19879065986476852,-7038342539,1993.9655853458853,1376.0717476099205,617.8938377359648,0.7684220638726224,0.5905435133124524,-989
1531,2021-03-12,2021,235567,235567,477802568.01666677,3703494.5166666615,180255,0,130,0.8633552237792222,55792980,8329054397,312483,312483,431533523.3833318,3699056.21666637,180976,0,130,0.655027633503259,7115058021,-76916,-76916,46269044.633334994,4438.300000291318,-721,0,0,0.20832759027596326,-7059265041,2028.3085831914775,1380.9824002692362,647.3261829222413,0.765196313575331,0.5791547060160073,-721
1532,2021-03-13,2021,229197,229197,477872734.28333294,3652492.6666666707,174899,0,142,0.8599676261033089,55623950,8339605196,305830,305830,431720576.08332753,3648341.8166664015,175638,0,142,0.6486773697805958,7131996026,-76633,-76633,46152158.20000541,4150.850000269245,-739,0,0,0.21129025632271314,-7076372076,2084.986864065991,1411.635797937833,673.351066128158,0.7630946303834693,0.5742994474054213,-739
1533,2021-03-14,2021,230788,230788,478348466.58333343,3649863.116666667,176626,0,70,0.8612709499627365,56209657,8357094724,304065,304065,432273501.94999504,3645417.3999997154,177506,0,72,0.6586157564994309,7150259543,-73277,-73277,46074964.63333839,4445.716666951776,-880,0,-2,0.20265519346330552,-7094049886,2072.674777645863,1421.6483381842536,651.0264394616092,0.7653170875435464,0.5837764951572855,-880
1534,2021-03-15,2021,237808,237808,479125596.28333306,3717177.6499999985,180335,0,174,0.8531714660566491,56695229,8376963610,310698,310698,433173450.51666623,3713601.3666663594,181208,0,175,0.6577770053234886,7167720100,-72890,-72890,45952145.76666683,3576.2833336391486,-873,0,-1,0.19539446073316047,-7111024871,2014.7581085721804,1394.1945249620733,620.5635836101071,0.7583218394671332,0.5832287301495342,-873
1535,2021-03-16,2021,238943,238943,479661433.23333234,3699013.3166666613,181158,0,225,0.8542246477193304,55727249,8390725520,314153,314153,433830633.3666639,3694798.633333075,181934,0,228,0.6543117525536912,7187748553,-75210,-75210,45830799.86666846,4214.683333586436,-776,0,-3,0.19991289516563915,-7132021304,2007.4303630293934,1380.9533360071807,626.4770270222127,0.7581640809732865,0.5791254579774823,-776
1536,2021-03-17,2021,243473,243473,480454544.0833331,3757895.2999999984,182366,0,120,0.843481618084962,57157323,8408028576,319726,319726,434801625.4833279,3753960.133333101,183276,0,120,0.6480893014643788,7208062829,-76253,-76253,45652918.60000515,3935.1666668974794,-910,0,0,0.1953923166205832,-7150905506,1973.338087111643,1359.9195107164508,613.4185763951923,0.7490193984548594,0.5732283267547837,-910
1537,2021-03-18,2021,237964,237964,481055166.53333366,3550212.1499999957,179022,0,130,0.8473466574776004,56359410,8425664310,316203,316203,435529116.76666087,3546457.9499999373,179834,0,131,0.6425524109512082,7227373209,-78239,-78239,45526049.76667279,3754.200000058394,-812,0,-1,0.20479424652639222,-7171013799,2021.545975581742,1377.3718679666572,644.1741076150847,0.7523070716578978,0.5687295819457754,-812
1538,2021-03-19,2021,237863,237863,481583936.38333344,3710624.5833333298,178567,0,129,0.8457305255546257,55040619,8438556060,317053,317053,436183758.4666575,3706278.216666569,179361,0,130,0.6390666544710261,7250211967,-79190,-79190,45400177.916675925,4346.366666760761,-794,0,-1,0.20666387108359963,-7195171348,2024.6273543314153,1375.7439874931242,648.8833668382911,0.7507136460903966,0.5657129880493167,-794
1539,2021-03-20,2021,230466,230466,481756010.5333331,3622509.133333338,174177,0,128,0.8486457872310885,57162036,8454492722,308878,308878,436401806.48332024,3618239.9166664924,174889,0,129,0.6377242794890082,7269043501,-78412,-78412,45354204.05001289,4269.216666845605,-712,0,-1,0.2109215077420803,-7211881465,2090.356106902246,1412.8614096287863,677.4946972734599,0.7557600687303117,0.56620736990009,-712
1540,2021-03-21,2021,218149,218149,481726577.5500001,3547345.9500000007,165807,0,134,0.8570014072950144,56648615,8468408099,295931,295931,436498665.1166635,3543594.966666406,166517,0,135,0.637391824445564,7287161430,-77782,-77782,45227912.433336556,3750.9833335946314,-710,0,-1,0.21960958284945042,-7230512815,2208.245637385457,1475.0014872273048,733.2441501581523,0.7600630761543715,0.5626885997073642,-710
1541,2021-03-22,2021,234387,234387,482483198.4999999,3674283.283333332,176229,0,138,0.847849923417255,56734379,8486800776,302596,302596,437362446.74999547,3670343.2333331127,176810,0,138,0.6609505743631856,7310275325,-68209,-68209,45120751.75000441,3940.05000021914,-581,0,0,0.18689934905406935,-7253540946,2058.4895855998834,1445.3675750835948,613.1220105162886,0.7518719041585071,0.5843104337135984,-581
1542,2021-03-23,2021,239506,239506,483259726.4499999,3701752.3500000043,179247,0,127,0.840029059814786,56507097,8503548615,310651,310651,438223172.0999972,3697766.166666246,179882,0,129,0.6516959546243214,7325626961,-71145,-71145,45036554.350002706,3986.183333758265,-635,0,-2,0.18833310519046464,-7269119864,2017.7353655023253,1410.6607482351487,607.0746172671766,0.7484029627650247,0.5790485142491091,-635
1543,2021-03-24,2021,241792,241792,483859264.53333306,3778075.9166666702,180114,0,58,0.8406233456855474,57534750,8516341571,322503,322503,438944816.7333281,3778688.016666549,182630,0,59,0.6403196249337195,7344147088,-80711,-80711,44914447.80000496,-612.0999998785555,-2516,0,-1,0.2003037207518279,-7286612338,2001.1384352391024,1361.0565381820575,640.0818970570449,0.74491298305982,0.5662893058359147,-2516
1544,2021-03-25,2021,246021,246021,484961391.7166671,3808545.499999999,181540,0,160,0.8292909954841251,57863565,8535072773,327087,327087,439835132.51665896,3804029.883333093,182411,0,160,0.6287837792391687,7359840887,-81066,-81066,45126259.200008154,4515.616666906048,-871,0,0,0.20050721624495638,-7301977322,1971.2194963709078,1344.7038020974817,626.5156942734261,0.7379044878282748,0.5576834297908507,-871
1545,2021-03-26,2021,245237,245237,485104172.0999996,3759229.2499999977,180433,0,80,0.8206469659961585,57797216,8540620683,324858,324858,439991925.3166687,3755223.0333332643,181135,0,80,0.6233338874215903,7368880355,-79621,-79621,45112246.78333092,4006.2166667333804,-702,0,0,0.19731307857456815,-7311083139,1978.1035165982278,1354.4130829983214,623.6904335999063,0.735749499463784,0.5575820820173737,-702
1546,2021-03-27,2021,234717,234717,485084683.06666666,3695013.866666666,175544,0,77,0.8348607045931916,56908907,8547571849,317381,317381,440084094.7166669,3691041.283333342,176206,0,78,0.6210989315680419,7382204625,-82664,-82664,45000588.349999785,3972.5833333241753,-662,0,-1,0.21376177302514976,-7325295718,2066.678949827523,1386.6113432015995,680.0676066259234,0.7478964029022184,0.5551876136252643,-662
1547,2021-03-28,2021,237001,237001,485928033.3333328,3698548.733333335,174001,0,82,0.8240302783532562,56964436,8569085817,313760,313760,441001012.6333289,3695058.6500000237,174710,0,82,0.626239801121883,7398474102,-76759,-76759,44927020.70000386,3490.083333311137,-709,0,0,0.1977904772313731,-7341509666,2050.320603429238,1405.5361187956685,644.7844846335695,0.7341783368002667,0.5568268740438552,-709
1548,2021-03-29,2021,246468,246468,486909328.86666685,3795741.7166666714,180546,0,87,0.823242773909797,57523195,8587816937,321475,321475,442182231.7666641,3791213.1833331813,181134,0,87,0.6344008087720657,7422762315,-75007,-75007,44727097.100002766,4528.533333490137,-588,0,0,0.18884196513773133,-7365239120,1975.5478555701627,1375.4793740311504,600.0684815390123,0.7325332294658942,0.5634466132669725,-588
1549,2021-03-30,2021,253151,253151,487560522.5333334,3891438.3666666676,184931,0,104,0.8220350699779966,58728205,8599992401,329918,329918,442997568.28332996,3887305.749999835,185676,0,104,0.6346516407107045,7445587302,-76767,-76767,44562954.25000346,4132.616666832473,-745,0,0,0.18738342926729212,-7386859097,1925.9671995502028,1342.75052674704,583.2166728031627,0.7305165691622787,0.5627943913336041,-745
1550,2021-03-31,2021,252200,252200,488461058.18333393,3880635.783333331,185830,0,146,0.8289770023790647,58391430,8617233519,333073,333073,443973447.13332623,3876612.4166665664,186642,0,147,0.6321256901640391,7462265879,-80873,-80873,44487611.0500077,4023.3666667644866,-812,0,-1,0.1968513122150256,-7403874449,1936.8003893074304,1332.961384241071,603.8390050663593,0.7368358445678034,0.5603636440059686,-812
1551,2021-04-01,2021,242976,242976,488693438.3166666,3794234.3000000026,180277,0,127,0.8343787040695375,57504421,8630822893,326281,326281,444322451.18332356,3789536.2833333393,181103,0,128,0.6257397764503541,7482581540,-83305,-83305,44370987.13334304,4698.016666663345,-826,0,-1,0.20863892761918346,-7425077119,2011.2827535092626,1361.7785013020175,649.5042522072451,0.7419539378374819,0.5550522402469037,-826
1552,2021-04-02,2021,237948,237948,488667547.8333332,3728331.5166666675,178635,0,124,0.8421377780019168,57103951,8639621533,317371,317371,444411907.516657,3723743.966666475,179386,0,124,0.6353479051331107,7498734178,-79423,-79423,44255640.3166762,4587.5500001925975,-751,0,0,0.20678987286880612,-7441630227,2053.673692711572,1400.2914806855604,653.3822120260118,0.7507312522063644,0.5652249260329394,-751
1553,2021-04-03,2021,227477,227477,488339695.9999997,3617192.6166666653,172290,0,142,0.8499057047525685,57084780,8647944323,304774,304774,444136975.3666639,3613430.9333332023,173000,0,143,0.6381023315637196,7509190492,-77297,-77297,44202720.63333583,3761.6833334630355,-710,0,-1,0.2118033731888489,-7452105712,2146.765149883284,1457.266615153077,689.4985347302068,0.7573952531464719,0.5676337220366566,-710
1554,2021-04-04,2021,221212,221212,488118428.5666661,3583696.549999999,167292,0,150,0.8494204654358711,56934821,8656194967,296253,296253,444051694.9333292,3579920.4499998824,167972,0,151,0.6384542941337273,7523695308,-75041,-75041,44066733.6333369,3776.1000001165085,-680,0,-1,0.2109661713021438,-7466760487,2206.563968350117,1498.8934962121202,707.670472137997,0.7562519212339295,0.5669883511728151,-680
1555,2021-04-05,2021,231361,231361,488969918.0333334,3665325.5333333355,172475,0,134,0.8354044112879864,57499613,8676655968,299297,299297,444967894.3333268,3661313.633333197,173245,0,136,0.6503306080582003,7535844486,-67936,-67936,44002023.700006604,4011.900000138674,-770,0,-2,0.18507380322978606,-7478344873,2113.450054388308,1486.7101719473526,626.7398824409556,0.7454800074342693,0.5788397478090325,-770
1556,2021-04-06,2021,236055,236055,489485713.2166656,3710683.449999996,174939,0,119,0.8295736163182308,57996118,8692465126,305861,305861,445605137.4166527,3707243.5666663954,175854,0,121,0.6451231114787378,7556286031,-69806,-69806,43880575.800012946,3439.883333600592,-915,0,-2,0.184450504839493,-7498289913,2073.608748879141,1456.887728140079,616.7210207390619,0.7410942365126771,0.5749474434465329,-915
1557,2021-04-07,2021,239442,239442,489520316.5000003,3747109.1333333333,176961,0,163,0.8281838608097164,58365204,8705051530,312195,312195,445764986.249987,3742737.416666673,177792,0,164,0.6396547029901085,7576585352,-72753,-72753,43755330.25001329,4371.716666660272,-831,0,-1,0.18852915781960788,-7518220148,2044.4212648574614,1427.841529332587,616.5797355248744,0.7390558047460345,0.5694902224571181,-831
1558,2021-04-08,2021,238015,238015,489918067.0333331,3730253.3333333335,176616,0,131,0.8354431443396427,58059865,8717265445,313963,313963,446270745.4166582,3726806.183333254,177501,0,132,0.6385975417485481,7594044475,-75948,-75948,43647321.6166749,3447.150000079535,-885,0,-1,0.19684560259109463,-7535984610,2058.3495453367777,1421.4119033665056,636.9376419702721,0.7420372665588303,0.5653564273497196,-885
1559,2021-04-09,2021,248752,248752,490624401.7166666,3863180.3833333314,192770,0,164,0.874602013250145,58889798,8732011707,324132,324132,447125179.33331966,3858904.5499997013,193659,0,165,0.6753112929300481,7613059690,-75380,-75380,43499222.383346915,4275.833333630115,-889,0,-1,0.19929072032009687,-7554169892,1972.3435458475371,1379.453985824663,592.8895600228741,0.7749485431272914,0.5974695494428196,-889
1560,2021-04-10,2021,249296,249296,491182173.61666673,3874599.966666665,191711,0,243,0.8612813683332257,58137612,8746928659,328193,328193,447826210.6333278,3870325.4333332395,192380,0,244,0.6570889689908138,7627430426,-78897,-78897,43355962.98333895,4274.53333342541,-669,0,-1,0.20419239934241185,-7569292814,1970.2769944831314,1364.5209088351298,605.7560856480015,0.7690095308388422,0.5861794736633628,-669
1561,2021-04-11,2021,246963,246963,491789703.25,3851618.1833333285,189084,0,165,0.864202329903671,57464613,8762619240,340224,340224,448501841.8499876,3858224.016666547,194942,0,166,0.6463859104589987,7644454828,-93261,-93261,43287861.400012374,-6605.83333321847,-5858,0,-1,0.21781641944467223,-7586990215,1991.3497295141378,1318.2545671380844,673.0951623760534,0.7656369577629037,0.5729813299473289,-5858
1562,2021-04-12,2021,245237,245237,492312706.9000002,3855078.650000004,189094,0,370,0.8685434905825794,57128383,8777297359,347880,347880,447923901.56665176,3913175.3333331216,196551,0,374,0.6359865470852201,7644044334,-102643,-102643,44388805.33334845,-58096.683333117515,-7457,0,-4,0.23255694349735934,-7586915951,2007.497673271163,1287.5816418496372,719.9160314215258,0.7710663562186783,0.5649965505346671,-7457
1563,2021-04-13,2021,248214,248214,492601730.18333334,3805069.233333342,188459,0,164,0.8497224169466662,57304385,8788278961,338335,338335,442784839.51666045,3801094.5333331143,189151,0,165,0.6266924793474079,7460631388,-90121,-90121,49816890.666672885,3974.700000227429,-692,0,-1,0.22302993759925827,-7403327003,1984.584794505279,1308.7172167131998,675.8675777920791,0.7592601545440628,0.5590642410628519,-692
1564,2021-04-14,2021,246109,246109,493054435.4499999,3820139.716666667,185725,0,160,0.8404812501777661,58028979,8801604462,327988,327988,443334885.86666244,3816182.133333026,186408,0,161,0.6341116138395309,7461512403,-81879,-81879,49719549.583337486,3957.583333640825,-683,0,-1,0.20636963633823524,-7403483424,2003.3986382050227,1351.6802013081651,651.7184368968576,0.7546452994404919,0.5683378660194885,-683
1565,2021-04-15,2021,249061,249061,493385977.28333354,3847645.016666663,187911,0,164,0.8386058033975602,58590300,8813162068,328671,328671,443866352.5999944,3843556.2333330647,188482,0,165,0.6388881282498363,7482185562,-79610,-79610,49519624.68333912,4088.7833335981704,-571,0,-1,0.19971767514772387,-7423595262,1980.984486866003,1350.4883381861935,630.4961486798095,0.7544778186869884,0.5734670841053819,-571
1566,2021-04-16,2021,265129,265129,493823519.0833338,3896425.850000003,193010,0,159,0.8148976535950432,59785049,8829446293,347900,347900,444459687.1166651,3892067.516666385,193896,0,160,0.6249094567404392,7497623456,-82771,-82771,49363831.966668665,4358.333333618008,-886,0,-1,0.189988196854604,-7437838407,1862.5782886192526,1277.550121059687,585.0281675595656,0.7279852449185114,0.5573325668295487,-886
1567,2021-04-17,2021,245034,245034,493612460.6166673,3790301.233333333,185127,0,161,0.844380779810148,59775586,8836448184,340928,340928,444379793.5499886,3786187.8166664904,185766,0,161,0.6100818941242782,7514447854,-95894,-95894,49232667.06667864,4113.416666842531,-639,0,0,0.23429888568586987,-7454672268,2014.4651787779135,1303.4417635101506,711.0234152677629,0.7555155611058058,0.5448833771353482,-639
1568,2021-04-18,2021,244833,244833,494189123.50000006,3806422.5666666706,184171,0,165,0.8409323906499531,59503567,8853272978,328229,328229,445047556.5999914,3802490.583333036,184817,0,166,0.6305049218685684,7529219772,-83396,-83396,49141566.90000868,3931.9833336346783,-646,0,-1,0.21042746878138463,-7469716205,2018.474321272051,1355.905653065364,662.5686682066869,0.75223111263596,0.5630733420873841,-646
1569,2021-04-19,2021,246417,246417,494969932.15000063,3830434.2,183640,0,158,0.827402330196374,60404750,8872575759,326483,326483,446046145.46666145,3826835.116666315,184326,0,159,0.628066392430837,7548617772,-80066,-80066,48923786.68333918,3599.083333685063,-686,0,-1,0.19933593776553704,-7488213022,2008.6679577707732,1366.2155317938805,642.4524259768928,0.7452407910168536,0.5645806979230159,-686
1570,2021-04-20,2021,253321,253321,495595573.7166662,3905492.2333333353,186606,0,122,0.8197978059458155,60032268,8888958201,331013,331013,446843902.28332824,3901617.6166663556,187245,0,123,0.6306247790872319,7574096512,-77692,-77692,48751671.43333799,3874.616666979622,-639,0,-1,0.18917302685858361,-7514064244,1956.3935627787125,1349.9285595530334,606.4650032256791,0.7366384942424828,0.5656726472978403,-639
1571,2021-04-21,2021,250641,250641,496151142.9166671,3889972.649999999,185290,0,42,0.823620237710511,59020657,8898704114,330889,330889,447558663.66666675,3885940.949999693,185983,0,42,0.6274218846803737,7588674068,-80248,-80248,48592479.25000036,4031.7000003061257,-693,0,0,0.19619835303013722,-7529653411,1979.5290591589849,1352.5945669595144,626.9344921994705,0.7392645257559617,0.5620706641804352,-693
1572,2021-04-22,2021,244239,244239,496592464.0999999,3810877.583333335,182079,0,36,0.8307927890304169,58731966,8915887958,326466,326466,448054006.79998755,3807161.933333064,182787,0,36,0.6250053604356974,7607275419,-82227,-82227,48538457.30001235,3715.6500002709217,-708,0,0,0.20578742859471943,-7548543453,2033.2234577606357,1372.4369667897654,660.7864909708703,0.7454951911856829,0.5598959769164323,-708
1573,2021-04-23,2021,247369,247369,496915796.30000037,3799515.350000001,183814,0,37,0.8286689116259518,59064261,8928493767,326527,326527,448507543.06667054,3797296.7999999,184802,0,37,0.6322662444453361,7626673625,-79158,-79158,48408253.23332983,2218.5500001008622,-988,0,0,0.19640266718061572,-7567609364,2008.8038367782558,1373.5695457547783,635.2342910234775,0.7430761332260711,0.5659623859588947,-988
1574,2021-04-24,2021,245514,245514,497089509.0833331,3823842.1833333336,183500,0,46,0.8327590279984031,59505549,8940491426,328248,328248,448616996.88332325,3819201.483333151,184143,0,46,0.6265811215909954,7637467389,-82734,-82734,48472512.20000982,4640.7000001827255,-643,0,0,0.20617790640740763,-7577961840,2024.6890567679768,1366.7013870101973,657.9876697577795,0.7474115529053333,0.5609874241427214,-643
1575,2021-04-25,2021,245177,245177,497671505.81666636,3834913.916666664,183069,0,38,0.8363019369679853,59780603,8958079909,324334,324334,449311142.6666647,3830809.1499999706,183759,0,38,0.6358414473968259,7654050131,-79157,-79157,48360363.150001645,4104.766666693613,-690,0,0,0.20046048957115936,-7594269528,2029.845808606298,1385.3346940705098,644.5111145357882,0.7466809692589436,0.5665733472284743,-690
1576,2021-04-26,2021,248768,248768,498542305.4500006,3873760.0666666706,185359,0,33,0.8288485657319284,59894360,8974635592,328409,328409,450313711.60000074,3869277.5666666026,186154,0,33,0.6324613515464037,7675157047,-79641,-79641,48228593.849999845,4482.500000067987,-795,0,0,0.19638721418552474,-7615262687,2004.0451563303986,1371.1978404976744,632.8473158327242,0.7451078916902496,0.5668358662521429,-795
1577,2021-04-27,2021,255758,255758,499392779.15000004,3958048.799999997,188431,0,96,0.8244004097623536,60648400,8988971169,333580,333580,451310593.2999958,3953080.6166665303,189524,0,96,0.6372714191498119,7695040107,-77822,-77822,48082185.850004256,4968.183333466761,-1093,0,0,0.18712899061254173,-7634391707,1952.598859664214,1352.930611247664,599.6682484165499,0.7367550575153075,0.5681515678397986,-1093
1578,2021-04-28,2021,265952,265952,500361901.93333316,4090520.533333329,203622,0,40,0.8585383828660803,61111324,9002852370,346497,346497,452352608.7166592,4085833.733333168,204445,0,40,0.6633592787238975,7715958396,-80545,-80545,48009293.21667397,4686.8000001609325,-823,0,0,0.19517910414218276,-7654847072,1881.3992823266346,1305.5022372968863,575.8970450297484,0.7656344001925159,0.5900339685480682,-823
1579,2021-04-29,2021,268066,268066,501204510.6666667,4111281.8333333326,204405,0,41,0.8544425626524802,60305887,9019321596,351988,351988,453367543.3833263,4105852.8166661463,205289,0,41,0.6554541632101268,7736100754,-83922,-83922,47836967.283340394,5429.016667186283,-884,0,0,0.19898839944235336,-7675794867,1869.7056346820063,1288.01988528963,581.6857493923762,0.7625174397349906,0.583227269111447,-884
1580,2021-04-30,2021,272808,272808,501910361.56666636,4138069.1500000022,212105,0,54,0.8716130025512441,61913310,9040644083,359241,359241,454150522.73332816,4132211.5333330203,213029,0,54,0.667292987159046,7758157882,-86433,-86433,47759838.8333382,5857.61666698195,-924,0,0,0.20432001539219813,-7696244572,1839.793413560696,1264.1945733736632,575.5988401870329,0.7774881968270725,0.5929974585306242,-924
1581,2021-05-01,2021,254206,254206,501112276.51666635,3945075.383333338,197602,0,44,0.8644327828611442,60729731,9047444914,351970,351970,453504347.5999952,3940126.8333330466,199504,0,44,0.6325652754496202,7775013024,-97764,-97764,47607928.91667116,4948.550000291318,-1902,0,0,0.23186750741152407,-7714283293,1971.2842203436046,1288.4744370258693,682.8097833177353,0.7773301967695491,0.5668210358837401,-1902
1582,2021-05-02,2021,241310,241310,501094604.2833327,3851493.716666667,188437,0,48,0.8660768306327957,60130120,9059855717,330181,330181,453584975.8666706,3846262.8833329375,189268,0,51,0.6380227814441091,7788750990,-88871,-88871,47509628.4166621,5230.833333729301,-831,0,-3,0.22805404918868666,-7728620870,2076.559629867526,1373.7464477564445,702.8131821110815,0.7808917989308358,0.5732249887183091,-831
1583,2021-05-03,2021,231615,231615,501514582.4666656,3775194.8166666673,180471,0,48,0.8632083414286633,59033490,9078140708,309200,309200,454089297.883333,3770879.0833330234,181296,0,48,0.6522703751617105,7806522378,-77585,-77585,47425284.5833326,4315.7333336439915,-825,0,0,0.21093796626695283,-7747488888,2165.294054645276,1468.5941069965493,696.6999476487267,0.7791852859270773,0.5863389391979301,-825
1584,2021-05-04,2021,231210,231210,501737877.30000037,3773377.2166666654,179746,0,57,0.8606937416201723,59130220,9090091104,300846,300846,454460991.69999915,3769170.716666454,180691,0,57,0.6680328141307995,7825582595,-69636,-69636,47276885.600001216,4206.50000021141,-945,0,0,0.1926609274893728,-7766452375,2170.0526677046855,1510.610051986728,659.4426157179576,0.7774144716924009,0.6006096142212295,-945
1585,2021-05-05,2021,236079,236079,502449810.98333406,3820185.7666666717,182448,0,63,0.8527357367660825,60444414,9104407395,303734,303734,455237682.6499957,3815604.999999689,183322,0,56,0.6684566100601164,7843882426,-67655,-67655,47212128.33333838,4580.766666982789,-874,0,7,0.18427912670596613,-7783438012,2128.3121793269797,1498.8038304898223,629.5083488371574,0.7728260455186611,0.6035610106211357,-874
1586,2021-05-06,2021,238113,238113,503287396.3666665,3838631.3333333377,184749,0,55,0.8570258658704057,60081171,9123019264,307652,307652,456243992.11667293,3833655.2499996666,185657,0,57,0.6702670549841897,7863169977,-69539,-69539,47043404.24999356,4976.083333671093,-908,0,-2,0.18675881088621604,-7803088806,2113.6493864957665,1482.9872457083748,630.6621407873918,0.7758879187612604,0.6034643038238009,-908
1587,2021-05-07,2021,239496,239496,503923114.7333338,3829095.0833333298,186376,0,93,0.862682466513012,60303054,9138034535,311280,311280,456996306.93333143,3824441.549999757,187376,0,93,0.6701747622718927,7879933880,-71784,-71784,46926807.800002396,4653.533333572559,-1000,0,0,0.1925077042411193,-7819630826,2104.098251049428,1468.1197215797079,635.9785294697203,0.7782008885325851,0.6019532253919301,-1000
1588,2021-05-08,2021,241780,241780,504267116.7999999,3839251.9333333327,186806,0,76,0.8578583836545631,61355857,9145767847,314981,314981,457491974.15000266,3834255.0499995886,187622,0,78,0.6641352970496697,7900589646,-73201,-73201,46775142.649997234,4996.8833337440155,-816,0,-2,0.19372308660489346,-7839233789,2085.6444569443292,1452.4430811699838,633.2013757743455,0.7726280089337414,0.5956613256037666,-816
1589,2021-05-09,2021,239096,239096,504877306.98333275,3816128.3500000024,184515,0,93,0.8582284939940442,60993743,9165086918,313847,313847,458177612.61666346,3811540.1833329946,185317,0,93,0.6592065560607497,7920870887,-74751,-74751,46699694.3666693,4588.166667007841,-802,0,0,0.19902193793329448,-7859877144,2111.6091736513063,1459.8757121038705,651.7334615474358,0.7717193093987352,0.5904692413819472,-802
1590,2021-05-10,2021,237352,237352,505616894.6833337,3782117.8666666667,183077,0,57,0.853437089217702,59895669,9186985117,314131,314131,458960939.3333374,3778162.799999701,184050,0,57,0.651190108585279,7941278216,-76779,-76779,46655955.34999627,3955.0666669658385,-973,0,0,0.20224698063242297,-7881382547,2130.2407170924776,1461.049496335406,669.1912207570715,0.7713311874346962,0.5859020599686118,-973
1591,2021-05-11,2021,241716,241716,505206454.4333338,3871900.9333333285,191063,0,45,0.8741250062056298,61458841,9181156368,313889,313889,458711385.18333054,3867980.149999784,191986,0,47,0.6795555116617714,7947921669,-72173,-72173,46495069.25000328,3920.7833335446194,-923,0,-2,0.1945694945438584,-7886462828,2090.0828014419144,1461.3808868209162,628.7019146209982,0.7904441576064473,0.611636597650762,-923
1592,2021-05-12,2021,245082,245082,505553756.4166662,3912147.899999997,194183,0,64,0.8744257024179655,60976104,9190297330,315994,315994,459115393.1166662,3908270.166666288,195046,0,64,0.6842914738887621,7962330194,-70912,-70912,46438363.30000001,3877.733333709184,-863,0,0,0.19013422852920336,-7901354090,2062.7943154400004,1452.9244008325038,609.8699146074966,0.7923184893219413,0.6172458970739951,-863
1593,2021-05-13,2021,246870,246870,505989213.94999963,3931835.5833333344,193875,0,123,0.8643982662940014,61364680,9208675480,320877,320877,459644258.350008,3927927.533333131,194798,0,124,0.6710016610726467,7976769761,-74007,-74007,46344955.59999162,3908.0500002033077,-923,0,-1,0.1933966052213547,-7915405081,2049.6180740875748,1432.462464900906,617.1556091866687,0.7853323611617451,0.607079971453236,-923
1594,2021-05-14,2021,246556,246556,506416763.03333324,3902771.150000003,192910,0,82,0.8608348610457675,60488854,9221740517,321857,321857,460271999.53333795,3898459.116666497,193736,0,82,0.6654725545817073,7996619038,-75301,-75301,46144763.49999529,4312.0333335059695,-826,0,0,0.19536230646406016,-7936130184,2053.9624386887085,1430.051232483177,623.9112062055315,0.7824185986145136,0.6019319138623674,-826
1595,2021-05-15,2021,240429,240429,506550889.7333337,3844881.4500000034,187943,0,73,0.8624417187610486,60582349,9233126451,317753,317753,460462319.93332684,3840767.2499998156,188718,0,75,0.6580110966694284,8014960386,-77324,-77324,46088569.80000687,4114.200000187848,-775,0,-2,0.20443062209162022,-7954378037,2106.8626901635566,1449.120291337381,657.7423988261755,0.7816985471802487,0.5939141408578361,-775
1596,2021-05-16,2021,237073,237073,506622305.3,3783254.799999996,184987,0,102,0.8582672847603897,59548254,9240815579,312509,312509,460665529.9500066,3779265.516666437,185691,0,103,0.6565058926302858,8027558337,-75436,-75436,45956775.34999341,3989.283333559055,-704,0,-1,0.2017613921301039,-7968010083,2136.9886292407823,1474.0872421274478,662.9013871133345,0.7802955207889553,0.5941940872102883,-704
1597,2021-05-17,2021,239825,239825,507220003.13333344,3851913.233333338,186293,0,37,0.8569373501511516,60011762,9255541285,313868,313868,461374137.749997,3847960.8499996467,187028,0,38,0.6590764270330269,8042341352,-74043,-74043,45845865.383336425,3952.383333691396,-735,0,-1,0.19786092311812464,-7982329590,2114.9588372076864,1469.9623336880377,644.9965035196487,0.7767872406963411,0.5958810710234875,-735
1598,2021-05-18,2021,241223,241223,507709742.5499996,3863592.716666661,186384,0,174,0.8517554296232114,59319984,9265539740,310851,310851,461995757.28333324,3859697.549999729,186950,0,175,0.6649713206648902,8057046121,-69628,-69628,45713985.26666635,3895.166666932404,-566,0,-1,0.1867841089583212,-7997726137,2104.7318976631564,1486.2289562630754,618.502941400081,0.7726626399638509,0.6014135389623968,-566
1599,2021-05-19,2021,240876,240876,508562423.3000002,3843835.749999998,185662,0,155,0.8508029027383381,59532247,9285978365,312554,312554,462927134.54999596,3840151.2166663986,186198,0,157,0.6590925088144535,8075270249,-71678,-71678,45635288.75000423,3684.5333335995674,-536,0,-2,0.19171039392388467,-8015738002,2111.303838074363,1481.1108945974006,630.1929434769622,0.7707783257775785,0.5957306577423421,-536
1600,2021-05-20,2021,235101,235101,508856169.1166663,3792422.483333333,182885,0,156,0.8577122173023503,59131885,9297860130,309252,309252,463337363.6833349,3788620.6499996167,183348,0,158,0.6551032814662332,8094688031,-74151,-74151,45518805.43333143,3801.833333716262,-463,0,-2,0.20260893583611705,-8035556146,2164.4151624904457,1498.2517936289332,666.1633688615125,0.7778997111879575,0.5928757130107485,-463
1601,2021-05-21,2021,241841,241841,509258147.1666663,3891028.1666666684,192781,0,150,0.8780397037723129,59303193,9310617302,313500,313500,463852689.5333331,3887652.1166663514,193260,0,151,0.6810558213716189,8112540988,-71659,-71659,45405457.633333206,3376.050000316929,-479,0,-1,0.19698388240069398,-8053237795,2105.7560428821675,1479.5939060074422,626.1621368747253,0.7971394428570838,0.6164593301435407,-479
1602,2021-05-22,2021,244948,244948,509686423.9166666,4013828.066666668,192561,0,159,0.8704418897072026,59449607,9315417767,313174,313174,464454527.8999996,4010231.9333331236,193109,0,159,0.6850313244394393,8125098204,-68226,-68226,45231896.01666701,3596.133333544247,-548,0,0,0.18541056526776334,-8065648597,2080.79438867297,1483.0558344562435,597.7385542167265,0.7861301174126754,0.6166188764073646,-548
1603,2021-05-23,2021,244611,244611,510700710.04999995,3998955.950000004,192790,0,154,0.8756719853154602,60688265,9334482305,314988,314988,465617842.81665707,3995262.149999864,193447,0,155,0.6846927502000095,8141178182,-70377,-70377,45082867.233342886,3693.800000139978,-657,0,-1,0.19097923511545067,-8080489917,2087.8076212844067,1478.208194650771,609.5994266336356,0.7881493473310686,0.6141408561595997,-657
1604,2021-05-24,2021,246461,246461,511860034.9500008,3997201.2333333357,194401,0,155,0.8741545315486028,60157531,9357297285,318867,318867,466881773.48333865,3993735.1333329966,195070,0,156,0.6798414385935234,8164689664,-72406,-72406,44978261.46666217,3466.1000003390945,-669,0,-1,0.19431309295507937,-8104532133,2076.8398852151086,1464.1896887521714,612.6501964629372,0.7887698256519287,0.611759761907002,-669
1605,2021-05-25,2021,245318,245318,512542565.0500002,4007345.500000001,194130,0,47,0.8860132562633002,60062544,9373332919,317255,317255,467648606.44999653,4003524.733332603,194987,0,49,0.6915352003908538,8188460777,-71937,-71937,44893958.60000366,3820.7666673981585,-857,0,-2,0.19447805587244638,-8128398233,2089.2986452278274,1474.0464498589354,615.252195368892,0.7913402196332923,0.6146065467841326,-857
1606,2021-05-26,2021,243092,243092,513421059.71666694,3988240.2833333337,192724,0,287,0.8815921544106763,59591061,9392216127,313323,313323,468547107.25000286,3984215.649999725,193412,0,287,0.6890429365223725,8205054645,-70231,-70231,44873952.466664076,4024.633333608508,-688,0,0,0.19254921788830381,-8145463584,2112.0442454571394,1495.4124250374305,616.6318204197089,0.7928027248942787,0.6172926979506771,-688
1607,2021-05-27,2021,247862,247862,514114380.31666595,4026773.4166666614,196479,0,261,0.8802922594024088,60044284,9405393528,316915,316915,469387417.2499983,4023446.7166662687,197054,0,261,0.692040452487256,8223899544,-69053,-69053,44726963.066667676,3326.7000003927387,-575,0,0,0.18825180691515286,-8163855260,2074.1960458507797,1481.1145488537882,593.0814969969915,0.792695128740993,0.6217881766404241,-575
1608,2021-05-28,2021,253766,253766,514829802.46666676,4056199.4499999997,201678,0,50,0.8821512732202106,60407363,9418423348,324889,324889,470230459.78333056,4052600.6666654195,202328,0,50,0.6929074237662644,8241458967,-71123,-71123,44599342.6833362,3598.78333458025,-650,0,0,0.18924384945394623,-8181051604,2028.7579993642441,1447.3572813586504,581.4007180055937,0.7947400360962461,0.6227603889328355,-650
1609,2021-05-29,2021,255821,255821,515433239.9499997,4113697.300000004,204209,0,42,0.8891334175067727,61300021,9426789204,330472,330472,470948948.9333347,4109732.7166663795,204799,0,42,0.6929089302573234,8256616754,-74651,-74651,44484291.01666498,3964.583333624527,-590,0,0,0.1962244872494493,-8195316733,2014.819893402026,1425.0797312127343,589.7401621892918,0.7982495573076487,0.6197166477038902,-590
1610,2021-05-30,2021,256120,256120,516371485.3999998,4093995.9833333325,204642,0,37,0.8844135561455571,61897051,9442874217,330310,330310,472017232.7333312,4089773.366666595,205158,0,38,0.6888861978141797,8273247007,-74190,-74190,44354252.666668594,4222.616666737478,-516,0,-1,0.19552735833137735,-8211349956,2016.131053412462,1429.0128447014356,587.1182087110265,0.7990082773699828,0.6211074445218129,-516
1611,2021-05-31,2021,258997,258997,517249237.2166664,4113192.783333328,202598,0,35,0.8626818071251794,61533955,9459552650,338577,338577,472968688.25000226,4109182.499999818,203117,0,35,0.6633321223828038,8294352946,-79580,-79580,44280548.966664135,4010.2833335101604,-519,0,0,0.19934968474237558,-8232818991,1997.1244347103109,1396.9309440688596,600.1934906414513,0.7822407209349915,0.5999137566934553,-519
1612,2021-06-01,2021,258873,258873,517815099.4833329,4125877.900000004,202337,0,39,0.8639101026372009,61211904,9470880523,336736,336736,473630541.8166696,4122125.166664793,202911,0,39,0.6678198945167658,8310744873,-77863,-77863,44184557.66666329,3752.7333352109417,-574,0,0,0.1960902081204351,-8249532969,2000.2669242575814,1406.5337291429178,593.7331951146637,0.7816071973515971,0.6025818445310273,-574
1613,2021-06-02,2021,256845,256845,518263477.49999964,4133957.400000002,201520,0,35,0.8702213397185071,60996147,9478570857,332718,332718,474249439.7166631,4129628.583333079,202134,0,35,0.6763114709754181,8328251160,-75873,-75873,44014037.78333652,4328.816666922998,-614,0,0,0.19390986874308902,-8267255013,2017.8063715470405,1425.3795698359065,592.426801711134,0.7845977145749382,0.6075234883595116,-614
1614,2021-06-03,2021,255276,255276,518803036.8499994,4109568.600000001,199827,0,42,0.8672887384634679,60810352,9487374239,331013,331013,474884934.4499982,4105501.616666317,200374,0,42,0.6727439707806129,8340341807,-75737,-75737,43918102.40000123,4066.9833336840384,-547,0,0,0.194544767682855,-8279531455,2032.3220234177886,1434.6413417297756,597.680681688013,0.7827880411789593,0.6053357421007635,-547
1615,2021-06-04,2021,256738,256738,519140922.5333338,4103175.1,202065,0,34,0.8670590251540485,61601182,9495407546,333366,333366,475325278.200002,4099175.9499996933,202758,0,37,0.6723781069455231,8354689060,-76628,-76628,43815644.333331764,3999.1500003067777,-693,0,-3,0.1946809182085254,-8293087878,2022.0649944041543,1425.8361026619452,596.228891742209,0.7870474958907524,0.6082143949892911,-693
1616,2021-06-05,2021,255916,255916,519536490.25000024,4152887.5666666655,204204,0,63,0.8764750933900181,61815147,9503786961,331740,331740,475741877.2833326,4148652.616666376,204737,0,63,0.6799059504431114,8363821144,-75824,-75824,43794612.96666765,4234.950000289362,-533,0,0,0.19656914294690664,-8302005997,2030.1055434204982,1434.0805368159781,596.0250066045201,0.7979336969943263,0.6171610297220715,-533
1617,2021-06-06,2021,260225,260225,520509744.8499996,4131076.2166666673,206577,0,39,0.874304928427323,63754374,9521660001,333375,333375,476814626.616668,4127121.5499996883,207082,0,40,0.6859632545931759,8377685218,-73150,-73150,43695118.23333162,3954.66666697897,-505,0,-1,0.18834167383414713,-8313930844,2000.229589201651,1430.2650967129148,569.9644924887361,0.7938399462004035,0.6211683539557555,-505
1618,2021-06-07,2021,255148,255148,521261303.0666673,4124042.383333339,200594,0,34,0.8689897628043326,62807972,9541696922,336559,336559,477664501.7333352,4119661.8666664725,201040,0,35,0.6616254505153647,8397512375,-81411,-81411,43596801.33333212,4380.516666866373,-446,0,-1,0.2073643122889679,-8334704403,2042.9762454209608,1419.259332638067,623.7169127828938,0.7861868405788013,0.5973395452208974,-446
1619,2021-06-08,2021,258525,258525,521818898.3833327,4161149.2833333365,201762,0,45,0.8661135286722752,62843958,9550493155,331120,331120,478300406.3166719,4157395.416666344,202097,0,45,0.6784760811790257,8418125901,-72595,-72595,43518492.06666082,3753.8666669926606,-335,0,0,0.1876374474932495,-8355281943,2018.4465656448417,1444.4926501469918,573.95391549785,0.7804351610095736,0.6103436820488041,-335
1620,2021-06-09,2021,257917,257917,522622362.1666668,4158603.650000007,202260,0,43,0.8659181054370199,62382490,9567959448,332579,332579,479152722.35000354,4155134.599999721,202632,0,43,0.6735542532751781,8435095617,-74662,-74662,43469639.816663265,3469.0500002857298,-372,0,0,0.1923638521618417,-8372713127,2026.319948536416,1440.7185130450316,585.6014354913843,0.7842057716242047,0.6092747888471611,-372
1621,2021-06-10,2021,257269,257269,521989584.0333334,4152389.4833333376,202259,0,57,0.87423280690639,62250805,9557219697,332429,332429,478664402.88332784,4148217.9999995283,202618,0,57,0.6786772513829922,8439869223,-75160,-75160,43325181.15000558,4171.483333809301,-359,0,0,0.19555555552339787,-8377618418,2028.9641738154749,1439.899656417845,589.0645173976297,0.7861771142267432,0.6095075941028009,-359
1622,2021-06-11,2021,258431,258431,522583162.03333336,4139645.0833333335,204478,0,41,0.8789270637036584,62411112,9571280556,332867,332867,479412014.11667216,4135764.8166663153,204765,0,41,0.6843033403732008,8447697904,-74436,-74436,43171147.9166612,3880.266667018179,-287,0,0,0.19462372333045752,-8385286792,2022.1380640609423,1440.2509534338706,581.8871106270717,0.7912286064752294,0.6151556026881607,-287
1623,2021-06-12,2021,256814,256814,522815757.1666665,4158668.083333333,204701,0,57,0.8814122283053106,62745871,9582371582,333150,333150,479742626.68333256,4154638.3833330935,204884,0,56,0.6810655860723386,8465138903,-76336,-76336,43073130.483333945,4029.700000239536,-183,0,1,0.20034664223297205,-8402393032,2035.7759201860745,1440.0198909900423,595.7560291960322,0.7970788196905153,0.614990244634549,-183
1624,2021-06-13,2021,256699,256699,523532454.5166666,4139201.9166666623,204339,0,72,0.8786555459896602,63240470,9595807421,330269,330269,480585231.4500084,4135571.3499997207,204539,0,71,0.6843149069394954,8479844922,-73570,-73570,42947223.0666582,3630.566666941624,-200,0,1,0.19434063905016485,-8416604452,2039.479914283525,1455.1327295326184,584.3471847509065,0.7960256954643377,0.6193103197696423,-200
1625,2021-06-14,2021,246307,246307,523708872.1999997,4057501.599999999,195021,0,52,0.8722163803708373,61134095,9608828751,325366,325366,480774683.98333406,4054765.3166662417,195238,0,52,0.6616487278941299,8500026714,-79059,-79059,42934188.216665626,2736.2833337574266,-217,0,0,0.2105676524767074,-8438892619,2126.244370643139,1477.642666976064,648.6017036670751,0.7917801767712651,0.6000565516987024,-217
1626,2021-06-15,2021,250433,250433,524235592.55000025,4083324.1000000034,199059,0,49,0.8800717157882546,62188263,9618065806,318834,318834,481413596.40000135,4080113.2166663115,199221,0,49,0.6925955199257383,8513661192,-68401,-68401,42821996.1499989,3210.8833336918615,-162,0,0,0.1874761958625163,-8451472929,2093.3167455966277,1509.919257042854,583.3974885537737,0.7948593036860159,0.6248423944748678,-162
1627,2021-06-16,2021,258383,258383,524930846.3666662,4178687.266666669,200716,0,63,0.8603313685497885,63146233,9631975434,327730,327730,482162076.75000244,4175146.2833329807,200928,0,63,0.679596008909783,8528258676,-69347,-69347,42768769.616663754,3540.9833336882293,-212,0,0,0.18073535964000553,-8465112443,2031.5997815903763,1471.2173946541434,560.3823869362329,0.7768158121857862,0.6130900436334787,-212
1628,2021-06-17,2021,260517,260517,526245837.6166661,4255741.316666667,201402,0,60,0.8532571770748167,61665200,9656468715,330581,330581,483519905.13332486,4252256.1333333375,201610,0,60,0.6738469543016699,8539591186,-70064,-70064,42725932.48334122,3485.1833333298564,-208,0,0,0.1794102227731469,-8477925986,2020.0057486331643,1462.6367066870898,557.3690419460745,0.773085825493154,0.6098656607609028,-208
1629,2021-06-18,2021,262951,262951,527539608.93333364,4265368.083333326,204950,0,92,0.8618944213940994,62093565,9679081754,335013,335013,484876234.91666937,4261060.333333071,205157,0,92,0.6779139913973387,8565618403,-72062,-72062,42663374.01666427,4307.750000254251,-207,0,0,0.18398042999676079,-8503524838,2006.2278102510872,1447.3355807585656,558.8922294925217,0.7794227821913589,0.6123851910224379,-207
1630,2021-06-19,2021,265639,265639,528362216.85000014,4303939.666666669,204968,0,56,0.8522167302241004,63560137,9697925965,339555,339555,485794055.53333384,4299854.916666853,205143,0,56,0.6678476240962427,8589583595,-73916,-73916,42568161.316666305,4084.749999815598,-175,0,0,0.18436910612785773,-8526023458,1989.0235125489862,1430.6785514374221,558.3449611115641,0.7716035672472792,0.6041524937049962,-175
1631,2021-06-20,2021,263993,263993,529186118.4166672,4262695.399999993,203771,0,58,0.8626857530313314,63794662,9717965386,339479,339479,486707280.9666725,4258045.150000014,203938,0,58,0.6723273015414646,8612277320,-75486,-75486,42478837.44999474,4650.24999997858,-167,0,0,0.19035845148986685,-8548482658,2004.5460236319418,1433.6889202768728,570.8571033550691,0.7718803150083525,0.6007381899911335,-167
1632,2021-06-21,2021,261879,261879,530341318.61666673,4256542.383333331,200212,0,67,0.8538599887734403,62561738,9742651170,340808,340808,487893050.06666094,4252302.250000212,200433,0,67,0.6578249336870108,8633467662,-78929,-78929,42448268.55000579,4240.133333118632,-221,0,0,0.1960350550864295,-8570905924,2025.1387801872877,1431.5774572975427,593.561322889745,0.764521019249348,0.5881111945728974,-221
1633,2021-06-22,2021,263047,263047,531308897.0499997,4277230.249999996,201704,0,61,0.8613821864533716,62111796,9761081555,336532,336532,488946032.233336,4272700.016666784,201910,0,61,0.6746044952634671,8655829569,-73485,-73485,42362864.81666374,4530.2333332123235,-206,0,0,0.1867776911899045,-8593717773,2019.8249630294195,1452.8961056699986,566.9288573594208,0.7667983288157629,0.5999726623322597,-206
1634,2021-06-23,2021,264105,264105,532397194.6500003,4254651.283333333,206312,0,69,0.8788019916321166,62546961,9781306471,336404,336402,490083304.6666704,4250622.450000072,206519,0,69,0.6912075956290523,8678138405,-72299,-72297,42313889.98332989,4028.833333261311,-207,0,0,0.18759439600306427,-8615591444,2015.854280115864,1456.8382609695257,559.0160191463383,0.781174154218966,0.6139017371969417,-207
1635,2021-06-24,2021,260761,260761,532130482.0000001,4180320.300000001,207018,0,78,0.8844689198154639,61748773,9780660369,337705,337705,489917502.8666643,4176149.6333330637,207196,0,78,0.6844909018225938,8700442468,-76944,-76944,42212979.13333583,4170.666666937526,-178,0,0,0.19997801799287018,-8638693695,2040.682778482979,1450.726234040551,589.9565444424281,0.7938993944646631,0.6135414044802416,-178
1636,2021-06-25,2021,262163,262163,532558212.23333305,4206473.100000002,207924,0,87,0.8810434729538492,62033992,9788348423,338311,338311,490414251.48333246,4203095.583333035,208078,0,86,0.6840067275376709,8708502521,-76148,-76148,42143960.750000596,3377.5166669674218,-154,0,1,0.19703674541617833,-8646468529,2031.4011215668613,1449.595938303314,581.8051832635474,0.7931096302681919,0.6150494663194517,-154
1637,2021-06-26,2021,260413,260413,532311451.7833328,4199321.783333336,206533,0,76,0.8929047320986281,62414730,9789800765,337301,337301,490318326.2500015,4195699.166666408,206662,0,76,0.690267743054417,8714361603,-76888,-76888,41993125.533331335,3622.6166669279337,-129,0,0,0.20263698904421112,-8651946873,2044.1047558429602,1453.6521571237604,590.4525987191998,0.7930978868182464,0.6126931138656571,-129
1638,2021-06-27,2021,258649,258649,532503785.89999974,4143965.4333333387,204963,0,67,0.8969994084647519,62766300,9796594028,334552,334552,490636817.2333326,4140138.0666665593,205080,0,67,0.6951086826562151,8725555894,-75903,-75903,41866968.66666716,3827.3666667793877,-117,0,0,0.20189072580853684,-8662789594,2058.789270014575,1466.5487494719284,592.2405205426464,0.7924368545789854,0.6129988761089457,-117
1639,2021-06-28,2021,255871,255871,533110728.6499998,4160785.283333332,202717,0,83,0.8950877590660911,63036586,9814412980,334333,334333,491325739.8000031,4156962.4999996573,202793,0,72,0.684987721822248,8735812364,-78462,-78462,41784988.849996686,3822.783333674539,-76,0,11,0.21010003724384307,-8672775778,2083.5136793540487,1469.5699790328897,613.943700321159,0.7922625072790586,0.606559926779588,-76
1640,2021-06-29,2021,252702,252702,533281163.91666657,4143951.683333333,200346,0,88,0.8962018504008666,61185249,9812757996,324029,324029,491822140.13333553,4140222.5333328065,200454,0,88,0.6999342651429561,8746629221,-71327,-71327,41459023.78333104,3729.15000052657,-108,0,0,0.19626758525791055,-8685443972,2110.316356485768,1517.833712826122,592.4826436596461,0.7928152527482965,0.6186298139981298,-108
1641,2021-06-30,2021,252124,252124,533609939.78333324,4123329.999999998,200875,0,84,0.8986213133220163,61132271,9819713915,321808,321808,492183258.10000384,4119676.9666661755,200973,0,84,0.70459715109631,8755737141,-69684,-69684,41426681.6833294,3653.033333822619,-98,0,0,0.1940241622257063,-8694604870,2116.4583291687154,1529.4313941853648,587.0269349833507,0.7967309736478876,0.6245121314572665,-98
1642,2021-07-01,2021,253427,253427,533915172.48333335,4144483.4333333345,202522,0,82,0.893933953367242,62840038,9830703855,323982,323982,492568767.5166802,4140989.1833327524,202685,0,82,0.7006376897481988,8768970000,-70555,-70555,41346404.96665317,3494.2500005820766,-163,0,0,0.19329626361904317,-8706129962,2106.78093685098,1520.3584381745904,586.4224986763898,0.7991334782797413,0.6256057435289615,-163
1643,2021-07-02,2021,256839,256839,534286190.81666714,4168699.6499999966,206135,0,114,0.8990534926549318,64031332,9837014817,325683,325683,493029416.1333306,4164910.283332874,206241,0,114,0.7099480169367048,8780450171,-68844,-68844,41256774.683336556,3789.36666712258,-106,0,0,0.189105475718227,-8716418839,2080.2377785954122,1513.8322114858024,566.4055671096098,0.8025844984601248,0.633256878621236,-106
1644,2021-07-03,2021,254933,254933,534469786.6500001,4158998.6666666623,205431,0,175,0.8887433168714911,63160053,9848379513,328258,328258,493297094.4333442,4154863.2833335116,205555,0,169,0.6908133236661547,8788126163,-73325,-73325,41172692.21665591,4135.383333150763,-124,0,6,0.19792999320533644,-8724966110,2096.5107955815847,1502.7724973446016,593.7382982369832,0.8058234908779954,0.6261995137970743,-124
1645,2021-07-04,2021,253566,253566,534948249.36666626,4100884.05,204229,0,84,0.9046678182406167,60790954,9862442342,326216,326215,493855067.7333336,4097744.6666659866,204330,0,87,0.7030035314025199,8803315484,-72650,-72649,41093181.63333267,3139.3833340131678,-101,0,-3,0.20166428683809678,-8742524530,2109.700233338327,1513.8944185072226,595.8058148311045,0.8054273837975123,0.6263641268362067,-101
1646,2021-07-05,2021,252011,252011,535266020.6000004,4064550.900000001,203050,0,105,0.8962624647336819,58659000,9869376232,327339,327338,494285386.0999971,4063097.9333330733,203238,0,105,0.6911428213564487,8818915377,-75328,-75327,40980634.50000328,1452.9666669275612,-188,0,0,0.2051196433772332,-8760256377,2123.978796957277,1510.0152933664808,613.9635035907963,0.8057187979889767,0.6208792719474306,-188
1647,2021-07-06,2021,250171,250171,535704185.01666653,4135140.2333333306,201622,0,157,0.8990690367788428,62383722,9876606316,321854,321854,494867624.66667616,4132579.8166664364,201781,0,159,0.6992456206851608,8830829669,-71683,-71683,40836560.34999037,2560.41666689422,-159,0,-2,0.19982341609368193,-8768445947,2141.3520552608675,1537.5531286442802,603.7989266165873,0.805936739270339,0.6269333300192013,-159
1648,2021-07-07,2021,259132,259132,536404780.44999975,4221201.083333334,207952,0,71,0.8985767871200777,62632552,9886682607,325327,325327,495630227.033336,4218575.766666588,208073,0,74,0.7163438632514472,8841228265,-66195,-66195,40774553.416663766,2625.3166667455807,-121,0,-3,0.18223292386863055,-8778595713,2070.005944653689,1523.4832246734393,546.5227199802496,0.8024944815769569,0.6395810984025304,-121
1649,2021-07-08,2021,261720,261720,536131051.41666657,4237219.45,209014,0,89,0.8968821641448879,62383540,9889613850,330965,330965,495464874.76667005,4233809.416666526,209184,0,90,0.7103047150000741,8846103974,-69245,-69245,40666176.64999652,3410.033333473839,-170,0,-1,0.18657744914481378,-8783720434,2048.490949933771,1497.0310297665012,551.4599201672697,0.7986168424270212,0.632042663121478,-170
1650,2021-07-09,2021,265744,265744,536421666.16666716,4238465.266666664,211573,0,74,0.891297639833826,63514809,9900705165,339099,339099,495724024.51666105,4234236.19999986,211776,0,74,0.6998103798595864,8856300213,-73355,-73355,40697641.650006115,4229.066666804254,-203,0,0,0.19148725997423965,-8792785404,2018.565484702071,1461.8858342745366,556.6796504275344,0.7961534409055332,0.6245255810250104,-203
1651,2021-07-10,2021,260729,260729,535900922.31666654,4213195.766666662,207575,0,142,0.8780956472045689,60195291,9897797925,338410,338410,495288895.65000135,4209190.1333329175,207700,0,143,0.6773588250938258,8860443454,-77681,-77681,40612026.6666652,4005.633333744481,-125,0,-1,0.20073682211074306,-8800248163,2055.39438388774,1463.576418102306,591.8179657854339,0.7961331497455212,0.6137525486835496,-125
1652,2021-07-11,2021,261669,261669,536341869.5333333,4225158.100000002,209203,0,146,0.8849768218627345,62332264,9908294185,336610,336610,495826736.98332673,4221396.466666242,209311,0,149,0.6887169127476824,8871359750,-74941,-74941,40515132.55000657,3761.6333337603137,-108,0,-3,0.1962599091150521,-8809027486,2049.695873539981,1473.0006149054595,576.6952586345217,0.7994947815751962,0.6218205044413416,-108
1653,2021-07-12,2021,266305,266305,537549451.6666671,4249710.716666671,210658,0,93,0.89033626856424,64322659,9935329437,343894,343894,497054850.99999714,4245520.933333181,210843,0,93,0.691416541143475,8892731004,-77589,-77589,40494600.666669965,4189.783333490603,-185,0,0,0.19891972742076502,-8828408345,2018.5480996100978,1445.372268780488,573.1758308296098,0.791040348472616,0.6131046194466899,-185
1654,2021-07-13,2021,266113,266113,536590607.4999993,4222895.266666668,208809,0,77,0.8800547135991102,63858843,9931700131,342387,342387,495896770.48333895,4218276.5833330825,209046,0,77,0.6843338094027969,8895791778,-76274,-76274,40693837.01666033,4618.683333585039,-237,0,0,0.19572090419631338,-8831932935,2016.4013313892942,1448.3516327528175,568.0496986364767,0.7846629063593286,0.6105547231641388,-237
1655,2021-07-14,2021,262331,262331,535025962.5666663,4232694.283333331,207459,0,72,0.8882289931422515,64432491,9913683655,339095,339095,494704801.5999925,4228835.383333226,207592,0,72,0.6883439744024551,8893538308,-76764,-76764,40321160.96667379,3858.900000105612,-133,0,0,0.19988501873979636,-8829105817,2039.5071972685894,1458.8973638655614,580.609833403028,0.7908291433341846,0.6121942228579011,-133
1656,2021-07-15,2021,265829,265829,535732377.0833332,4268580.100000004,209354,0,141,0.8859040962423212,64991639,9931002319,339804,339804,495431494.03333265,4264342.46666685,209568,0,141,0.6942266718461384,8901935476,-73975,-73975,40300883.05000055,4237.633333154023,-214,0,0,0.19167742439618285,-8836943837,2015.3270601903223,1457.9919425119558,557.3351176783665,0.7875513958221263,0.6167319984461631,-214
1657,2021-07-16,2021,268556,268556,536377943.5999999,4255210.466666665,211584,0,122,0.8860014298693754,65021434,9949482199,344800,344800,496157815.2666672,4250336.150000198,211808,0,122,0.6913950116009351,8921073508,-76244,-76244,40220128.33333272,4874.316666467115,-224,0,0,0.19460641826844027,-8856052074,1997.2666542546058,1438.9727820959024,558.2938721587034,0.7878580258865935,0.614292343387471,-224
1658,2021-07-17,2021,264608,264608,535668457.8666663,4238036.850000001,210101,0,134,0.8858273370419639,65213560,9955687249,344956,344956,495511721.46666443,4233797.933333445,210331,0,135,0.6810288848432776,8938907043,-80348,-80348,40156736.40000188,4238.916666555218,-230,0,-1,0.2047984521986863,-8873693483,2024.3849689603728,1436.4490586238953,587.9359103364775,0.7940084955859233,0.6097328354920628,-230
1659,2021-07-18,2021,263394,263394,536116874.8833329,4227352.416666665,210027,0,131,0.8957189609482387,65069547,9970769298,341165,341165,496004783.56667334,4222968.633333298,210148,0,131,0.6925651810707529,8949360134,-77771,-77771,40112091.31665957,4383.783333366737,-121,0,0,0.20315377987748573,-8884290587,2035.4179475741016,1453.856003888656,581.5619436854456,0.7973871842183193,0.6159717438775959,-121
1660,2021-07-19,2021,266416,266416,536555462.01666725,4234439.400000005,211174,0,149,0.8910200588553246,64569135,9987910105,345252,345252,496522426.000003,4230636.199999858,211369,0,150,0.689322581766373,8967456292,-78836,-78836,40033036.01666427,3803.2000001473352,-195,0,-1,0.2016974770889517,-8902887157,2013.9761201154106,1438.144966575148,575.8311535402627,0.7926475887334095,0.6122165838286238,-195
1661,2021-07-20,2021,259693,259693,535953491.6833329,4213612.733333329,206379,0,137,0.886442838274424,65295840,10002833240,338703,338703,495956595.78334147,4209946.766666372,206503,0,139,0.6807645636442462,8985252466,-79010,-79010,39996895.89999145,3665.966666956432,-124,0,-2,0.20567827463017785,-8919956626,2063.7964507450447,1464.2816738657216,599.5147768793231,0.7947037463466478,0.6096875433639501,-124
1662,2021-07-21,2021,264219,264219,536754206.38333315,4251492.383333328,210677,0,133,0.8914385415129114,66237302,10026995793,337965,337965,496763874.4833444,4247582.21666634,210753,0,134,0.6976965070347548,9004909298,-73746,-73746,39990331.89998877,3910.1666669882834,-76,0,-1,0.19374203447815652,-8938671996,2031.4746720838893,1469.86781022693,561.6068618569593,0.7973574951082246,0.6235941591584927,-76
1663,2021-07-22,2021,266642,266642,537316759.1833329,4260945.533333335,213306,0,110,0.8883559229228702,65844373,10046042220,340601,340601,497364961.050014,4257096.199999678,213461,0,110,0.6966832158449335,9027458517,-73959,-73959,39951798.1333189,3849.333333657123,-155,0,0,0.1916727070779367,-8961614144,2015.124245930247,1460.2569019175342,554.8673440127129,0.7999714973635061,0.6267186532041891,-155
1664,2021-07-23,2021,260409,260409,537491064.15,4192157.049999999,209181,0,86,0.8944199317227889,64601073,10057054879,338481,338481,497607413.40000755,4188622.36666632,209311,0,86,0.6888363010035873,9043633406,-78072,-78072,39883650.74999243,3534.6833336791024,-130,0,0,0.2055836307192016,-8979032333,2064.0264512747253,1470.1191895557138,593.9072617190116,0.8032786885245902,0.6183833065962343,-130
1665,2021-07-24,2021,256311,256311,537278617.7500004,4204851.033333331,206818,0,76,0.9035702720523116,65328763,10067019632,333234,333234,497468273.0666698,4200640.2166663185,206898,0,82,0.69550526056764,9058739210,-76923,-76923,39810344.683330536,4210.81666701287,-80,0,-6,0.2080650114846716,-8993410447,2096.1980474891843,1492.8496884071549,603.3483590820294,0.8069025519778706,0.6208790219485406,-80
1666,2021-07-25,2021,250349,250349,537574649.6166669,4135205.799999999,202715,0,62,0.9056956488741715,64532571,10078647057,322005,322005,497849768.1499992,4131264.633332789,202810,0,61,0.7049455753792678,9068306505,-71656,-71656,39724881.46666771,3941.166667209938,-95,0,1,0.2007500734949037,-9003773934,2147.300966317688,1546.093284731601,601.2076815860871,0.8097296174540342,0.6298349404512352,-95
1667,2021-07-26,2021,251313,251313,538097275.0999997,4145091.600000003,201784,0,95,0.9008606797101624,63751924,10097387049,321842,321842,498440145.7333533,4140696.133332899,201891,0,94,0.7048924627612432,9088314293,-70529,-70529,39657129.36664635,4395.466667104047,-107,0,1,0.1959682169489192,-9024562369,2141.143813093631,1548.7106895102359,592.433123583395,0.8029190690493528,0.627298488078001,-107
1668,2021-07-27,2021,251726,251726,538680552.5999998,4126866.0499999993,200404,0,144,0.8991681431397619,63808912,10112539804,322318,322317,499082553.2500253,4122725.049999586,201301,0,144,0.7065382634540934,9104465030,-70592,-70591,39597999.34997451,4141.000000413507,-897,0,0,0.19262987968566847,-9040656118,2139.948009343492,1548.4214399179232,591.5265694255686,0.7961195903482358,0.6245416017721629,-897
1669,2021-07-28,2021,259664,259664,539442548.9500004,4210727.133333339,205732,0,251,0.8857061433236794,64208721,10127342990,330987,330987,499818714.43334854,4206519.683332937,205832,0,253,0.6962962291570338,9121237757,-71323,-71323,39623834.51665187,4207.450000402518,-100,0,-2,0.18940991416664554,-9057029036,2077.463756816503,1510.0856360925006,567.3781207240024,0.7923008195206113,0.6218733666276923,-100
1670,2021-07-29,2021,263447,263447,540349200.8833332,4286980.216666666,209172,0,181,0.8843752253773999,64640765,10146001206,334359,334359,500820948.21667993,4282505.166666405,209256,0,183,0.6973791643114208,9137901251,-70912,-70912,39528252.666653275,4475.050000260584,-84,0,-2,0.1869960610659791,-9073260486,2051.0736538405567,1497.8539480518841,553.2197057886726,0.7939813321085456,0.6258422832943035,-84
1671,2021-07-30,2021,266562,266562,540958579.9666672,4278215.849999997,211366,0,272,0.8948649845064183,64723904,10156377828,339677,339677,501477275.46667445,4274310.716666516,211388,0,273,0.7020316359364906,9153057798,-73115,-73115,39481304.49999273,3905.133333480917,-22,0,-1,0.19283334856992762,-9088333894,2029.3912109252901,1476.3356820352112,553.0555288900789,0.7929337264876464,0.6223206163502386,-22
1672,2021-07-31,2021,267762,267762,541279050.5666674,4306058.833333331,213262,0,293,0.8992314069957648,65230432,10170516964,345510,345509,501898539.6833353,4302120.733333598,213360,0,296,0.6974790888830948,9169908513,-77748,-77747,39380510.88333213,3938.099999733269,-98,0,-3,0.20175231811266991,-9104678081,2021.4931564847418,1452.6352126379784,568.8579438467634,0.7964610362934248,0.617521924112182,-98
1673,2021-08-01,2021,269183,269183,541723632.7666676,4285335.883333331,214546,0,256,0.8997670729578027,62881445,10181672438,346697,346697,502395514.783328,4281805.816666855,214579,0,257,0.6984946509488077,9184630514,-77514,-77514,39328117.98333961,3530.0666664764285,-33,0,-1,0.20127242200899498,-9121749069,2012.473420560242,1449.0910356401353,563.3823849201067,0.7970265581407444,0.6189237287891156,-33
1674,2021-08-02,2021,263773,263773,541610681.0333333,4210830.116666672,209531,0,335,0.8953569925655772,61600344,10193336658,348706,348706,502330850.5166645,4206838.566666485,209585,0,338,0.6779866133648457,9200585143,-84933,-84933,39279830.5166688,3991.5500001870096,-54,0,-3,0.21737037920073154,-9138984799,2053.321155058832,1440.5569463005068,612.7642087583254,0.7943610604572872,0.6010364031591082,-54
1675,2021-08-03,2021,268190,268190,542280395.0833336,4298761.199999998,215201,0,365,0.9108206868265042,64956140,10206480249,343292,343292,503097222.3666691,4294767.900000201,215263,0,369,0.7121634060799451,9215236503,-75102,-75102,39183172.71666449,3993.2999997977167,-62,0,-4,0.19865728074655908,-9150280363,2022.0008019811835,1465.5081457379406,556.4926562432429,0.802419926171744,0.6270551017792433,-62
1676,2021-08-04,2021,269059,269059,543006717.3166673,4306332.066666667,215614,0,348,0.906094945718226,65563871,10222728686,344718,344716,503879032.35000235,4302625.833333387,215695,0,352,0.7079641910199101,9230162312,-75659,-75657,39127684.96666497,3706.23333328031,-81,0,-4,0.19813075469831587,-9164598441,2018.169685149604,1461.7222071212313,556.4474780283726,0.8013632697661108,0.6257143520210723,-81
1677,2021-08-05,2021,262649,262649,543334397.383333,4243112.183333333,210346,0,331,0.9048920803048928,63771599,10227695289,341716,341716,504275308.5166717,4239271.533333048,210411,0,334,0.696332627093829,9245933180,-79067,-79067,39059088.86666125,3840.650000284426,-65,0,-3,0.20855945321106373,-9182161581,2068.671106241916,1475.7146534451758,592.95645279674,0.8008635098553583,0.6157481651429842,-65
1678,2021-08-06,2021,266024,266024,543477841.533334,4236194.8500000015,211846,0,321,0.9065535440411393,63422545,10238423111,342433,342432,504515024.4333358,4231527.316666306,211929,0,322,0.704762683503043,9259240610,-76409,-76408,38962817.099998236,4667.533333695494,-83,0,-1,0.20179086053809625,-9195818065,2042.9654524905047,1473.3290826597274,569.6363698307773,0.7963416834571316,0.618891870818525,-83
1679,2021-08-07,2021,267866,267866,543491995.5333332,4254506.01666667,211336,0,267,0.8887764777911342,64158774,10245995242,347667,347667,504628523.24998885,4250999.850000036,211441,0,270,0.6858689493106918,9271283609,-79801,-79801,38863472.28334433,3506.166666634381,-105,0,-3,0.20290752848044247,-9207124835,2028.9696920599597,1451.4708708332653,577.4988212266944,0.7889616450016053,0.6081710372281522,-105
1680,2021-08-08,2021,266758,266758,541648682.4166666,4262469.133333337,210711,0,256,0.9019523313265208,63905594,10129580104,346552,346552,503363869.5666661,4258343.966666862,210806,0,258,0.6948105911955551,9178658416,-79794,-79794,38284812.8500005,4125.166666474193,-95,0,-2,0.20714174013096565,-9114752822,2030.4871172248504,1452.4916017413436,577.9955154835068,0.7898957107190787,0.6082954361827374,-95
1681,2021-08-09,2021,268964,268964,542491391.4,4298751.533333329,213250,0,271,0.8955250516797791,64695348,10154059511,349829,349829,504236909.4499995,4294863.566666835,213380,0,274,0.6898827712968361,9195321532,-80865,-80865,38254481.950000465,3887.966666493565,-130,0,-3,0.20564228038294308,-9130626184,2016.966550913877,1441.3811017668618,575.5854491470152,0.7928570366294374,0.6099551495159063,-130
1682,2021-08-10,2021,271037,271037,543572131.1333333,4328888.983333333,216297,0,357,0.8989879610532884,65046501,10175332089,348357,348357,505380844.0166709,4324542.1166668935,216446,0,362,0.7006547880478842,9219923068,-77320,-77320,38191287.11666244,4346.866666439921,-149,0,-5,0.1983331730054042,-9154876567,2005.5274044995087,1450.7555295764714,554.7718749230373,0.7980349546371898,0.6213338615271116,-149
1683,2021-08-11,2021,271950,271950,544397364.5333338,4298905.46666667,215738,0,264,0.8913623827909545,64615472,10195091199,349873,349873,506308211.83333176,4294857.466666908,216010,0,266,0.6949636010781027,9240261656,-77923,-77923,38089152.700002015,4047.9999997615814,-272,0,-2,0.19639878171285174,-9175646184,2001.8288822700267,1447.1199887768755,554.7088934931512,0.7933002390145247,0.6173954549222146,-272
1684,2021-08-12,2021,270501,270501,544968864.483334,4289568.083333337,215796,0,251,0.8935752548049717,64110012,10212015162,350586,350586,506919054.16666514,4286579.800000208,215921,0,256,0.6907206790915873,9262390692,-80085,-80085,38049810.31666881,2988.283333128318,-125,0,-5,0.2028545757133844,-9198280680,2014.6648791809787,1445.9192727794752,568.7456064015034,0.7977641487462154,0.6158859737696314,-125
1685,2021-08-13,2021,267658,267658,545179841.2,4261889.93333333,213914,0,321,0.9048935581974016,64909161,10222370562,347767,347767,507155220.0166663,4258382.050000017,214122,0,324,0.6976682663967487,9282485893,-80109,-80109,38024621.183333755,3507.883333313279,-208,0,-3,0.20722529180065286,-9217576732,2036.8524056818778,1458.3189894862546,578.5334161956232,0.799206450022043,0.6157053429451328,-208
1686,2021-08-14,2021,263513,263513,545027359.3166665,4247350.55,210504,0,232,0.9032191960168943,64498238,10227750334,348845,348845,507076871.13332826,4247477.866666549,212618,0,233,0.6894122031274584,9288841918,-85332,-85332,37950488.183338225,-127.31666654907167,-2114,0,-1,0.21380699288943583,-9224343680,2068.312983862908,1453.5879004524309,614.725083410477,0.7988372490161776,0.6094913213604897,-2114
1687,2021-08-15,2021,266152,266152,545509199.816666,4256710.966666662,213482,0,233,0.9091985031110038,64437080,10242403210,347691,347691,507486480.83333755,4253067.95000012,213658,0,236,0.6971304980571882,9300308339,-81539,-81539,38022718.98332846,3643.0166665418074,-176,0,-3,0.21206800505381562,-9235871259,2049.6152567580407,1459.5905008566156,590.0247559014251,0.8021055637380143,0.6145054085380409,-176
1688,2021-08-16,2021,276343,276343,546227091.3666662,4382829.450000003,218501,0,304,0.901546266777157,64238839,10260964313,355237,355237,508191040.81666356,4379153.550000686,218717,0,306,0.702820933630226,9316668698,-78894,-78894,38036050.550002635,3675.8999993167818,-216,0,-2,0.19872533314693097,-9252429859,1976.6272037528224,1430.5690027127341,546.0582010400883,0.7906876599009203,0.6156931851130372,-216
1689,2021-08-17,2021,269905,269905,546005322.0333331,4332889.95,212193,0,296,0.896148644893573,62965406,10265399425,350961,350961,508107777.14999723,4328839.116667015,212342,0,297,0.6901735520471061,9330337745,-81056,-81056,37897544.88333583,4050.8333329856396,-149,0,-1,0.20597509284646698,-9267372339,2022.9537134670832,1447.7613670749663,575.1923463921169,0.78617661769882,0.6050301885394673,-149
1690,2021-08-18,2021,271289,271289,546145280.4999999,4340551.466666667,214370,0,263,0.9019680119724722,63232769,10274102604,349324,349324,508344507.3666614,4335266.316667005,214501,0,267,0.701878485303058,9342013469,-78035,-78035,37800773.13333845,5285.149999661371,-131,0,-4,0.20008952666941426,-9278780700,2013.149373914902,1455.223538510556,557.9258354043461,0.7901905348171139,0.614045985961457,-131
1691,2021-08-19,2021,276332,276332,546849545.5833338,4361805.433333332,215672,0,243,0.8932009322119774,63433793,10286585274,353976,353976,509153142.88333297,4356882.950000429,215859,0,246,0.6985558342938379,9353663286,-77644,-77644,37696402.70000088,4922.483332903124,-187,0,-3,0.19464509791813944,-9290229493,1978.958447025078,1438.3832318669429,540.575215158135,0.7804814498501802,0.609812529663028,-187
1692,2021-08-20,2021,280592,280592,547432719.8333333,4363424.166666668,220629,0,141,0.8976699264412384,64900236,10301546151,361208,361208,509833248.96666664,4358709.950000466,220800,0,143,0.6980216385019028,9369476492,-80616,-80616,37599470.866666615,4714.216666202061,-171,0,-2,0.19964828793933564,-9304576256,1950.9919022400256,1411.4672127047756,539.52468953525,0.7862982551177511,0.6112821421452459,-171
1693,2021-08-21,2021,278737,278737,547552528.1000001,4373364.599999995,220582,0,87,0.9029658782292991,64478260,10312683415,366228,366228,510013540.28333503,4368987.883333858,220765,0,87,0.6886830062147056,9384055317,-87491,-87491,37538987.81666511,4376.716666136868,-183,0,0,0.2142828720145935,-9319577057,1964.4056156879071,1392.61208941789,571.7935262700171,0.7913624671285118,0.6028075406577323,-183
1694,2021-08-22,2021,279004,279004,547938558.1166664,4368058.349999999,220180,0,80,0.8967004057289505,64959189,10328161826,364904,364904,510462498.4333288,4364039.8000005465,220324,0,80,0.6867066406507014,9399119141,-85900,-85900,37476059.68333763,4018.549999452196,-144,0,0,0.20999376507824907,-9334159952,1963.9093278829926,1398.8953216005548,565.0140062824378,0.7891643130564436,0.6037862013022604,-144
1695,2021-08-23,2021,273969,273969,548558394.7666669,4359184.583333336,214453,0,81,0.8922651832871599,64130716,10350299279,361680,361680,511131514.0000104,4354313.300000546,214578,0,81,0.6770957752709503,9415983552,-87711,-87711,37426880.76665652,4871.283332790248,-125,0,0,0.21516940801620954,-9351852836,2002.2644706761234,1413.2147589029262,589.0497117731973,0.782763743343225,0.5932813536828135,-125
1696,2021-08-24,2021,278206,278206,548742657.7333335,4352802.700000003,216740,0,45,0.8835970467926639,64303228,10358470823,364159,364158,511380545.99999756,4349282.916667151,218218,0,45,0.6799145428233235,9437594237,-85953,-85952,37362111.73333591,3519.7833328517154,-1478,0,0,0.2036825039693404,-9373291009,1972.4328653348005,1404.2820588865206,568.1508064482798,0.7790629964846193,0.5992382448326143,-1478
1697,2021-08-25,2021,281635,281635,549696430.7333341,4412954.883333331,218813,0,78,0.8822802563601829,64348115,10376065958,367779,367779,512289854.26666033,4409745.783333981,218944,0,78,0.6767406513150502,9442244861,-86144,-86144,37406576.46667373,3209.0999993495643,-131,0,0,0.2055396050451327,-9377896746,1951.8043948136208,1392.9285094218549,558.8758853917659,0.7769382356596304,0.5953140336995859,-131
1698,2021-08-26,2021,282000,282000,550475737.4166666,4401255.666666669,218492,0,48,0.8844468085106375,64829311,10391439843,371284,371284,513159712.1166724,4403631.2333339555,220693,0,48,0.6789842815742207,9456833212,-89284,-89284,37316025.29999423,-2375.566667286679,-2201,0,0,0.20546252693641676,-9392003901,1952.0416220449172,1382.1218046473116,569.9198173976056,0.7747943262411348,0.594404822184635,-2201
1699,2021-08-27,2021,278354,278354,550784559.3166661,4338682.749999999,218014,0,78,0.8917026520186524,64370441,10404536801,371040,371040,513175678.84998894,4334839.516666974,218153,0,78,0.6699681974989203,9465765251,-92686,-92686,37608880.46667719,3843.2333330251276,-139,0,0,0.22173445451973206,-9401394810,1978.7197572755058,1383.0737355810395,595.6460216944663,0.7832256766563441,0.5879500862440707,-139
1700,2021-08-28,2021,269308,269308,550205374.8833338,4279911.766666671,212690,0,62,0.8942326258410443,63339879,10408922104,358320,358320,512646149.64999956,4276507.600000011,212756,0,62,0.6727394507702568,9476414398,-89012,-89012,37559225.23333424,3404.166666660458,-66,0,0,0.22149317507078758,-9413074519,2043.0339049836389,1430.6936527405658,612.3402522430731,0.7897648788747457,0.5937597678053137,-66
1701,2021-08-29,2021,266941,266941,550355647.2333332,4239578.583333332,211374,0,65,0.8969210424775516,62889257,10419027377,350349,350349,512916924.1833274,4235790.266666736,211438,0,65,0.6842691145115449,9487148465,-83408,-83408,37438723.05000585,3788.316666595638,-64,0,0,0.21265192796600663,-9424259208,2061.7126901949614,1464.0170920520036,597.6955981429578,0.7918378967637043,0.603506788944738,-64
1702,2021-08-30,2021,270825,270825,550452449.5666676,4291600.599999999,211838,0,66,0.8843016708206413,63750790,10430618657,351913,351913,513060777.1333386,4288149.7666667905,211906,0,67,0.6813587449170676,9502183062,-81088,-81088,37391672.433328986,3450.8333332082257,-68,0,-1,0.20294292590357366,-9438432272,2032.5023523185362,1457.9193639716025,574.5829883469337,0.7821951444659836,0.6021545097794057,-68
1703,2021-08-31,2021,274592,274592,550629821.9166671,4243247.483333331,214152,0,75,0.8836164199976684,61377990,10436576811,355118,355118,513368958.4500016,4237681.96666689,214368,0,75,0.6849047358906081,9512655077,-80526,-80526,37260863.46666551,5565.516666440293,-216,0,0,0.1987116841070603,-9451277087,2005.265346101369,1445.629223103311,559.636122998058,0.7798916210231908,0.6036528703135295,-216
1704,2021-09-01,2021,284465,284465,549574960.3166672,4395959.966666664,221441,0,80,0.8888263934051642,63355398,10426278711,367808,367808,512666717.88332725,4391484.183333803,221627,0,83,0.6885331477292538,9513525223,-83343,-83343,36908242.43333995,4475.783332861029,-186,0,-3,0.20029324567591045,-9450169825,1931.959855576845,1393.8433037979796,538.1165517788654,0.7784472606471798,0.6025616626065774,-186
1705,2021-09-02,2021,279365,279365,549607361.7500004,4270615.216666665,217860,0,77,0.8760331466003263,55513816,10427435539,366595,366595,512735437.26666075,4266616.7333337525,218121,0,77,0.6692617193360579,9510552830,-87230,-87230,36871924.48333961,3998.4833329124376,-261,0,0,0.20677142726426834,-9455039014,1967.345092441789,1398.6427454456846,568.7023469961043,0.7798399942727257,0.5949917483871847,-261
1706,2021-09-03,2021,287462,287462,549638407.2166668,4440700.750000005,223580,0,61,0.8824331563824083,63569922,10433750183,377773,377773,512795287.8999896,4438950.166667634,225268,0,61,0.6763506126695213,9519172504,-90311,-90311,36843119.31667721,1750.5833323709667,-1688,0,0,0.20608254371288692,-9455602582,1912.038485840448,1357.4164588257752,554.6220270146728,0.7777723664345201,0.5963051885656201,-1688
1707,2021-09-04,2021,288702,288702,549100263.9499997,4437642.650000005,223636,0,63,0.8799419470595967,63764054,10428231223,382158,382158,512289511.4833242,4432837.950000953,223863,0,63,0.6660334207317465,9525418297,-93456,-93456,36810752.46667546,4804.6999990521,-227,0,0,0.21390852632785018,-9461654243,1901.9621060817026,1340.5175646809023,561.4445414008003,0.7746257386509272,0.5857865071514923,-227
1708,2021-09-05,2021,285200,285200,549466665.5999994,4427215.6000000015,223225,0,44,0.8897931276297337,64484977,10440550593,377367,377367,512733604.19999826,4422979.783334073,223431,0,45,0.6736333595677374,9529823181,-92167,-92167,36733061.40000117,4235.816665928811,-206,0,-1,0.21615976806199633,-9465338204,1926.6012117812043,1358.7134121425515,567.8877996386527,0.7826963534361852,0.5920787986230911,-206
1709,2021-09-06,2021,281923,281923,549586050.7333331,4357145.266666665,218448,0,46,0.8800629959244199,63261828,10450460026,376863,376863,512871289.2833317,4352963.7166670915,218623,0,47,0.6595685965457105,9540849964,-94940,-94940,36714761.45000142,4181.549999573268,-175,0,-1,0.2204943993787094,-9477588136,1949.4189928928577,1360.8958408847027,588.523152008155,0.7748498703546713,0.580112666937322,-175
1710,2021-09-07,2021,284855,284855,549843522.3000005,4332411.283333338,219858,0,46,0.8766144178617189,62607775,10458230449,377219,377219,513161328.3999977,4327148.316667068,219971,0,46,0.6629199483589051,9551749584,-92364,-92364,36682193.90000284,5262.966666270047,-113,0,0,0.2136944695028138,-9489141809,1930.2575777149798,1360.3803848692608,569.877192845719,0.7718242614663601,0.583138707223125,-113
1711,2021-09-08,2021,287749,287749,549280852.7333336,4445688.083333335,220268,0,61,0.8726702786108725,63834811,10443487163,377150,377150,512709401.0166674,4440958.816667647,220397,0,61,0.6664801802995967,9539826272,-89401,-89401,36571451.71666616,4729.266665687785,-129,0,0,0.20619009831127588,-9475991461,1908.8888327442792,1359.4309983207409,549.4578344235383,0.7654865872687655,0.5843749171417209,-129
1712,2021-09-09,2021,291336,291336,549681820.3833333,4488060.58333333,224135,0,56,0.87746107587116,64743039,10448542294,380183,380183,513349286.90000117,4483139.416667851,224290,0,57,0.6731337277048056,9547489728,-88847,-88847,36332533.48333216,4921.166665479541,-155,0,-1,0.20432734816635434,-9482746689,1886.762433696259,1350.2689149698992,536.4935187263598,0.7693350632946152,0.5899527332889687,-155
1713,2021-09-10,2021,285261,285261,549967190.2666668,4404442.300000001,221767,0,49,0.8862129768878337,63419374,10456604123,379054,379054,513616813.4500006,4400349.150000571,221881,0,51,0.66761200251151,9557436949,-93793,-93793,36350376.816666186,4093.149999429472,-114,0,-2,0.21860097437632375,-9494017575,1927.9438488495334,1354.9964212223076,572.9474276272258,0.7774178734562384,0.5853545932769474,-114
1714,2021-09-11,2021,289068,289068,550020952.2833338,4457319.166666669,225894,0,46,0.8891679466423126,63846613,10465882312,383720,383720,513759907.3666707,4453091.4500011,226882,0,46,0.6729490253309672,9568800323,-94652,-94652,36261044.91666305,4227.7166655687615,-988,0,0,0.21621892131134535,-9504953710,1902.7389828114276,1338.8927013621148,563.8462814493128,0.7814562663456349,0.5912696758052747,-988
1715,2021-09-12,2021,286552,286552,550252264.4666667,4458953.18333333,225220,0,47,0.8908260978810125,64094495,10483630896,381086,381086,513970074.35000336,4453827.983334446,225338,0,49,0.6704917000361984,9579494168,-94534,-94534,36282190.11666334,5125.1999988835305,-118,0,-2,0.22033439784481412,-9515399673,1920.2527445862067,1348.698389208744,571.5543553774628,0.7859655490103018,0.5913048498239243,-118
1716,2021-09-13,2021,283189,283189,550777060.6000001,4453008.949999999,219719,0,40,0.8845152883763149,64011348,10501967698,379081,379081,514544007.05000293,4448528.80000094,219856,0,40,0.6618532714644045,9597818711,-95892,-95892,36233053.54999721,4480.149999058805,-137,0,0,0.22266201691191034,-9533807363,1944.9097973438238,1357.3458101302965,587.5639872135273,0.7758740629049857,0.5799710352141099,-137
1717,2021-09-14,2021,278686,278686,550940943.7833335,4479955.533333338,216003,0,43,0.88943829255865,63672592,10508058324,364556,364556,514813394.01666003,4475422.916667771,216120,0,44,0.6808364147072108,9613644776,-85870,-85870,36127549.766673505,4532.616665567271,-117,0,-1,0.20860187785143924,-9549972184,1976.9236480603029,1412.1654670795708,564.758180980732,0.7750766095175216,0.592830731081096,-117
1718,2021-09-15,2021,287754,287754,551921721.8000004,4543676.199999996,222598,0,45,0.8809086928418023,63892873,10519473210,369473,369473,515850448.58332825,4539296.1833346,222725,0,45,0.6869784801595726,9631208453,-81719,-81719,36071273.21667218,4380.016665396281,-127,0,0,0.19393021268222965,-9567315580,1918.0331873753291,1396.1790133063262,521.854174069003,0.7735704803408467,0.6028180678967069,-127
1719,2021-09-16,2021,291708,291708,552496846.5833329,4553701.383333327,225639,0,37,0.8800958492739325,63809987,10532387892,376246,376246,516479064.88333285,4549521.933334678,225847,0,39,0.6832790248932853,9640198221,-84538,-84538,36017781.70000005,4179.449998648837,-208,0,-2,0.19681682438064718,-9576388234,1894.006494793879,1372.7164272399782,521.2900675539008,0.773509811181044,0.6002641888551639,-208
1720,2021-09-17,2021,287198,287198,552473566.4333338,4398385.116666668,223163,0,135,0.8829274577121003,63219681,10541236553,378943,378943,516583248.90000063,4393797.016667485,223450,0,136,0.6704596733545563,9652637346,-91745,-91745,35890317.53333312,4588.099999182858,-287,0,-1,0.2124677843575441,-9589417665,1923.667875240544,1363.2215106229714,560.4463646175725,0.7770353553994108,0.589666519766825,-287
1721,2021-09-18,2021,284368,284368,552084850.95,4430286.283333333,223288,0,195,0.8914821639565634,63976596,10545334392,376726,376726,516253634.3166674,4425654.566667432,223456,0,197,0.6737363494954008,9665065727,-92358,-92358,35831216.63333267,4631.716665901244,-168,0,-2,0.2177458144611626,-9601089131,1941.44506748298,1370.3690064308473,571.0760610521327,0.7852078996230237,0.5931525830444407,-168
1722,2021-09-19,2021,280709,280709,552365506.95,4313776.083333332,220871,0,185,0.8943496645992828,63139057,10548594529,369466,369466,516597715.61666197,4309447.483333707,221048,0,185,0.6805605928556403,9673663037,-88757,-88757,35767791.33333808,4328.599999625236,-177,0,0,0.21378907174364248,-9610523980,1967.7513259282746,1398.228025357305,569.5233005709697,0.7868326273828057,0.5982905057569573,-177
1723,2021-09-20,2021,267122,267122,551897791.8666664,4233423.66666666,211835,0,203,0.9065707803924795,62318299,10558487920,362416,362416,516184275.7333347,4229602.349999946,211878,0,205,0.6690212352655464,9682441629,-95294,-95294,35713516.133331716,3821.316666714847,-43,0,-2,0.23754954512693316,-9620123330,2066.088872749779,1424.286664312102,641.8022084376771,0.7930271561309065,0.5846265065560019,-43
1724,2021-09-21,2021,270506,270506,551509823.5999994,4251677.299999998,212055,0,93,0.8961132100581867,62134852,10561628330,357621,357621,515913690.7833362,4247114.116666488,212179,0,94,0.6786094776313497,9691106724,-87115,-87115,35596132.816663206,4563.183333509602,-124,0,-1,0.21750373242683696,-9628971872,2038.8080988961406,1442.6269452390554,596.1811536570851,0.7839197651808093,0.5933068807480545,-124
1725,2021-09-22,2021,287472,287472,552494642.3500004,4435232.833333334,222430,0,205,0.8922573328880725,63324823,10572368824,366774,366774,516946495.8499968,4430584.000000779,222649,0,205,0.7009875291050938,9696322635,-79302,-79302,35548146.50000358,4648.8333325553685,-219,0,0,0.19126980378297875,-9632997812,1921.9076722254702,1409.441497625232,512.4661746002382,0.7737449212445038,0.6070468462868143,-219
1726,2021-09-23,2021,282379,282379,552742300.5333327,4399207.333333329,217767,0,273,0.8788790951168468,62627517,10578634261,369836,369836,517277247.6833364,4394748.166667439,217984,0,276,0.672484560724216,9708220319,-87457,-87457,35465052.84999633,4459.166665890254,-217,0,-3,0.20639453439263078,-9645592802,1957.4483248872357,1398.6665648647952,558.7817600224405,0.7711869508709925,0.5894071967034037,-217
1727,2021-09-24,2021,280232,280232,553306306.1333331,4349291.250000007,218362,0,255,0.8868330526135493,62316776,10594689176,370090,370090,517906097.1166614,4344753.6166671235,218566,0,256,0.6726093652895365,9716670345,-89858,-89858,35400209.01667166,4537.633332883939,-204,0,-1,0.21422368732401276,-9654353569,1974.457971014492,1399.405812414984,575.052158599508,0.7792186474064347,0.5905752654759653,-204
1728,2021-09-25,2021,277460,277460,553621928.2166662,4372813.666666666,217275,0,104,0.8912636055647671,64209457,10605291640,366506,366506,518324325.7166613,4367880.950000474,217440,0,108,0.6760080326106667,9731452666,-89046,-89046,35297602.50000495,4932.716666191816,-165,0,-4,0.21525557295410047,-9667243209,1995.3215894783616,1414.231487933789,581.0901015445727,0.7830858502126432,0.593278145514671,-165
1729,2021-09-26,2021,278908,278908,554240059.2499992,4301800.233333332,219296,0,42,0.8914875155965417,61591185,10617014730,363393,363393,519000207.6500105,4297555.850000102,219499,0,42,0.6852085758393858,9745532915,-84485,-84485,35239851.59998864,4244.383333230391,-203,0,0,0.20627893975715594,-9683941730,1987.1787802787985,1428.206398169504,558.9723821092946,0.7862664391125389,0.6040264947315991,-203
1730,2021-09-27,2021,274820,274820,554384258.8833332,4340711.349999997,214572,0,55,0.8975584018630371,62962996,10628158212,365724,365724,519182214.0666662,4336386.81666709,214706,0,54,0.6749488685456922,9765606219,-90904,-90904,35202044.81666702,4324.533332906663,-134,0,1,0.2226095333173449,-9702643223,2017.2631500012124,1419.6011584327696,597.6619915684428,0.7807728695145914,0.5870711246732508,-134
1731,2021-09-28,2021,275631,275631,554851007.7000008,4330320.16666667,215393,0,51,0.8948267792809955,62417163,10640620289,358242,358242,519719484.5833361,4325447.983333805,215509,0,52,0.689436191178034,9769323514,-82611,-82611,35131523.11666465,4872.183332865126,-116,0,-1,0.2053905881029615,-9706906351,2013.0210596776153,1450.7497294659368,562.2713302116786,0.7814541905663731,0.601573796483941,-116
1732,2021-09-29,2021,278152,278152,555288083.4666667,4394379.466666668,217913,0,116,0.9055013086370033,63225908,10649623768,361173,361173,520208700.383334,4390174.433333794,218083,0,116,0.698429838332325,9783640571,-83021,-83021,35079383.08333272,4205.033332874067,-170,0,0,0.20707147030467832,-9720414663,1996.347620965036,1440.3310889333754,556.0165320316605,0.7834313612700969,0.6038186686158711,-170
1733,2021-09-30,2021,280711,280711,556035052.7999994,4438037.533333334,218162,0,114,0.9017637356569574,63645457,10663272155,363316,363316,521028493.8500048,4433408.133334368,218328,0,116,0.6979984366226734,9796288017,-82605,-82605,35006558.949994564,4629.3999989666045,-166,0,-2,0.2037652990342841,-9732642560,1980.8096326827213,1434.0917929571083,546.717839725613,0.7771765267481502,0.6009314205815324,-166
1734,2021-10-01,2021,281149,281149,556251285.7166667,4429613.25,217579,0,137,0.8953437501111502,62369822,10672681130,364666,364666,521341745.166668,4425114.116667428,217725,0,137,0.6912462362819499,9807323997,-83517,-83517,34909540.5499987,4499.133332571946,-146,0,0,0.20409751382920027,-9744954175,1978.4928479797784,1429.6417685407139,548.8510794390645,0.7738921354868771,0.5970531938815244,-146
1735,2021-10-02,2021,281186,281186,556429175.1833338,4412824.766666664,215049,0,42,0.8747590562830294,62778900,10675765426,364369,364369,521582395.79999804,4408042.116667762,215231,0,44,0.6763089066303638,9819964968,-83183,-83183,34846779.38333571,4782.649998901412,-182,0,-2,0.1984501496526656,-9757186068,1978.8651468541598,1431.4675392253403,547.3976076288195,0.764792699494285,0.5906951469526771,-182
1736,2021-10-03,2021,267380,267380,556368901.2000005,4264050.966666663,209870,0,64,0.8955494053407133,62834796,10688288447,357785,357785,521595087.08333176,4259347.8166667335,210047,0,64,0.6704333608172438,9827105005,-90405,-90405,34773814.11666876,4703.149999929592,-177,0,0,0.22511604452346945,-9764270209,2080.8171935073697,1457.8450384541884,622.9721550531813,0.7849128581045702,0.5870760372849616,-177
1737,2021-10-04,2021,261307,261307,556570720.9166671,4221363.533333331,205183,0,132,0.9005537547788619,63062496,10707401100,346424,346424,521855303.3666753,4216647.249999789,205407,0,132,0.6805417638500821,9848909429,-85117,-85117,34715417.54999179,4716.283333542757,-224,0,0,0.22001199092877977,-9785846933,2129.9495264828997,1506.406321059382,623.5432054235177,0.7852181533598411,0.5929352469805788,-224
1738,2021-10-05,2021,261154,261154,556578604.5500004,4220879.749999998,205251,0,120,0.8999708983971139,62819780,10711434200,339326,339326,521952826.0000028,4216277.016665959,205480,0,121,0.694096532538048,9863509419,-78172,-78172,34625778.54999763,4602.733334039338,-229,0,-1,0.20587436585906582,-9800689639,2131.227568982288,1538.2046350707071,593.022933911581,0.7859385649846451,0.6055533616640045,-229
1739,2021-10-06,2021,263954,263954,557128347.8166662,4241878.683333334,207241,0,141,0.8991718253938191,63475589,10726994600,339245,339245,522551777.34999967,4237857.566666641,207386,0,142,0.7006912408436512,9877271874,-75291,-75291,34576570.46666658,4021.116666692309,-145,0,-1,0.19848058455016793,-9813796285,2110.7024247280447,1540.3374474200052,570.3649773080394,0.7851405926790274,0.6113163053250601,-145
1740,2021-10-07,2021,265501,265501,557670949.683333,4268870.100000001,207579,0,41,0.8954429550171189,63592494,10740135221,342559,342559,523165885.8833357,4264891.300000098,207757,0,42,0.6951386476490099,9892248330,-77058,-77058,34505063.79999733,3978.799999902956,-178,0,-1,0.200304307368109,-9828655836,2100.4476430722784,1527.2285529889325,573.2190900833459,0.781838863130459,0.6064853061808331,-178
1741,2021-10-08,2021,268241,268241,558025679.3333334,4300784.7,210172,0,50,0.9003619879138546,63679144,10751934852,345513,345513,523670031.73332846,4297153.366666961,210304,0,51,0.6998810464439851,9906996237,-77272,-77272,34355647.60000491,3631.333333038725,-132,0,-1,0.2004809414698695,-9843317093,2080.314639944428,1515.630473334805,564.6841666096232,0.7835192979447586,0.6086717431760889,-132
1742,2021-10-09,2021,266940,266940,558159000.7333338,4307615.116666664,210533,0,37,0.9046939387128198,63904426,10756627196,345162,345162,523863249.13333404,4303849.9666670505,210690,0,37,0.7005000550466239,9922944211,-78222,-78222,34295751.599999785,3765.1499996138737,-157,0,0,0.20419388366619584,-9859039785,2090.953025898456,1517.7315264523152,573.2214994461408,0.788690342399041,0.6104090253272376,-157
1743,2021-10-10,2021,264985,264985,558534629.7666668,4261146.783333334,210737,0,39,0.9167650999113153,64812940,10770255442,345286,345286,524182453.3000047,4257435.166666656,210890,0,39,0.7042306957131285,9930541607,-80301,-80301,34352176.46666205,3711.6166666783392,-153,0,0,0.2125344041981868,-9865728667,2107.7971574491644,1518.1109378891838,589.6862195599806,0.7952789780553616,0.6107690436333938,-153
1744,2021-10-11,2021,255981,255981,558883798.2833343,4205722.03333333,202777,0,47,0.9116496927506333,62501611,10781863868,338497,338497,524556578.0499945,4201679.333333228,202954,0,49,0.6902867676818398,9947550537,-82516,-82516,34327220.23333973,4042.7000001026317,-177,0,-2,0.22136292506879351,-9885048926,2183.301878980605,1549.6638908173322,633.6379881632729,0.7921564491114574,0.5995739991787224,-177
1745,2021-10-12,2021,256868,256868,558889939.0000002,4247196.416666663,203581,0,35,0.9081707336063666,62751565,10785105105,330483,330483,524605253.4333371,4244007.466666609,203639,0,35,0.7062753606085478,9962677024,-73615,-73615,34284685.566663146,3188.950000054203,-58,0,0,0.2018953729978188,-9899925459,2175.7865479545926,1587.389528155267,588.3970197993256,0.7925510378871639,0.6161860065419401,-58
1746,2021-10-13,2021,272295,272295,559162540.9666668,4344031.566666663,213151,0,48,0.8910409665987269,63414968,10784283968,343420,343420,525079137.15000355,4340585.766666863,213311,0,50,0.7073758080484702,9966220506,-71125,-71125,34083403.816663265,3445.7999997995794,-160,0,-2,0.18366515855025667,-9902805538,2053.517475409636,1528.970756362482,524.546719047154,0.7827943957839842,0.6211373827965756,-160
1747,2021-10-14,2021,273445,273445,559873468.9833335,4330568.116666674,212235,0,45,0.881786099581269,63268918,10798590027,351922,351919,525841015.4666609,4326981.96666712,212454,0,45,0.6863225373804361,9975640939,-78477,-78474,34032453.51667255,3586.1499995533377,-219,0,0,0.19546356220083283,-9912372021,2047.4810985146316,1494.2103593913967,553.270739123235,0.7761524255334711,0.6036962736060831,-219
1748,2021-10-15,2021,272560,272560,559923899.05,4295459.9,212725,0,40,0.8947828001174056,63209937,10809242542,358063,358063,525935700.7833398,4291111.76666695,212926,0,41,0.6821397351862784,9987262787,-85503,-85503,33988198.266660154,4348.133333050646,-201,0,-1,0.21264306493112728,-9924052850,2054.3142759392426,1468.8356540143488,585.4786219248938,0.7804703551511594,0.5946607161309602,-201
1749,2021-10-16,2021,258521,258521,559307660.0999999,4219961.333333329,206378,0,45,0.9226871317997378,62736735,10808337194,345139,345139,525400874.11666864,4215618.183333278,206522,0,45,0.6919907631417946,9998543335,-86618,-86618,33906785.98333126,4343.150000051595,-144,0,0,0.23069636865794318,-9935806600,2163.490239090828,1522.2877568651143,641.2024822257135,0.7983026523957435,0.5983734089743553,-144
1750,2021-10-17,2021,263733,263733,559487803.25,4157102.066666668,207185,0,31,0.8910337348758016,61785375,10816636750,344784,344784,525601652.1833314,4153186.3666664083,207296,0,33,0.6820357093136484,10005199935,-81051,-81051,33886151.06666863,3915.7000002595596,-111,0,-2,0.2089980255621532,-9943414560,2121.4175065312265,1524.437480229162,596.9800263020645,0.7855861799623104,0.6012343960276579,-111
1751,2021-10-18,2021,271339,271339,558686189.8833339,4259973.099999997,213676,0,47,0.9004750515038379,63331685,10803421667,354535,354535,524984320.98332775,4255875.683333363,213892,0,47,0.6901998392260307,10003582642,-83196,-83196,33701868.900006175,4097.4166666334495,-216,0,0,0.2102752122778072,-9940250957,2058.997010688968,1480.7686715932919,578.2283390956763,0.787487239209992,0.6033029179065537,-216
1752,2021-10-19,2021,265545,265545,558885752.0999999,4205914.066666667,210271,0,48,0.9120224444067864,60966556,10808001942,349416,349416,525234194.88333267,4201204.566666539,210477,0,48,0.6942097671543315,9999858649,-83871,-83871,33651557.216667235,4709.5000001285225,-206,0,0,0.2178126772524549,-9938892093,2104.6743568886627,1503.1772869111107,601.497069977552,0.7918469562597676,0.6023679510955423,-206
1753,2021-10-20,2021,266942,266942,559060657.1166673,4286663.65,207887,0,54,0.908695521873665,61748758,10811841385,346772,346772,525493527.5999904,4281773.8166669505,208068,0,54,0.7005236870335565,10007033949,-79830,-79830,33567129.51667684,4889.833333049901,-181,0,0,0.20817183484010848,-9945285191,2094.3150838634133,1515.3862699410288,578.9288139223845,0.7787721677368118,0.6000138419480234,-181
1754,2021-10-21,2021,266783,266783,559273159.5500005,4268574.76666667,210351,0,122,0.9225812739192519,62474158,10809717091,345680,345680,525762944.3333434,4264360.416666836,210486,0,122,0.712896320296228,10013637492,-78897,-78897,33510215.21665716,4214.349999834783,-135,0,0,0.20968495362302397,-9951163334,2096.359811344803,1520.952743385048,575.4070679597548,0.7884722789683001,0.6089041888451747,-135
1755,2021-10-22,2021,262372,262372,558988681.8833332,4241588.266666669,206663,0,60,0.9166145777750668,62401515,10808371747,342705,342705,525525746.250009,4237456.016666553,206815,0,61,0.7025896908419905,10014967944,-80333,-80333,33462935.633324206,4132.250000116415,-152,0,-1,0.2140248869330763,-9952566429,2130.5195748148935,1533.4639011686697,597.0556736462238,0.7876717027731618,0.6034782101224084,-152
1756,2021-10-23,2021,265752,265752,559149586.45,4259787.683333333,209499,0,37,0.9092499774225594,62465335,10811991098,343319,343319,525783277.83333045,4255425.06666678,209637,0,38,0.704784762859044,10014578188,-77567,-77567,33366308.616669595,4362.616666552611,-138,0,-1,0.2044652145635154,-9952112853,2104.027764419459,1531.4715405594518,572.5562238600071,0.7883252054547096,0.6106186957319577,-138
1757,2021-10-24,2021,261150,261150,559001773.5000004,4188099.483333333,206380,0,38,0.9121883974727165,61611194,10813639097,341189,341189,525659875.01666343,4183633.2333332943,206529,0,38,0.699172599351087,10018366832,-80039,-80039,33341898.483336926,4466.25000003865,-149,0,0,0.21301579812162952,-9956755638,2140.5390522688126,1540.6706400753349,599.8684121934778,0.7902737890101474,0.6053213907834074,-149
1758,2021-10-25,2021,266041,266041,559433918.1000004,4217767.399999997,207013,0,45,0.8963280095925051,61405274,10829463034,343937,343937,526160998.3000017,4214658.3333333265,207181,0,45,0.6945719710295656,10029963755,-77896,-77896,33272919.7999987,3109.0666666701436,-168,0,0,0.20175603856293955,-9968558481,2102.81091297958,1529.81795590472,572.9929570748598,0.7781244244308209,0.602380668552671,-168
1759,2021-10-26,2021,267062,267062,559196318.9666669,4254667.183333329,210696,0,42,0.9152930780118476,61587733,10825796424,347992,347992,525962617.43333787,4251279.75000003,210736,0,42,0.7027977654658871,10032145951,-80930,-80930,33233701.53332907,3387.4333332991228,-40,0,0,0.21249531254596044,-9970558218,2093.8820160362275,1511.4215770286037,582.4604390076238,0.7889403958631329,0.605577139704361,-40
1760,2021-10-27,2021,272744,272744,559561794.5000006,4343299.15,214365,0,42,0.9221614407649661,63021626,10833543305,352184,352184,526397535.4833363,4338865.016667079,214506,0,42,0.7150551984190375,10035897647,-79440,-79440,33164259.016664267,4434.133332921192,-141,0,0,0.20710624234592856,-9972876021,2051.600748320772,1494.666241178862,556.9345071419098,0.7859567946499282,0.6090736660382073,-141
1761,2021-10-28,2021,272925,272925,560095229.9166659,4334069.266666671,212500,0,54,0.9103893010900427,62610499,10841480461,352406,352406,526970472.1166673,4330705.900000503,212653,0,54,0.7061911545206287,10045647247,-79481,-79481,33124757.79999864,3363.3666661679745,-153,0,0,0.20419814656941393,-9983036748,2052.194668559736,1495.3504540690774,556.8442144906585,0.7786021800861043,0.6034318371423869,-153
1762,2021-10-29,2021,252891,252891,558893003.1499996,3883335.266666676,191889,0,71,0.8690661193953123,59572786,10837908553,338506,338506,525830786.483335,3881093.73333284,192115,0,71,0.6507211098178333,10051530405,-85615,-85615,33062216.6666646,2241.5333338361233,-226,0,0,0.21834500957747904,-9991957619,2210.015394577109,1553.3869015123366,656.6284930647723,0.7587814512971992,0.5675379461516191,-226
1763,2021-10-30,2021,227586,227586,549758749.4833332,3709010.599999998,165419,0,67,0.8301960577539916,58228569,10795935737,317127,317127,516732485.866668,3705207.7499997728,165643,0,67,0.5969911108167943,10047370536,-89541,-89541,33026263.616665244,3802.850000225473,-224,0,0,0.2332049469371973,-9989141967,2415.6088225256967,1629.418138054054,786.1906844716427,0.7268417213712619,0.5223238639409448,-224
1764,2021-10-31,2021,222855,222855,547277692.2999997,3648718.133333336,162950,0,43,0.8363509905543967,58148252,10786955022,291719,291719,514262022.8666602,3645511.049999642,163155,0,43,0.6402325525591499,10011265209,-68864,-68864,33015669.433339536,3207.0833336939104,-205,0,0,0.19611843799524675,-9953116957,2455.756847726099,1762.867769554469,692.8890781716298,0.7311929281371295,0.5592882191423939,-205
1765,2021-11-01,2021,223832,223832,546032589.1333328,3630140.266666663,163532,0,59,0.8354301440365999,57697419,10787259868,289399,289399,513074747.35000354,3626490.383333033,163685,0,59,0.6473311932660407,10002058598,-65567,-65567,32957841.783329308,3649.8833336299285,-153,0,0,0.18809895077055916,-9944361179,2439.4750935225206,1772.897443840523,666.5776496819976,0.7306015225704993,0.5656031983524477,-153
1766,2021-11-02,2021,224736,224736,544580281.7500004,3643432.6999999997,163856,0,39,0.8275487683326215,58162546,10775833631,289000,289000,511711195.7166726,3640776.3666662206,164068,0,39,0.6447993079584879,10001657534,-64264,-64264,32869086.03332776,2656.3333337791264,-212,0,0,0.18274946037413353,-9943494988,2423.20002914531,1770.626974798175,652.573054347135,0.7291043713512744,0.5677093425605536,-212
1767,2021-11-03,2021,229238,229238,543363502.3333336,3675579.9666666663,165874,0,47,0.8216918660954989,57517841,10763977508,292927,292927,510640875.8666704,3674039.166666379,166071,0,47,0.6442936294708163,9990431154,-63689,-63689,32722626.46666318,1540.8000002871267,-197,0,0,0.17739823662468268,-9932913313,2370.3029267980596,1743.2359457020707,627.0669810959889,0.7235885847896073,0.5669364722268688,-197
1768,2021-11-04,2021,231271,231271,542384538.1000005,3598318.5000000033,165644,0,46,0.8102745264213852,56929718,10752001867,295387,295387,509747684.58332264,3596049.283333023,165871,0,46,0.6359352307312156,9977243782,-64116,-64116,32636853.516677856,2269.216666980181,-227,0,0,0.1743392956901696,-9920314064,2345.2336786713445,1725.6943757962356,619.5393028751089,0.7162333366483477,0.5615379146678764,-227
1769,2021-11-05,2021,223462,223462,539193661.5500005,3525854.783333336,160707,0,60,0.8120217307640668,56137208,10723201795,297478,297478,506595552.1000049,3524533.5833328944,160987,0,61,0.6117796946328782,9969340435,-74016,-74016,32598109.449995637,1321.2000004416332,-280,0,-1,0.20024203613118863,-9913203227,2412.909852905642,1702.9681257101531,709.9417271954887,0.7191692547278732,0.5411727926098737,-280
1770,2021-11-06,2021,211303,211303,536266808.5666668,3388897.7166666696,154637,0,50,0.8240015522732754,55751429,10698248581,283934,283934,503710612.69998837,3385788.1999997427,154830,0,50,0.61447378616158,9945692979,-72631,-72631,32556195.866678417,3109.5166669269092,-193,0,0,0.20952776611169543,-9889941550,2537.9043769689347,1774.0411951368571,763.8631818320775,0.73182586144068,0.5453027816323511,-193
1771,2021-11-07,2021,168751,168751,522950941.3500005,2865955.7000000016,132224,0,34,0.8823651415399025,52028796,10585292624,251207,251207,490442281.6500033,2863607.2833328447,132342,0,34,0.5938250128380151,9912202062,-82456,-82456,32508659.699997187,2348.416667156853,-118,0,0,0.2885401287018874,-9860173266,3098.9501771841383,1952.3432135649218,1146.6069636192165,0.7835449864000806,0.5268244913557345,-118
1772,2021-11-08,2021,170801,170801,519326764.51666623,2878490.0666666646,132999,0,87,0.881704439669556,52158694,10554394279,218455,218455,486852068.25001395,2875696.8166663083,133100,0,87,0.690865395619232,9818438837,-47654,-47654,32474696.266652286,2793.250000356231,-101,0,0,0.19083904405032404,-9766280143,3040.5370256419237,2228.6149012383053,811.9221244036185,0.7786781107838947,0.6092787988372892,-101
1773,2021-11-09,2021,172256,172256,517686420.5333339,2889788.4333333336,134485,0,45,0.8809910830391982,52606597,10535851816,216465,216465,485332635.63333476,2885508.633332977,134639,0,45,0.7029311897997406,9782537444,-44209,-44209,32353784.89999914,4279.80000035651,-154,0,0,0.1780598932394576,-9729930847,3005.3317186822746,2242.0836423132364,763.2480763690382,0.780727521827977,0.6219896981036195,-154
1774,2021-11-10,2021,171856,171856,515012949.04999936,2882684.3833333366,133579,0,61,0.8758437296341113,51540546,10501803320,217847,217847,482819451.9499975,2881608.6333329873,133788,0,61,0.6931148925622067,9765290105,-45991,-45991,32193497.10000187,1075.750000349246,-209,0,0,0.18272883707190457,-9713749559,2996.770255620981,2216.3236213948207,780.4466342261603,0.7772728330695466,0.6141374450876074,-209
1775,2021-11-11,2021,173182,173182,514033187.26666594,2890794.5833333307,134417,0,202,0.880998025198925,51555990,10485825840,220790,220790,481927452.73333436,2888612.333333061,134565,0,203,0.6927895285112459,9748717803,-47608,-47608,32105734.533331573,2182.250000269618,-148,0,-1,0.18820849668767914,-9697161813,2968.167518949232,2182.7413050107994,785.4262139384327,0.7761603399891444,0.6094705376149282,-148
1776,2021-11-12,2021,174181,174181,513423216.2333331,2887500.6333333342,135496,0,185,0.8876513511806677,52231195,10479009061,224379,224379,481416153.7333432,2884879.8166663335,135624,0,188,0.6908489653666265,9737509123,-50198,-50198,32007062.499989927,2620.816667000763,-128,0,-3,0.1968023858140412,-9685277928,2947.6419140625735,2145.5490653463257,802.0928487162478,0.7779034452667053,0.6044415921276055,-128
1777,2021-11-13,2021,170675,170675,512392997.3166672,2883284.7499999944,133539,0,126,0.894261022411015,52025677,10469253331,223284,223284,480422406.3833349,2879199.5833331584,133691,0,127,0.6853110836423748,9723323262,-52609,-52609,31970590.933332324,4085.166666836012,-152,0,-1,0.2089499387686402,-9671297585,3002.1561289976107,2151.620386518223,850.5357424793879,0.7824168741760656,0.5987486788126333,-152
1778,2021-11-14,2021,169435,169435,512215656.166667,2871281.4999999977,131933,0,135,0.8891492312686283,52250274,10472041710,219932,219932,480200975.9833328,2868941.616666455,132069,0,136,0.6866576941963874,9723096023,-50497,-50497,32014680.18333417,2339.88333354285,-136,0,-1,0.20249153707224088,-9670845749,3023.080568753014,2183.4065801399197,839.6739886130945,0.7786643845722548,0.6004992452212502,-136
1779,2021-11-15,2021,174223,174223,512570284.99999964,2924474.1833333364,134824,0,73,0.8856867348168732,53169118,10481833238,224160,224160,480582657.21666753,2922086.4999998156,135016,0,73,0.6911001070663711,9727713253,-49937,-49937,31987627.78333211,2387.6833335207775,-192,0,0,0.19458662775050206,-9674544135,2942.0356956314586,2143.9269147781383,798.1087808533202,0.7738587901712174,0.6023197715917202,-192
1780,2021-11-16,2021,174844,174844,512621418.06666696,2929763.7833333346,136326,0,50,0.8875397497197505,52638659,10487155773,224536,224536,480729553.3500024,2927176.7666664445,136502,0,50,0.6935324402323021,9732701813,-49692,-49692,31891864.716664553,2587.016666890122,-176,0,0,0.19400730948744838,-9680063154,2931.878806631437,2140.9909918676844,790.8878147637524,0.779700761821967,0.6079292407453594,-176
1781,2021-11-17,2021,174220,174220,512900249.6499997,2917942.7500000023,135715,0,51,0.8892492251176668,52035493,10495534782,226243,226243,481073722.31666636,2916261.249999668,136355,0,53,0.6889273922287,9740272204,-52023,-52023,31826527.333333313,1681.5000003343448,-640,0,-2,0.20032183288896677,-9688236711,2943.9803102399246,2126.3584832090555,817.6218270308691,0.7789863391114683,0.6026926799945191,-640
1782,2021-11-18,2021,172322,172322,512672646.23333335,2899005.833333327,134491,0,37,0.8866772669769383,52064542,10493573060,225475,225475,480951365.0833284,2895303.0999996844,134653,0,38,0.6797294600288324,9747306777,-53153,-53153,31721281.150004923,3702.7333336425945,-162,0,-1,0.20694780694810588,-9695242235,2975.0852835583,2133.0584990944826,842.0267844638174,0.7804633186708604,0.5971970284953986,-162
1783,2021-11-19,2021,172153,172153,512561262.2833334,2877870.5000000037,134480,0,39,0.8881808623724248,52329521,10497893793,223239,223239,480884331.18333304,2875789.433333086,134610,0,41,0.6863854434036992,9750743138,-51086,-51086,31676931.10000038,2081.0666669178754,-130,0,-2,0.20179541896872555,-9698413617,2977.3588742765646,2154.123299169648,823.2355751069167,0.781165591073057,0.6029860373859406,-130
1784,2021-11-20,2021,168223,168223,512050023.8666668,2861236.5333333383,131433,0,66,0.8934687884534218,52641160,10498542995,221647,221647,480411044.89999574,2858669.0833331156,131545,0,69,0.6796843629735616,9757297940,-53424,-53424,31638978.96667105,2567.4500002227724,-112,0,-3,0.2137844254798602,-9704656780,3043.8764251420243,2167.460172707033,876.4162524349913,0.7813022000558782,0.5934887456180323,-112
1785,2021-11-21,2021,165397,165397,511898714.74999946,2820097.8333333363,129925,0,65,0.9000163243589665,52000474,10499170650,216428,216428,480381541.30000174,2815450.5833330527,130036,0,65,0.6888526438353508,9754721183,-51031,-51031,31517173.449997723,4647.250000283588,-111,0,0,0.21116368052361567,-9702720709,3094.9697681940993,2219.5905395789905,875.3792286151088,0.7855341995320351,0.6008279889847894,-111
1786,2021-11-22,2021,165116,165116,511838220.1166663,2821023.5000000023,130261,0,76,0.9016085660989849,52071169,10508992553,216786,216786,480347216.5833375,2818367.449999714,130383,0,76,0.6877658151356564,9761479374,-51670,-51670,31491003.53332883,2656.0500002885237,-122,0,0,0.2138427509633285,-9709408205,3099.8705159806823,2215.7667772980612,884.103738682621,0.7889059812495458,0.6014364396224848,-122
1787,2021-11-23,2021,165410,165410,511980322.03333396,2826317.916666668,130918,0,65,0.9025935554077752,52042756,10517273705,212484,212484,480515336.63332695,2824005.583333121,131064,0,65,0.7043212665424178,9767868701,-47074,-47074,31464985.40000701,2312.3333335467614,-146,0,0,0.19827228886535742,-9715825945,3095.2198901719,2261.4189145221612,833.8009756497386,0.7914757269814401,0.6168182074885639,-146
1788,2021-11-24,2021,168135,168135,512115524.6666666,2856954.1833333313,132189,0,104,0.9006928955898523,51715046,10521890455,215232,215232,480666924.64999676,2854383.799999813,132300,0,106,0.7051274903360053,9775950249,-47097,-47097,31448600.01666987,2570.38333351817,-111,0,-2,0.19556540525384702,-9724235203,3045.8591290728677,2233.250281788938,812.6088472839297,0.7862075118208582,0.614685548617306,-111
1789,2021-11-25,2021,167460,167460,512308594.86666703,2870187.58333333,131788,0,72,0.901588439030216,51036739,10525696214,215771,215771,480983493.9999994,2868590.5166664296,131997,0,72,0.7016698258802241,9780939078,-48311,-48311,31325100.86666763,1597.066666900646,-209,0,0,0.19991861314999193,-9729902339,3059.2893518850296,2229.1387350478026,830.1506168372271,0.7869819658425893,0.6117457860416831,-209
1790,2021-11-26,2021,167524,167524,512696433.78333384,2854463.766666668,131921,0,35,0.899954633365965,51498695,10531349833,216044,216044,481428216.6166692,2852029.449999734,132125,0,35,0.6999129806891213,9786319577,-48520,-48520,31268217.16666466,2434.3166669341736,-204,0,0,0.2000416526768437,-9734820882,3060.4357213493818,2228.3804068461477,832.0553145032341,0.7874752274300996,0.6115652367110403,-204
1791,2021-11-27,2021,162465,162465,512448896.183333,2821918.566666667,128795,0,43,0.9047364047641032,50954169,10528670152,212462,212462,481213305.2500019,2819926.5333330953,128997,0,42,0.6941758996902958,9793661615,-49997,-49997,31235590.933331072,1992.0333335716277,-202,0,1,0.2105605050738074,-9742707446,3154.2110373516325,2264.9382254238494,889.2728119277831,0.7927553626935032,0.6071532791746289,-202
1792,2021-11-28,2021,161789,161789,512221404.25,2811821.149999999,128042,0,60,0.9105377992323339,51282143,10529380111,209542,209542,480959797.9000072,2809270.8499996546,128233,0,60,0.7049278903513412,9794004720,-47753,-47753,31261606.34999281,2550.300000344403,-191,0,0,0.20560990888099273,-9742722577,3165.9841166581164,2295.2906715599124,870.6934450982039,0.791413507716841,0.6119680064139886,-191
1793,2021-11-29,2021,205933,205933,513027171.4499998,3136360.6999999974,147118,0,45,0.8261376272865452,55505853,10547829894,252332,252332,481833583.2166776,3132718.5166664277,147603,0,45,0.6780511389756285,9806321313,-46399,-46399,31193588.233322203,3642.183333569672,-485,0,0,0.14808648831091664,-9750815460,2491.233417907765,1909.5223087704992,581.711109137266,0.7143974010964731,0.5849555347716501,-485
1794,2021-11-30,2021,218871,218871,514383468.28333366,3676201.8999999976,160407,0,101,0.8540921364639446,61816691,10567548850,263326,263326,483313543.4166893,3671656.883332664,161760,0,101,0.7200352414877462,9798119669,-44455,-44455,31069924.866644382,4545.0166673334315,-1353,0,0,0.13405689497619833,-9736302978,2350.1673053229238,1835.4189993266493,514.7483059962744,0.7328837534438094,0.6142955879783994,-1353
1795,2021-12-01,2021,234883,234883,515834187.06666625,3833268.699999999,172823,0,42,0.8624038351008804,62936922,10589173074,291708,291708,484851331.6499932,3828272.5833334983,174488,0,39,0.707039231011829,9820651726,-56825,-56825,30982855.416673064,4996.116666500457,-1665,0,3,0.1553646040890514,-9757714804,2196.1324875221544,1662.1118778024365,534.0206097197179,0.7357833474538387,0.5981598036392557,-1665
1796,2021-12-02,2021,251835,251835,517804604.4833331,4077913.6333333356,183360,0,75,0.8559096233645043,62673681,10612824122,310856,310856,486833189.51666725,4072083.833333481,184994,0,75,0.7033031371438837,9845049383,-59021,-59021,30971414.966665864,5829.799999854527,-1634,0,0,0.15260648622062056,-9782375702,2056.12644979186,1566.1051725450602,490.02127724679985,0.7280957769968431,0.5951115629101578,-1634
1797,2021-12-03,2021,255631,255631,519635454.63333374,4133400.866666662,184526,0,44,0.8619846575728293,63214584,10640447801,321411,321411,488730606.84999937,4128195.8166668043,186233,0,42,0.6946588635734127,9873590087,-65780,-65780,30904847.783334374,5205.049999857787,-1707,0,2,0.1673257939994166,-9810375503,2032.7560218961462,1520.5783462607046,512.1776756354416,0.7218451596246152,0.5794232306921667,-1707
1798,2021-12-04,2021,247841,247841,521033728.316667,4059445.8333333298,179176,0,53,0.8656033505352229,63254983,10662912021,318506,318506,490114822.03333277,4053238.5666671055,180934,0,53,0.6835224454170317,9899765388,-70665,-70665,30918906.283334255,6207.266666224226,-1758,0,0,0.1820809051181912,-9836510405,2102.2902922303697,1538.7930589481289,563.4972332822408,0.7229473735176989,0.5680709311598525,-1758
1799,2021-12-05,2021,246832,246832,522419346.3666668,3963447.8500000024,177012,0,43,0.8515427497245103,62849585,10686430194,314907,314907,491547141.0999976,3957366.183333647,178631,0,43,0.6773364834697158,9922261122,-68075,-68075,30872205.266669214,6081.66666635545,-1619,0,0,0.17420626625479452,-9859411537,2116.497643606448,1560.9279600008815,555.5696836055665,0.717135541582939,0.5672500134960481,-1619
1800,2021-12-06,2021,242079,242079,523803901.1000001,3900215.233333336,173050,0,42,0.8415310704356841,63117109,10723565437,315982,315982,492943858.1166664,3893818.6666668146,174702,0,39,0.6541543505642705,9950900608,-73903,-73903,30860042.983333707,6396.566666521598,-1652,0,3,0.18737671987141358,-9887783499,2163.7725746553815,1560.0377810022924,603.7347936530891,0.714849284737627,0.5528859238817401,-1652
1801,2021-12-07,2021,243666,243666,525021554.85000044,3927265.4999999935,174811,0,47,0.8522567777203216,62586970,10749729354,314546,314546,494145212.5833389,3921915.433333709,176470,0,45,0.6705060627062611,9982191314,-70880,-70880,30876342.266661525,5350.066666284576,-1659,0,2,0.18175071501406048,-9919604344,2154.677118884048,1570.97916547449,583.6979534095581,0.7174205674981327,0.5610308190217012,-1659
1802,2021-12-08,2021,250924,250924,526217808.9833331,3985072.150000001,179315,0,50,0.8501458608981207,63062895,10772181476,321289,321289,495374364.4666635,3982176.033333548,182457,0,50,0.6784670499145656,10012147067,-70365,-70365,30843444.51666963,2896.116666452959,-3142,0,0,0.17167881098355509,-9949084172,2097.120279380741,1541.8341881193053,555.2860912614358,0.7146187690296664,0.567890590714279,-3142
1803,2021-12-09,2021,254936,254936,527188720.36666644,4051474.1999999993,183109,0,51,0.8520452191922673,62836667,10787584517,337193,337193,496462156.8499983,4051914.950000463,189179,0,51,0.6675108913886104,10032127262,-82257,-82257,30726563.51666814,-440.75000046379864,-6070,0,0,0.18453432780365686,-9969290595,2067.9257553529765,1472.3382657706368,595.5874895823397,0.7182547776696896,0.5610407096232721,-6070
1804,2021-12-10,2021,252189,252189,528381215.4166664,4043091.63333333,180659,0,88,0.8504375686489101,62691127,10807539991,332527,332527,494711515.41666514,4037657.033333582,182407,0,88,0.655312200212322,9888906878,-80338,-80338,33669700.00000125,5434.59999974817,-1748,0,0,0.19512536843658812,-9826215751,2095.1794702253724,1487.7333732799596,607.4460969454128,0.7163635210100361,0.5485479374607175,-1748
1805,2021-12-11,2021,242899,242899,529115124.6666666,3967143.3166666646,175624,0,111,0.8542357111391969,62755767,10832664040,317679,317679,495554274.84999734,3961147.616667075,177307,0,113,0.6623446938576387,9906867985,-74780,-74780,33560849.816669285,5995.699999589473,-1683,0,-2,0.19189101728155822,-9844112218,2178.333894609145,1559.9214139115186,618.4124806976263,0.7230330301895026,0.5581325803720107,-1683
1806,2021-12-12,2021,227832,227832,529748975.4166665,3779633.750000001,164692,0,119,0.8491168931493381,62382744,10859658587,301225,301225,496204820.01666135,3774506.616666907,166431,0,121,0.652581957008889,9934651052,-73393,-73393,33544155.40000516,5127.133333093952,-1739,0,-2,0.19653493614044915,-9872268308,2325.1737043815906,1647.2896340498344,677.8840703317562,0.7228659714175357,0.5525139015685949,-1739
1807,2021-12-13,2021,244026,244026,531036286.0333331,3929678.283333335,176620,0,157,0.8559948530074669,62703696,10888692861,325000,325000,497536175.5166955,3934097.2333328477,188330,0,158,0.6839876923076841,9964954240,-80974,-80974,33500110.516637623,-4418.949999512639,-11710,0,-1,0.17200716069978284,-9902250544,2176.1463370023403,1530.8805400513709,645.2657969509694,0.7237753354150788,0.5794769230769231,-11710
1808,2021-12-14,2021,256368,256368,532293653.5666668,4120821.8666666686,183225,0,171,0.8519667041128377,63941340,10912794094,323166,323166,483792757.66666186,4114918.5833336497,184907,0,177,0.685328902174119,9335153427,-66798,-66798,48500895.90000492,5903.283333018888,-1682,0,-6,0.1666378019387187,-9271212087,2076.2874210769937,1497.0410181351438,579.24640294185,0.7146952817824378,0.5721734340865067,-1682
1809,2021-12-15,2021,255183,255183,533707616.7500002,4110403.8333333256,179281,0,125,0.829886787129236,63425262,10938610180,324640,324640,485269356.39999896,4104780.483333446,181063,0,129,0.6632731641202623,9357424642,-69457,-69457,48438260.350001216,5623.349999879487,-1782,0,-4,0.16661362300897375,-9293999380,2091.4701087063017,1494.7922511089175,596.6778575973842,0.7025585560166625,0.5577347215377033,-1782
1810,2021-12-16,2021,246273,246273,534621620.6999998,3872922.183333337,174776,0,111,0.8331242158092846,62596678,10969488512,320141,320141,486168883.766674,3868694.566666024,176300,0,111,0.6495356733439185,9386700407,-73868,-73868,48452736.93332583,4227.616667313036,-1524,0,0,0.18358854246536616,-9324103729,2170.849507254144,1518.6086248455335,652.2408824086106,0.7096839686039477,0.5506948500816827,-1524
1811,2021-12-17,2021,222503,222503,534121723.04999995,3694624.1499999953,160054,0,110,0.8475750888752072,62617906,10989220725,304841,304841,485747347.5500078,3689418.7333331276,161328,0,110,0.6270088341135278,9413644216,-82338,-82338,48374375.49999213,5205.416666867677,-1274,0,0,0.22056625476167935,-9351026310,2400.5147033972576,1593.4449353925745,807.069768004683,0.7193341213376898,0.5292201508327292,-1274
1812,2021-12-18,2021,221727,221727,534573648.40000033,3727272.2166666654,163674,0,53,0.8645676890951483,62894116,11005491829,289560,289560,486287709.13333184,3721777.450000209,165239,0,53,0.6717916839342433,9437783637,-67833,-67833,48285939.2666685,5494.766666456591,-1565,0,0,0.19277600516090498,-9374889521,2410.9542292999968,1679.4022279780766,731.5520013219202,0.7381780297392739,0.5706554772758669,-1565
1813,2021-12-19,2021,232869,232869,535592112.9666674,3870730.4666666677,169553,0,59,0.8627597490434531,62785238,11030484601,291344,291344,487357831.4666697,3864782.1666669673,171106,0,60,0.6997295293536118,9459914398,-58475,-58475,48234281.499997735,5948.2999997003935,-1553,0,-1,0.16303021968984133,-9397129160,2299.971713567145,1672.791722042224,627.179991524921,0.7281046425243377,0.5872988631995167,-1553
1814,2021-12-20,2021,243592,243592,537396994.3166672,3965349.2333333325,176022,0,95,0.8554878649545133,63363177,11061973606,303600,303600,489240644.0833324,3959354.366666898,177603,0,95,0.6962154150197627,9489716779,-60008,-60008,48156350.23333478,5994.866666434333,-1581,0,0,0.15927244993475065,-9426353602,2206.1356461487535,1611.4645720794877,594.6710740692658,0.722609937928996,0.5849901185770751,-1581
1815,2021-12-21,2021,242922,242922,538465154.4500004,3873043.716666669,173773,0,66,0.8414758646808445,62360225,11082824976,310706,310706,490295847.549996,3867256.616666897,176883,0,66,0.6722593062251699,9518661096,-67784,-67784,48169306.90000439,5787.099999771919,-3110,0,0,0.16921655845567452,-9456300871,2216.6174922403093,1578.0057274400751,638.6117648002341,0.7153448432006981,0.5692938018577047,-3110
1816,2021-12-22,2021,237717,237717,538879087.6999992,3863356.683333335,168900,0,47,0.8302098714017094,62218031,11104854294,311303,311303,489615810.16666925,3858582.2500000037,170703,0,48,0.6439803021493643,9490691959,-73586,-73586,49263277.53332996,4774.433333331253,-1803,0,-1,0.18622956925234513,-9428473928,2266.8933551239465,1572.7950266032426,694.098328520704,0.710508714143288,0.5483499998393848,-1803
1817,2021-12-23,2021,236105,236105,539691591.616666,3835540.8499999996,169904,0,41,0.8386480591262349,62504935,11121740675,306086,306086,490450919.1500103,3829695.8999993782,171193,0,40,0.6544827270767064,9515151489,-69981,-69981,49240672.46665567,5844.950000621378,-1289,0,1,0.18416533204952845,-9452646554,2285.8117855050336,1602.330453369348,683.4813321356855,0.7196120370174287,0.5592970603033135,-1289
1818,2021-12-24,2021,213188,213188,539247573.8166668,3525881.099999997,153428,0,36,0.8324389740510723,54633320,11127951564,285045,285045,490087131.01667374,3522757.1833330765,154465,0,34,0.6294620147696038,9525186851,-71857,-71857,49160442.7999931,3123.916666920297,-1037,0,2,0.20297695928146842,-9470553531,2529.446187480847,1719.3324949277262,810.1136925531209,0.7196840347486725,0.5418968934729604,-1037
1819,2021-12-25,2021,190698,190698,537754990.5999999,3294846.133333333,137117,0,38,0.8317863847549519,52777084,11124486034,258352,258352,488616173.35000396,3291384.8166666715,137721,0,40,0.6179476063665126,9533377409,-67654,-67654,49138817.24999595,3461.316666661296,-604,0,-2,0.21383877838843934,-9480600325,2819.9298922904272,1891.2807849368457,928.6491073535815,0.7190269431247313,0.5330750294172292,-604
1820,2021-12-26,2021,199561,199561,538211082.3000005,3393251.6500000027,145550,0,35,0.8445187185872989,55760568,11137192189,249909,249909,489197306.2666804,3390294.9999995665,146447,0,35,0.6811479378493762,9540547736,-50348,-50348,49013776.03332013,2956.6500004362315,-897,0,0,0.16337078073792266,-9484787168,2696.975272222531,1957.5017557057986,739.4735165167326,0.7293509252809918,0.5860013044748288,-897
1821,2021-12-27,2021,221846,221846,540098757.9166665,3714525.883333337,162748,0,37,0.851212102088836,61301407,11174247803,267894,267894,491036818.10001504,3710003.299999486,164314,0,37,0.7154844826685138,9562516598,-46048,-46048,49061939.81665146,4522.583333850838,-1566,0,0,0.1357276194203222,-9501215191,2434.566131084926,1832.9519067243575,601.6142243605684,0.7336079983411916,0.6133545357492143,-1566
1822,2021-12-28,2021,236925,236925,541609539.4666663,3892718.0833333307,171017,0,40,0.8437986704653369,61457675,11196611878,290492,290492,492591671.98335034,3887405.266666023,172605,0,40,0.6978333310383631,9593745583,-53567,-53567,49017867.483316004,5312.816667307634,-1588,0,0,0.14596533942697376,-9532287908,2285.9957347965237,1695.7151039730882,590.2806308234356,0.7218191410784003,0.5941815953623508,-1588
1823,2021-12-29,2021,232248,232248,542936331.9833337,3824217.1166666583,167394,0,48,0.8431202852123596,61077422,11217825608,294292,294292,494039900.09999955,3818336.2833334752,168855,0,48,0.6746258817772891,9617451847,-62044,-62044,48896431.88333416,5880.83333318308,-1461,0,0,0.1684944034350705,-9556374425,2337.7438427169823,1678.740502969838,659.0033397471443,0.7207553994006407,0.5737668709988719,-1461
1824,2021-12-30,2021,227029,227029,543857790.0166663,3746173.083333331,164891,0,42,0.8518735491941555,61311715,11240701361,293621,293621,495038305.18333703,3740763.466666987,166369,0,44,0.6679529052758459,9645334534,-66592,-66592,48819484.83332926,5409.616666343994,-1478,0,-2,0.18392064391830953,-9584022819,2395.5432566617756,1685.9771786872773,709.5660779744983,0.7262992833514661,0.5666113799762279,-1478
1825,2021-12-31,2021,228004,228004,544675897.3166668,3792639.4666666696,165003,0,35,0.8522087331801199,61821170,11261810141,291172,291172,495998226.64999586,3787266.200000319,166516,0,36,0.6778708117538732,9670172468,-63168,-63168,48677670.66667098,5373.266666350421,-1513,0,-1,0.1743379214262467,-9608351298,2388.887463889523,1703.4544071888638,685.4330567006593,0.7236846721987333,0.571881911722281,-1513
1826,2022-01-01,2022,225584,225584,545712362.4500008,3817554.8166666697,164795,0,38,0.862100148946733,61119269,11285127494,285352,285352,497127631.78333914,3811862.9833335886,166357,0,30,0.6919734222994737,9694756477,-59768,-59768,48584730.66666162,5691.8333330811,-1562,0,8,0.17012672664725936,-9633637208,2419.1093448560214,1742.1557647513919,676.9535801046295,0.730526101141925,0.5829887297092714,-1562
1827,2022-01-02,2022,224366,224366,543747212.0666667,3763827.0666666636,161237,0,51,0.8495003699312732,59392151,11286210387,285659,285659,495377210.3666674,3758498.166666912,163073,0,35,0.67893537399487,9720808700,-61293,-61293,48370001.69999933,5328.899999751709,-1836,0,16,0.17056499593640317,-9661416549,2423.483112711671,1734.1557954297516,689.3273172819192,0.7186338393517735,0.5708659625637561,-1836
1828,2022-01-03,2022,232728,232728,542616928.8333337,3819406.183333336,166797,0,49,0.8406551854525461,59026831,11281691458,291494,291494,494385303.8166603,3813507.0000002366,168248,0,35,0.6804050855249141,9729547961,-58766,-58766,48231625.016673446,5899.183333099354,-1451,0,14,0.16025009992763206,-9670521130,2331.549829987512,1696.0393826859568,635.5104473015554,0.7167036196761886,0.5771919833684398,-1451
1829,2022-01-04,2022,233515,233515,543939420.8333334,3831788.583333334,168487,0,83,0.8454745947797785,59704289,11304591240,295379,295379,495796413.4499976,3825598.8833334683,170098,0,83,0.6794084887551215,9721994767,-61864,-61864,48143007.38333577,6189.69999986561,-1611,0,0,0.166066106024657,-9662290478,2329.35537688514,1678.5093505293119,650.8460263558279,0.7215253838083207,0.5758635515727252,-1611
1830,2022-01-05,2022,230956,230956,544737774.2333336,3755086.166666668,165837,0,60,0.8417101092848849,60073026,11328813216,295956,295956,496661360.70000553,3749617.6166668325,167314,0,60,0.6669842814472512,9751372122,-65000,-65000,48076413.53332806,5468.549999835435,-1477,0,0,0.17472582783763368,-9691299096,2358.6214440557233,1678.1594585006067,680.4619855551166,0.718045861549386,0.5653340361405074,-1477
1831,2022-01-06,2022,224568,224568,544879714.0166664,3734940.11666667,162735,0,56,0.8489811549285735,59954223,11343078604,292363,292363,496894674.03335005,3729255.349999261,164107,0,35,0.6617834678122837,9776856475,-67795,-67795,47985039.98331636,5684.766667408869,-1372,0,21,0.1871976871162898,-9716902252,2426.3462025607673,1699.5812535558537,726.7649490049137,0.7246580100459549,0.5613124779811399,-1372
1832,2022-01-07,2022,228026,228026,545910129.9166664,3774511.4666666645,165422,0,40,0.8553366721338798,59815917,11368441200,290968,290968,498008968.7333275,3769330.0833335523,166925,0,41,0.6803462923758035,9799342551,-62942,-62942,47901161.18333888,5181.383333112113,-1503,0,-1,0.1749903797580763,-9739526634,2394.069667128601,1711.5592392748601,682.5104278537408,0.7254523606957102,0.573688515575596,-1503
1833,2022-01-08,2022,229198,229198,546885309.6333339,3797701.283333336,166237,0,91,0.8604918018481845,59309082,11384012712,291715,291715,499093864.5000019,3792080.616666873,167749,0,91,0.6856589479457665,9824887836,-62517,-62517,47791445.133332014,5620.6666664630175,-1512,0,0,0.17483285390241798,-9765578754,2386.0823813180477,1710.895444183542,675.1869371345058,0.7252986500754806,0.5750441355432528,-1512
1834,2022-01-09,2022,224414,224414,547819142.2333336,3779987.366666668,164009,0,63,0.8640949316887538,58891853,11406604136,285801,285801,500145957.98333967,3773635.8333334527,165524,0,65,0.6894867407741719,9849166033,-61387,-61387,47673184.24999392,6351.533333215397,-1515,0,-2,0.1746081909145819,-9790274180,2441.1094772756314,1749.9797340923917,691.1297431832397,0.7308323010150882,0.5791582254785672,-1515
1835,2022-01-10,2022,223699,223699,548704660.0833327,3693064.716666665,162788,0,56,0.8534995686167576,59028420,11430887499,285192,285192,501230132.23333466,3687827.250000138,164073,0,56,0.6780274341496358,9875704865,-61493,-61493,47474527.849998,5237.4666665270925,-1285,0,0,0.17547213446712173,-9816676445,2452.8704199988942,1757.5182060974173,695.352213901477,0.7277100031739078,0.575307161491206,-1285
1836,2022-01-11,2022,211481,211481,548551163.4999998,3602222.7333333357,155042,0,37,0.8549420515318163,59656216,11449563255,277477,277477,501252315.1833553,3597114.7333327048,156420,0,37,0.6605556496574357,9904798534,-65996,-65996,47298848.31664449,5108.000000630971,-1378,0,0,0.1943864018743806,-9845142318,2593.855540214013,1806.4643742845542,787.391165929459,0.7331249615804729,0.5637223986132184,-1378
1837,2022-01-12,2022,221558,221558,549253428.4833335,3676531.13333333,162013,0,46,0.8583982523763537,59458341,11469433211,282541,282541,502078825.1666681,3671688.250000137,163627,0,46,0.6835326554376279,9928651742,-60983,-60983,47174603.31666535,4842.883333193138,-1614,0,0,0.17486559693872583,-9869193401,2479.0503095502463,1777.0122749146783,702.038034635568,0.731244188880564,0.5791265692412783,-1614
1838,2022-01-13,2022,226077,226077,550170814.2,3712750.7,163893,0,48,0.8498874277347978,61128091,11483346298,286720,286720,502987841.56666464,3707624.43333267,165215,0,48,0.6787423270089342,9952185574,-60643,-60643,47182972.63333541,5126.266667330172,-1322,0,0,0.17114510072586353,-9891057483,2433.5550020568216,1754.2823715355212,679.2726305213005,0.7249432715402274,0.5762241908482143,-1322
1839,2022-01-14,2022,235543,235543,551089625.8666666,3816725.100000002,170978,0,54,0.8561111983799132,60961540,11506498664,297962,297962,504029611.2499984,3810996.100000033,172467,0,45,0.6867486458004813,9973959054,-62419,-62419,47060014.616668165,5728.999999968801,-1489,0,9,0.1693625525794319,-9912997514,2339.656138652673,1691.5902405340225,648.0658981186502,0.7258886912368442,0.5788221316812211,-1489
1840,2022-01-15,2022,231035,231035,551501692.3333329,3764669.9499999993,167656,0,95,0.8569437531110001,60944806,11517479845,296381,296381,504495754.7333353,3759038.216666948,168983,0,95,0.6767809002601433,9993560133,-65346,-65346,47005937.59999758,5631.733333051205,-1327,0,0,0.18016285285085687,-9932615327,2387.0915330289045,1702.186559642269,684.9049733866354,0.7256735992382106,0.5701546320445643,-1327
1841,2022-01-16,2022,221146,221146,551960986.9666662,3667858.6500000027,161184,0,54,0.8573024155987443,59500975,11532800158,291984,291984,505023649.5000218,3661825.849999381,162489,0,55,0.6581079785193821,10011195093,-70838,-70838,46937337.46664441,6032.800000621472,-1305,0,-1,0.19919443707936224,-9951694118,2495.9121438627253,1729.6278203600943,766.284323502631,0.7288578586092446,0.5564996712148611,-1305
1842,2022-01-17,2022,219358,219358,552733607.4000001,3682240.5833333423,160874,0,121,0.8577485206830833,59198131,11558597002,284078,284078,505871487.43333334,3677229.183333489,162108,0,121,0.6705552700314736,10030029209,-64720,-64720,46862119.96666676,5011.399999853224,-1234,0,0,0.18719325065160963,-9970831078,2519.7786604546,1780.7485529795808,739.0301074750191,0.7333856070897802,0.5706460901583368,-1234
1843,2022-01-18,2022,220549,220549,553677280.7166666,3600548.299999998,160507,0,67,0.8522641227119605,58722859,11579824741,277094,277094,506865110.3499989,3596253.783333005,161815,0,67,0.6873660201953239,10056791391,-56545,-56545,46812170.36666769,4294.516666993033,-1308,0,0,0.1648981025166366,-9998068532,2510.450197990771,1829.2171983153692,681.2329996754017,0.727761177788156,0.5839715042548738,-1308
1844,2022-01-19,2022,216812,216812,554005026.85,3458479.333333337,156867,0,191,0.8480942014279655,56471192,11595423290,280584,280584,507246679.81666845,3452872.6000001444,157867,0,191,0.6628104239728473,10075829236,-63772,-63772,46758347.03333157,5606.733333192766,-1000,0,0,0.18528377745511826,-10019358044,2555.2323065605224,1807.8246792998477,747.4076272606746,0.7235162260391491,0.5626372138111938,-1000
1845,2022-01-20,2022,222108,222108,555250210.0499997,3702708.6666666726,163008,0,121,0.856533758351793,58670046,11617676217,278227,278227,508572198.91666913,3697530.966666812,164319,0,122,0.6930204473325638,10096596515,-56119,-56119,46678011.13333058,5177.699999860488,-1311,0,-1,0.16351331101922917,-10037926469,2499.9108994273042,1827.9038300260906,672.0070694012136,0.7339132314009401,0.5905932925273248,-1311
1846,2022-01-21,2022,219747,219747,555791918.7166663,3647108.899999999,160102,0,35,0.8502186605505415,58623344,11634082861,279362,279362,509228607.4333398,3642238.8666667566,161486,0,37,0.6791224289631255,10123540428,-59615,-59615,46563311.283326566,4870.033333242405,-1384,0,-2,0.17109623158741605,-10064917084,2529.235524110301,1822.8270395878458,706.4084845224552,0.7285742239939567,0.5780528489916309,-1384
1847,2022-01-22,2022,221708,221708,556134718.7833337,3644879.983333333,163043,0,43,0.8570146318581185,59228841,11650226129,283037,283037,509652625.06666875,3640168.7833336345,164392,0,36,0.6808367810568995,10142422036,-61329,-61329,46482093.71666491,4711.199999698438,-1349,0,7,0.17617785080121906,-10083193195,2508.4106968775764,1800.6572464613064,707.75345041627,0.7353952045032205,0.5808145224829263,-1349
1848,2022-01-23,2022,214368,214368,556244991.3000013,3561373.6,158305,0,40,0.8607254814151369,58703310,11662673791,277236,277236,509838592.40000606,3556186.9500002177,159625,0,40,0.6753199440188198,10162113054,-62868,-62868,46406398.89999521,5186.649999782443,-1320,0,0,0.18540553739631715,-10103409744,2594.813550996423,1839.0057294146723,755.8078215817509,0.738473092998955,0.5757729876350834,-1320
1849,2022-01-24,2022,212147,212147,556956258.2333326,3564634.3833333277,157207,0,40,0.86146398487841,58813815,11692699994,274355,274355,510580576.6166711,3558275.1666667173,158470,0,40,0.6754897851324061,10181850281,-62208,-62208,46375681.61666155,6359.216666610446,-1263,0,0,0.18597419974600393,-10123036466,2625.3317663381176,1861.021583775295,764.3101825628225,0.7410286263769933,0.5776093018169889,-1263
1850,2022-01-25,2022,211532,211532,557229599.0000006,3549250.599999999,155749,0,36,0.8552701246147157,59113235,11706156520,268067,268067,510993176.03333575,3543979.4333332907,157024,0,36,0.6838924597208986,10206449912,-56535,-56535,46236422.96666485,5271.166666708421,-1275,0,0,0.17137766489381712,-10147336677,2634.2567507516624,1906.2144017478308,728.0423490038315,0.7362904903277045,0.5857640067595041,-1275
1851,2022-01-26,2022,207425,207425,557843408.5166663,3488118.8500000075,154476,0,43,0.8647993250572502,59941484,11731859747,263085,263085,511660174.86667246,3483697.1333333934,155568,0,43,0.6900165345800788,10229843483,-55660,-55660,46183233.64999384,4421.716666614171,-1092,0,0,0.17478279047717138,-10169901999,2689.374031658027,1944.8473872196153,744.5266444384117,0.7447318307822104,0.5913221962483608,-1092
1852,2022-01-27,2022,196988,196988,558038892.2999996,3389052.466666667,148700,0,41,0.8764036388003323,59664393,11757105435,253809,253809,511943063.65000623,3384618.4166664053,149731,0,41,0.6876509501239213,10254310808,-56821,-56821,46095828.64999336,4434.050000261515,-1031,0,0,0.18875268867641104,-10194646415,2832.857292322373,2017.040623657972,815.8166686644008,0.7548683168517879,0.5899357390793865,-1031
1853,2022-01-28,2022,188275,188275,557816970.5166667,3303710.716666669,142767,0,47,0.874481476563537,58882798,11775132696,241608,241608,511814840.2333329,3299552.2833329993,143648,0,47,0.6886609714909985,10283380201,-53333,-53333,46002130.28333378,4158.433333669789,-881,0,0,0.18582050507253856,-10224497403,2962.777694949763,2118.368763589504,844.408931360259,0.7582897357588634,0.594549849342737,-881
1854,2022-01-29,2022,181852,181852,557934764.3500001,3253207.616666662,139156,0,60,0.8829102786881639,59692797,11795190005,230080,230080,511991189.65000194,3249006.183333057,139938,0,61,0.7035465924895657,10306295695,-48228,-48228,45943574.6999982,4201.433333605062,-782,0,-1,0.1793636861985981,-10246602898,3068.070542804039,2225.2746420810236,842.7959007230156,0.7652156698854014,0.6082145340751043,-782
1855,2022-01-30,2022,177784,177784,558098620.35,3190930.4333333336,135893,0,69,0.8797923322683701,58943356,11813206569,222047,222047,512231082.5999998,3187587.716666594,136674,0,69,0.7107098947520116,10327064142,-44263,-44263,45867537.75000024,3342.716666739434,-781,0,0,0.16908243751635843,-10268120786,3139.1948676483826,2306.858829887365,832.3360377610175,0.7643713720019799,0.6155183362081,-781
1856,2022-01-31,2022,178763,178763,558568459.2166668,3205437.45,136948,0,102,0.881054804405834,59710941,11834809976,221004,221004,512812651.4333359,3201640.3499999624,137874,0,102,0.7209190783877244,10349608983,-42241,-42241,45755807.78333092,3797.1000000378117,-926,0,0,0.16013572601810955,-10289898042,3124.6312671898927,2320.3772394768234,804.2540277130693,0.7660869419286989,0.6238529619373405,-926
1857,2022-02-01,2022,178001,178001,558978814.2333336,3208821.4499999965,136986,0,92,0.8863377172038354,59019358,11853726802,218439,218439,513343344.7999971,3204838.1666666223,137794,0,90,0.7288396302857945,10370421794,-40438,-40438,45635469.4333365,3983.2833333741874,-808,0,2,0.1574980869180409,-10311402436,3140.3127748345996,2350.0535380586666,790.259236775933,0.7695799461800776,0.6308122633778767,-808
1858,2022-02-02,2022,182442,182442,560037417.1999999,3246679.5833333344,139274,0,63,0.8793644007410563,59571255,11880399101,221733,221733,514441994.4833347,3242655.9666665867,140155,0,63,0.7303107791803711,10394321625,-39291,-39291,45595422.71666521,4023.616666747723,-881,0,0,0.14905362156068513,-10334750370,3069.673743984389,2320.0966679895855,749.5770759948036,0.763387816401925,0.632089044030433,-881
1859,2022-02-03,2022,184255,184255,561000329.75,3282449.9000000022,140794,0,49,0.8777943610756836,60484655,11901640122,225514,225514,515435511.78333163,3278936.899999942,141661,0,49,0.7239151449577447,10424126884,-41259,-41259,45564817.96666837,3513.0000000600703,-867,0,0,0.15387921611793898,-10363642229,3044.695285066891,2285.603163366051,759.0921217008399,0.7641258039130553,0.6281694262883901,-867
1860,2022-02-04,2022,186599,186599,561767191.116666,3267899.716666664,141812,0,49,0.8722822737528071,59862305,11921919051,228135,228135,516319269.3833314,3263526.4833333646,142652,0,49,0.7198457053937451,10447436112,-41536,-41536,45447921.73333454,4373.233333299402,-840,0,0,0.15243656835906194,-10387573807,3010.5584226960805,2263.2181356798887,747.3402870161917,0.7599826365628969,0.6252964253621759,-840
1861,2022-02-05,2022,182713,182713,562381892.1499997,3233224.4666666663,138384,0,85,0.8712133236277664,58838518,11942677890,229005,229005,516980663.3833461,3228173.1666663922,139459,0,87,0.7027051811095704,10466896084,-46292,-46292,45401228.76665366,5051.300000274088,-1075,0,-2,0.168508142518196,-10408057566,3077.9522647540116,2257.5081914514794,820.4440733025322,0.7573845320256358,0.6089779699133206,-1075
1862,2022-02-06,2022,186729,186729,562827090.733333,3269260.066666667,140493,0,102,0.8678566264479538,59139202,11960063940,231462,231462,517532703.10000247,3264048.350000047,141629,0,106,0.7082847292428038,10488683877,-44733,-44733,45294387.633330524,5211.716666619759,-1136,0,-4,0.15957189720514997,-10429544675,3014.1386219244628,2235.9294532147933,778.2091687096695,0.7523898269684944,0.6118887765594352,-1136
1863,2022-02-07,2022,195119,195119,563920212.1166667,3360143.88333333,145825,0,218,0.86378056468104,59675323,11986643534,238615,238615,518698598.91666996,3354559.1333333305,147020,0,218,0.7153238480397253,10516455960,-43496,-43496,45221613.19999671,5584.749999999534,-1195,0,0,0.14845671664131477,-10456780637,2890.1348003867724,2173.78873464229,716.3460657444825,0.747364428886987,0.6161389686314774,-1195
1864,2022-02-08,2022,200355,200355,564817778.2666665,3397664.7833333355,148376,0,55,0.854992388510394,59221599,12003117103,247820,247820,519762920.0333305,3393155.366666481,149353,0,50,0.6986925994673508,10539138857,-47465,-47465,45054858.23333603,4509.416666854639,-977,0,5,0.1562997890430432,-10479917258,2819.085015430943,2097.3404891991386,721.7445262318042,0.7405654962441666,0.6026672584940683,-977
1865,2022-02-09,2022,212578,212578,565987372.4499998,3525729.983333337,157087,0,73,0.8572523967673047,59876935,12027791483,262626,262626,520954959.81666785,3520354.5500000212,158307,0,39,0.7026075102998126,10561543979,-50048,-50048,45032412.633331954,5375.433333315887,-1220,0,34,0.15464488646749208,-10501667044,2662.492696563143,1983.6381767862583,678.8545197768847,0.7389616987646888,0.6027849489387951,-1220
1866,2022-02-10,2022,221219,221219,567457896.8333331,3654584.1666666614,163387,0,39,0.8554102495716921,61215622,12053306427,273912,273912,522513589.4999947,3649516.8833335224,164685,0,41,0.6993377435088765,10590683408,-52693,-52693,44944307.33333844,5067.283333139028,-1298,0,-2,0.15607250606281564,-10529467786,2565.140864181346,1907.5965620345028,657.5443021468432,0.7385758004511367,0.6012332427933059,-1298
1867,2022-02-11,2022,222109,222109,568496855.95,3693379.6000000006,164070,0,42,0.8583623356099932,61410428,12071380890,281425,281425,523658162.54999936,3689097.350000064,165532,0,42,0.6861046459980483,10616497832,-59316,-59316,44838693.40000069,4282.24999993667,-1462,0,0,0.17225768961194488,-10555087404,2559.539937373092,1860.7378965976702,698.8020407754218,0.7386913632495756,0.5881922359420805,-1462
1868,2022-02-12,2022,218665,218665,569424173.1999998,3648821.6333333305,161151,0,68,0.857096471771889,61691103,12094133778,279000,279000,524679736.7666803,3643097.949999318,162692,0,69,0.6819354838709766,10642187378,-60335,-60335,44744436.43331951,5723.683334012516,-1541,0,-1,0.1751609879009124,-10580496275,2604.093811080876,1880.572533213908,723.5212778669681,0.736976653785471,0.5831254480286738,-1541
1869,2022-02-13,2022,206916,206916,570228342.3666669,3526408.1166666695,151801,0,58,0.8571014324653492,60427250,12121044142,268290,268290,525558652.01666474,3521176.750000309,153183,0,53,0.6711767117671138,10664355082,-61374,-61374,44669690.35000217,5231.366666360293,-1382,0,5,0.1859247206982354,-10603927832,2755.8446053793177,1958.9200194441266,796.9245859351911,0.7336358715614065,0.570960527787096,-1382
1870,2022-02-14,2022,211722,211722,571345003.7333331,3550609.1833333387,155893,0,56,0.8563871491861973,61068241,12149702945,268563,268563,526717723.80000633,3545277.683333327,157218,0,56,0.6848076615170227,10699274421,-56841,-56841,44627279.93332678,5331.5000000116415,-1325,0,0,0.17157948766917464,-10638206180,2698.562283245639,1961.2445638453783,737.3177194002606,0.7363098780476285,0.5854045419510506,-1325
1871,2022-02-15,2022,214077,214077,572099427.3333337,3580935.3499999978,159195,0,50,0.8663237993805977,61266545,12169684719,267689,267689,527560973.21666867,3575528.7500001197,160576,0,50,0.7019899958533939,10724536267,-53612,-53612,44538454.116665065,5406.59999987809,-1381,0,0,0.16433380352720373,-10663269722,2672.400245394572,1970.7981023376703,701.6021430569015,0.743634299808013,0.5998602856299661,-1381
1872,2022-02-16,2022,212687,212687,573142578.0833334,3590525.1333333356,159040,0,71,0.8679044793522878,61475397,12195997649,268763,268763,528658983.70000565,3585319.6500000744,160288,0,71,0.6948649925771113,10751427596,-56076,-56076,44483594.38332772,5205.483333261218,-1248,0,0,0.17303948677517644,-10689952199,2694.770146192919,1967.0080468665913,727.7620993263279,0.7477654957754822,0.5963916164055321,-1248
1873,2022-02-17,2022,214828,214828,574043064.2499996,3613148.533333331,159009,0,48,0.860916640288975,60093837,12215947655,271568,271568,529596448.30000126,3607152.9000000907,160109,0,48,0.6889766099098674,10778362923,-56740,-56740,44446615.94999838,5995.63333324017,-1100,0,0,0.17194003037910754,-10718269086,2672.105425037703,1950.1430518323266,721.9623732053763,0.740168879289478,0.5895724091203677,-1100
1874,2022-02-18,2022,213816,213816,574836323.3833331,3595218.3500000006,158791,0,76,0.8613433980618853,61666731,12237410340,270706,270706,530403758.5499993,3590417.066666727,159903,0,76,0.6872843601545472,10801570712,-56890,-56890,44432564.83333379,4801.2833332736045,-1112,0,0,0.17405903790733812,-10739903981,2688.4626191834714,1959.3350666405595,729.1275525429119,0.7426525610805552,0.5906887915302949,-1112
1875,2022-02-19,2022,207264,207264,575235212.5333338,3524077.9833333334,155470,0,66,0.8685975374401737,61906138,12251326200,267415,267415,530857734.2666683,3519344.6333330106,156514,0,66,0.6800329076529198,10825955124,-60151,-60151,44377478.26666546,4733.350000322796,-1044,0,0,0.18856462978725386,-10764048986,2775.37446219958,1985.1456884119002,790.22877378768,0.7501061448201328,0.585285043845708,-1044
1876,2022-02-20,2022,201177,201177,575979441.2999997,3494165.083333335,151022,0,32,0.8675792958439581,60506166,12275736592,258146,258146,531679297.8666633,3489171.6499997163,152039,0,32,0.6828151511160445,10840432751,-56969,-56969,44300143.43333644,4993.433333618566,-1017,0,0,0.18476414472791358,-10779926585,2863.0481680311354,2059.6069583362255,803.44120969491,0.7506921765410559,0.5889651592509665,-1017
1877,2022-02-21,2022,210577,210577,576970302.683333,3567415.099999997,156957,0,31,0.8618652559396324,60402008,12295346650,261552,261552,532768635.2333351,3563147.0666668154,158153,0,31,0.7022504129197924,10865693226,-50975,-50975,44201667.44999796,4268.033333181404,-1196,0,0,0.15961484301983997,-10805291218,2739.949294953072,2036.9511043055877,702.9981906474841,0.7453663030625377,0.6046713464244203,-1196
1878,2022-02-22,2022,210936,210936,577782903.3999988,3580105.0333333393,157432,0,35,0.8624985777676643,61284409,12315380133,263410,263410,533783331.9333285,3575402.383333441,158741,0,35,0.6999772218215163,10889151231,-52474,-52474,43999571.466670275,4702.649999898393,-1309,0,0,0.16252135594614792,-10827866822,2739.1384277695547,2026.4353362944782,712.7030914750765,0.7463496036712557,0.6026384723434949,-1309
1879,2022-02-23,2022,213690,213690,578540344.2166663,3600992.5333333346,160232,0,43,0.8690439421592026,63065826,12334845313,267801,267801,534643918.8333369,3596092.0333328424,161436,0,43,0.7021108957770915,10907905018,-54111,-54111,43896425.38332945,4900.500000492204,-1204,0,0,0.16693304638211104,-10844839192,2707.381460136957,1996.4224137823865,710.9590463545703,0.7498338714960925,0.6028207512294577,-1204
1880,2022-02-24,2022,221935,221935,579415272.6666669,3677999.4999999995,162426,0,43,0.8473381846035997,63099775,12357999211,278096,278096,535564984.4166685,3672453.566666054,163708,0,43,0.6840803175881713,10934321955,-56161,-56161,43850288.24999839,5545.933333945461,-1282,0,0,0.16325786701542833,-10871222180,2610.743112472872,1925.8277156689362,684.9153968039357,0.7318629328406966,0.588674414590645,-1282
1881,2022-02-25,2022,233524,233524,580203390.4666667,3766668.0166666694,172954,0,36,0.8564944074270742,63168931,12379017443,290722,290722,536400529.6166653,3761923.1666671014,174165,0,35,0.6957299413184943,10960832905,-57198,-57198,43802860.850001395,4744.8499995679595,-1211,0,1,0.16076446610857986,-10897663974,2484.5557221813033,1845.0634269737595,639.4922952075437,0.7406262311368425,0.5990774691973776,-1211
1882,2022-02-26,2022,232787,232787,580999558.6499993,3812102.933333331,172671,0,38,0.8634245039456665,62912632,12395445709,297597,297597,537275195.9166706,3807114.9499994344,173920,0,38,0.6828193832598994,10982502401,-64810,-64810,43724362.7333287,4987.98333389638,-1249,0,0,0.18060512068576706,-10919589769,2495.841944137771,1805.3784007119377,690.4635434258332,0.7417553385713119,0.584414493425673,-1249
1883,2022-02-27,2022,232875,232875,581950217.7166666,3831759.88333333,172288,0,49,0.8619130434782616,63195463,12415727073,297367,297367,538269798.1666632,3826402.8666670336,173526,0,33,0.6824429072492774,11003059826,-64492,-64492,43680419.55000341,5357.016666296404,-1238,0,16,0.17947013622898422,-10939864363,2498.981074467704,1810.119475821672,688.8615986460318,0.7398303811057434,0.5835415496675825,-1238
1884,2022-02-28,2022,244084,244084,583344771.3499998,3919507.5833333316,180131,0,75,0.8669597351731366,63587535,12444211453,307747,307747,539744001.966669,3913970.4666669415,181360,0,75,0.6947362606296874,11029100833,-63663,-63663,43600769.38333082,5537.116666390095,-1229,0,0,0.17222347454344922,-10965513298,2389.9344952967003,1753.8562584417361,636.0782368549642,0.7379877419249111,0.5893152492144521,-1229
1885,2022-03-01,2022,239384,239384,583842134.1000003,3866906.633333333,177469,0,42,0.8601953346923769,63618043,12451770286,308889,308889,540337239.7000006,3861409.56666693,178727,0,42,0.6736076713641441,11049065746,-69505,-69505,43504894.39999962,5497.066666402854,-1258,0,0,0.18658766332823273,-10985447703,2438.935493182503,1749.292592808422,689.6429003740809,0.7413569829228353,0.5786123817941072,-1258
1886,2022-03-02,2022,249928,249928,584330615.5333337,3941735.4333333345,186647,0,48,0.8677939246502997,64448697,12462776966,318236,318236,540932328.5833335,3936426.133333567,188050,0,40,0.6894883042773329,11073317691,-68308,-68308,43398286.95000017,5309.299999767449,-1403,0,8,0.17830562037296682,-11008868994,2337.995804925153,1699.7835838287733,638.2122210963798,0.7468030792868346,0.5909136615593459,-1403
1887,2022-03-03,2022,247866,247866,585195665.6000003,3983665.1833333345,183112,0,48,0.8596297999725659,64384598,12480002689,323858,323858,541962385.600003,3978054.6500003194,184596,0,36,0.6662333491839131,11085725479,-75992,-75992,43233279.99999726,5610.5333330151625,-1484,0,12,0.19339645078865286,-11021340881,2360.935608756345,1673.4568409611713,687.4787677951738,0.7387540041796777,0.5699905514145088,-1484
1888,2022-03-04,2022,238612,238612,585681609.3333327,3898912.3166666687,178236,0,55,0.870572309858683,63440414,12491971288,311982,311982,542538978.0333245,3894014.533333371,180512,0,59,0.6767057073805511,11103617347,-73370,-73370,43142631.30000818,4897.783333297819,-2276,0,-4,0.1938666024781318,-11040176933,2454.535435490808,1739.007308220745,715.5281272700631,0.7469699763633011,0.5785974831881326,-2276
1889,2022-03-05,2022,229891,229891,585708558.7499999,3814685.016666666,172235,0,52,0.8629654923420235,62145425,12503408510,306725,306725,542576059.6166571,3815031.0666669067,175208,0,52,0.6607025837476577,11111861399,-76834,-76834,43132499.13334274,-346.0500002405606,-2973,0,0,0.2022629085943658,-11049715974,2547.7663708018144,1768.93327774605,778.8330930557645,0.7492028831054717,0.5712217784660526,-2973
1890,2022-03-06,2022,226316,226316,585722817.9333326,3777766.583333332,170332,0,98,0.8703715159334737,63644745,12513734240,296310,296310,540998831.7166646,3772645.2166667455,171743,0,98,0.6735749721575428,11059830578,-69994,-69994,44723986.21666801,5121.366666586604,-1411,0,0,0.19679654377593092,-10996185833,2588.0751601006227,1825.7866144128263,762.2885456877964,0.7526290673217978,0.5796058182309068,-1411
1891,2022-03-07,2022,238577,238577,586935509.3166673,3885511.633333337,183354,0,74,0.88672420224917,64999455,12543835612,301096,301096,542234105.3666661,3880113.2166670267,184872,0,75,0.7114043361585763,11073983148,-62519,-62519,44701403.95000124,5398.416666310281,-1518,0,-1,0.1753198660905937,-11008983693,2460.1512690522027,1800.8678473532232,659.2834216989795,0.7685317528512807,0.6139968647873104,-1518
1892,2022-03-08,2022,239277,239277,588189714.5833334,3948544.466666665,179495,0,64,0.8656703318747734,64839860,12570030248,304531,304531,543588766.7500037,3943283.9666669215,181091,0,64,0.6896801967615733,11101002821,-65254,-65254,44600947.83332968,5260.499999743421,-1596,0,0,0.17599013511320005,-11036162961,2458.195792254723,1785.003059622842,673.192732631881,0.7501556773112334,0.5946553881214064,-1596
1893,2022-03-09,2022,244216,244216,589424595.733333,3987334.9166666633,181859,0,44,0.8604841615618961,65935564,12600366698,308290,308290,544820318.1333321,3980965.483333718,183398,0,33,0.6909954912582369,11132612935,-64074,-64074,44604277.60000086,6369.43333294522,-1539,0,11,0.16948867030365922,-11066677371,2413.537998056364,1767.2331834744305,646.3048145819334,0.7446645592426376,0.594887930195595,-1539
1894,2022-03-10,2022,241205,241205,590187475.3833339,3957002.1166666704,179473,0,47,0.8617648887875453,64623199,12614506972,310700,310700,545635305.6499957,3951507.8833334954,181161,0,36,0.6788027035725777,11160020815,-69495,-69495,44552169.73333824,5494.233333175071,-1688,0,11,0.18296218521496765,-11095397616,2446.8293583604564,1756.1483928226446,690.6809655378117,0.7440683236251322,0.5830737045381397,-1688
1895,2022-03-11,2022,243926,243926,591120298.1833332,4002583.366666666,183026,0,52,0.877819502636046,65360241,12635498119,310530,310530,546661475.9833345,3996996.2000003005,184467,0,34,0.6993720413486757,11179618087,-66604,-66604,44458822.19999862,5587.166666365694,-1441,0,18,0.17844746128737032,-11114257846,2423.3591260600883,1760.4143753689966,662.9447506910917,0.7503341177242279,0.5940392232634528,-1441
1896,2022-03-12,2022,236584,236584,591430979.5000001,3937343.8166666646,177625,0,51,0.8742264903797377,64248008,12650784013,305849,305849,547075906.083334,3932865.86666675,179366,0,38,0.6876432487927051,11206352278,-69265,-69265,44355073.41666615,4477.949999914505,-1741,0,13,0.18658324158703254,-11142104270,2499.877335322761,1788.7124237232556,711.1649115995056,0.7507904169343658,0.5864527920640578,-1741
1897,2022-03-13,2022,235802,235802,592380424.5000002,3892745.616666669,177079,0,39,0.8731054019898049,64788521,12677655921,302939,302939,547998421.9499973,3886771.516666926,178359,0,36,0.6883795087459749,11226385712,-67137,-67137,44382002.55000293,5974.099999743048,-1280,0,3,0.18472589324383004,-11161597191,2512.194232873344,1808.9398260045664,703.2544068687776,0.7509647924953987,0.5887620940189279,-1280
1898,2022-03-14,2022,241678,241678,593597495.5166662,3933157.766666667,180622,0,62,0.8687509827125346,65320022,12708944563,308830,308830,549246336.9000078,3927943.2166668437,182301,0,62,0.691050092283786,11257244753,-67152,-67152,44351158.61665833,5214.549999823328,-1679,0,0,0.1777008904287486,-11191924731,2456.150313709424,1778.4746847780586,677.6756289313655,0.7473663304065741,0.5902956319010458,-1679
1899,2022-03-15,2022,240232,240232,594398146.700001,3943146.75,179731,0,39,0.866628925372139,66220066,12725441365,307653,307653,550179389.7499999,3937492.000000345,181306,0,32,0.6861691581099489,11280982563,-67421,-67421,44218756.95000112,5654.749999654945,-1575,0,7,0.18045976726219004,-11214762497,2474.267153002102,1788.3114734782364,685.9556795238657,0.7481559492490593,0.5893197856026108,-1575
1900,2022-03-16,2022,235283,235283,594686833.9166663,3821769.9499999983,174232,0,35,0.8616007106335777,64801759,12740842850,305509,305509,550573808.30001,3816818.866666781,175650,0,31,0.6725333787220604,11302993357,-70226,-70226,44113025.6166563,4951.083333217539,-1418,0,4,0.18906733191151726,-11238191598,2527.5384703385553,1802.1525005810302,725.3859697575251,0.7405209896167594,0.5749421457305677,-1418
1901,2022-03-17,2022,222412,222412,594455151.8833328,3682338.699999995,164657,0,31,0.8594230527129827,62829533,12758737109,294922,294922,550363805.7999986,3677458.933332996,166032,0,31,0.6568177348587232,11322931277,-72510,-72510,44091346.08333421,4879.766666999087,-1375,0,0,0.2026053178542595,-11260101744,2672.7656416170566,1866.13343799377,806.6322036232866,0.7403242630793303,0.5629691918541173,-1375
1902,2022-03-18,2022,226098,226098,594652677.2833337,3713315.66666667,167748,0,31,0.8604764305743531,63447585,12773888793,292127,292127,550553302.1000026,3708147.5666668955,168902,0,31,0.6740527236441649,11345863985,-66029,-66029,44099375.18333101,5168.099999774247,-1154,0,0,0.18642370693018817,-11282416400,2630.0660655261595,1884.6368261064626,745.4292394196968,0.7419260674574742,0.5781800381340992,-1154
1903,2022-03-19,2022,223446,223446,594698167.8999997,3738099.383333328,168177,0,34,0.8695926532585047,64075061,12785871797,289213,289213,550692874.2333468,3732543.566666388,169634,0,34,0.6824520336222692,11363818177,-65767,-65767,44005293.66665292,5555.816666940227,-1457,0,0,0.1871406196362354,-11299743116,2661.4849578869157,1904.1083016093564,757.3766562775593,0.7526516473778899,0.5865365664752276,-1457
1904,2022-03-20,2022,223836,223836,595573787.5499998,3768482.0333333383,169589,0,33,0.8733000947122004,64512283,12811192686,285588,285588,551584762.1166844,3762568.6833330924,171036,0,31,0.6949416642155708,11376314524,-61752,-61752,43989025.4333154,5913.350000245962,-1447,0,2,0.17835843049662958,-11311802241,2660.759607703854,1931.4003463614872,729.3592613423666,0.757648456905949,0.5988907096936846,-1447
1905,2022-03-21,2022,228699,228699,596306798.2000002,3784814.916666667,171254,0,40,0.861814000061215,65482929,12834907702,291099,291099,552391191.466682,3779682.883333022,172706,0,40,0.6867697930944244,11406045665,-62400,-62400,43915606.73331821,5132.033333645202,-1452,0,0,0.17504420696679057,-11340562736,2607.38699425883,1897.6059397891506,709.7810544696792,0.7488183157775067,0.5932895681537896,-1452
1906,2022-03-22,2022,227833,227833,596816039.4499999,3794802.85,170712,0,32,0.8604504176304564,63634111,12853196342,292566,292566,552978405.2833374,3789932.550000244,171986,0,32,0.6787938448076585,11422728537,-64733,-64733,43837634.166662574,4870.299999756273,-1274,0,0,0.1816565728227979,-11359094426,2619.532901072276,1890.0979788606242,729.4349222116521,0.7492856609885311,0.5878536808788445,-1274
1907,2022-03-23,2022,231397,231397,597678603.6333328,3846071.033333333,174816,0,42,0.8703829349559429,65917669,12871163509,293840,293840,553886289.750009,3841191.2666663574,176104,0,42,0.6944970051728901,11448457180,-62443,-62443,43792313.88332391,4879.766666975804,-1288,0,0,0.17588592978305273,-11382539511,2582.914228072675,1884.9928183705722,697.9214097021029,0.7554808402874713,0.599319357473455,-1288
1908,2022-03-24,2022,233401,233401,598665977.4999989,3836674.3,175875,0,49,0.8716372252046899,65877388,12894248777,296340,296340,554999087.2000008,3831523.266666302,177476,0,39,0.696736856313684,11469862064,-62939,-62939,43666890.299998164,5151.033333697822,-1601,0,10,0.1749003688910059,-11403984676,2564.967491570297,1872.8456745630044,692.1218170072927,0.7535314758719971,0.5988931632584193,-1601
1909,2022-03-25,2022,228678,228678,599047656.2666664,3750634.866666668,170865,0,59,0.8662617304681695,64635932,12911391969,298149,298149,555459348.6333454,3745503.5499997437,172153,0,60,0.6736195660558911,11492634865,-69471,-69471,43588307.63332105,5131.316666924395,-1288,0,-1,0.19264216441227833,-11427998933,2619.6121020240967,1863.0260327331146,756.5860692909821,0.7471859995277202,0.577405927908529,-1288
1910,2022-03-26,2022,228092,228092,599582278.3999999,3769407.733333338,171962,0,42,0.8758001157427701,64913073,12928720711,297516,297516,556036650.4833423,3764574.08333306,173292,0,35,0.681499482380773,11513808338,-69424,-69424,43545627.91665757,4833.650000277907,-1330,0,7,0.1943006333619971,-11448895265,2628.686137172719,1868.9302440317235,759.7558931409956,0.7539150868947617,0.5824627919170734,-1330
1911,2022-03-27,2022,228703,228703,600500322.4666668,3817349.449999995,173888,0,47,0.8813570438516323,65560770,12954690480,293766,293766,556972594.3166562,3813040.916666802,175232,0,47,0.6950838422417752,11534136879,-65063,-65063,43527728.150010586,4308.533333193045,-1344,0,0,0.18627320160985705,-11468576109,2625.6775051777495,1895.9736467687078,729.7038584090417,0.7603223394533521,0.5965019777646153,-1344
1912,2022-03-28,2022,236937,236937,601933644.1000003,3904575.2833333397,176133,0,57,0.8629129262208943,64196413,12984546912,300041,300041,558430945.6999961,3899199.566666884,177339,0,57,0.6892924633633359,11563258320,-63104,-63104,43502698.40000415,5375.716666455846,-1206,0,0,0.1736204628575584,-11499061907,2540.479722879923,1861.182124109692,679.2975987702309,0.7433748211549905,0.5910492232728194,-1206
1913,2022-03-29,2022,240885,240885,603001910.6499997,3963681.4000000013,180347,0,50,0.8737530356809271,64655884,13006361893,304802,304802,559507495.0333327,3958946.5333335632,181647,0,53,0.699001318888995,11587286042,-63917,-63917,43494415.61666703,4734.866666438058,-1300,0,-3,0.17475171679193213,-11522630158,2503.277126637191,1835.6424663661417,667.6346602710494,0.7486850571849638,0.5959508139710369,-1300
1914,2022-03-30,2022,238260,238260,604021101.5999991,3928761.7666666657,178474,0,37,0.8750356753126832,65442056,13029352166,303778,303778,560617349.833327,3923497.2666669893,179798,0,37,0.6945565511656594,11610818241,-65518,-65518,43403751.766672015,5264.499999676365,-1324,0,0,0.18047912414702383,-11545376185,2535.134313774864,1845.483707948986,689.6506058258781,0.7490724418702258,0.5918730125288862,-1324
1915,2022-03-31,2022,230719,230719,604593140.6666664,3851985.883333333,174408,0,75,0.885146000112691,65327617,13046655425,298914,298914,561188766.5000114,3846936.066666385,175551,0,75,0.6906836079942624,11634781309,-68195,-68195,43404374.166654944,5049.816666947678,-1143,0,0,0.19446239211842853,-11569453692,2620.4739993960898,1877.4255019838865,743.0484974122032,0.7559325413164932,0.587296011561854,-1143
1916,2022-04-01,2022,229342,229342,604955499.5666668,3855554.016666674,174384,0,58,0.8890957609160121,64347086,13063459518,293561,293561,561585620.0499997,3850778.8333330806,175615,0,58,0.7028624374491417,11656238720,-64219,-64219,43369879.51666713,4775.183333593421,-1231,0,0,0.18623332346687038,-11591891634,2637.787668925303,1913.0116740643332,724.7759948609698,0.7603666140523759,0.5982231972230644,-1231
1917,2022-04-02,2022,230645,230645,605241078.0166668,3912376.466666667,176451,0,43,0.9032322400225443,65263024,13068429958,290617,290617,562009501.5500021,3907223.93333302,177912,0,42,0.7267228001114683,11674831425,-59972,-59972,43231576.46666467,5152.533333646599,-1461,0,1,0.17650943991107604,-11609568401,2624.12399148764,1933.8493672083948,690.2746242792452,0.7650328426803096,0.6121871741845797,-1461
1918,2022-04-03,2022,234539,234539,606218131.1500002,3935217.7166666673,178338,0,42,0.8936040487935888,65572346,13088239769,293167,293167,563084512.0500178,3930470.549999728,179816,0,42,0.7245597219332334,11692395223,-58628,-58628,43133619.09998238,4747.166666939389,-1478,0,0,0.16904432686035542,-11626822877,2584.7220767121894,1920.6954126829344,664.026664029255,0.7603767390497955,0.6133568921467969,-1478
1919,2022-04-04,2022,240471,240471,607267319.0333328,3969907.63333333,179762,0,50,0.8718057478864402,65778107,13115069178,302894,302894,564164526.6499995,3964953.7333336426,181082,0,50,0.7009845028293833,11715127220,-62423,-62423,43102792.383333325,4953.899999687448,-1320,0,0,0.17082124505705687,-11649349113,2525.3245465496166,1862.5807267558932,662.7438197937233,0.7475412835643384,0.5978395082107932,-1320
1920,2022-04-05,2022,248873,248873,608126766.3833336,4078197.1833333345,186960,0,47,0.8815379731831084,66504346,13132679251,312115,312115,565069823.7000064,4073022.3833335675,188405,0,47,0.7110552200310786,11738334066,-63242,-63242,43056942.6833272,5174.799999766983,-1445,0,0,0.17048275315202988,-11671829720,2443.5224648046737,1810.4539150633784,633.0685497412953,0.7512265291936048,0.6036396840907998,-1445
1921,2022-04-06,2022,250128,250128,608967618.9166667,4102762.666666668,187855,0,42,0.8813887289707663,67156020,13156708369,317058,317058,565983370.0166637,4097163.816666958,189428,0,42,0.705230588725089,11762435560,-66930,-66930,42984248.900003076,5598.849999709986,-1573,0,0,0.17615814024567722,-11695279540,2434.623948205186,1785.1098853101441,649.5140628950419,0.7510354698394422,0.597455355171609,-1573
1922,2022-04-07,2022,250812,250812,609907311.9166664,4061615.0500000007,185921,0,59,0.8636070044495479,67122867,13179096717,319527,319527,566961710.7666622,4055754.95000009,187637,0,59,0.6880545306030429,11786844193,-68715,-68715,42945601.15000415,5860.099999910686,-1716,0,0,0.17555247384650496,-11719721326,2431.730985426002,1774.3780987730684,657.3528866529336,0.7412763344656556,0.5872336297089135,-1716
1923,2022-04-08,2022,248743,248743,610544898.3000003,4025125.483333333,186558,0,44,0.8744205867099774,66294402,13202358855,321938,321938,567614578.8000028,4019373.416666828,188015,0,44,0.684737433915852,11808263288,-73195,-73195,42930319.4999975,5752.066666504834,-1457,0,0,0.1896831527941254,-11741968886,2454.520924407924,1763.1176773167592,691.403247091165,0.7500030151602256,0.5840099646515788,-1457
1924,2022-04-09,2022,249923,249923,611356570.0999995,4069684.049999997,187840,0,40,0.8789467155884009,66637590,13227830692,321429,321429,568516229.7833389,4063839.116666772,189593,0,34,0.693792408276779,11832843621,-71506,-71506,42840340.31666064,5844.933333225083,-1753,0,6,0.18515430731162186,-11766206031,2446.1797037487527,1768.714801039542,677.4649027092107,0.7515914901789751,0.5898441024300857,-1753
1925,2022-04-10,2022,248511,248511,612365966.3999997,4030200.733333329,186880,0,37,0.8813372446290098,66587605,13252577533,319255,319255,569541110.19999,4024444.750000357,188525,0,34,0.69664061643514,11861068648,-70744,-70744,42824856.2000097,5755.983332972042,-1645,0,3,0.18469662819386978,-11794481043,2464.1402851382827,1783.9692728382954,680.1710122999873,0.7519989054810451,0.5905154187091823,-1645
1926,2022-04-11,2022,253031,253031,613775384.566667,4089822.9166666646,192247,0,38,0.88962617228719,66372547,13285233676,324871,324871,571000430.2833384,4084124.6000002734,193850,0,38,0.7023803294230628,11893526670,-71840,-71840,42774954.28332853,5698.3166663912125,-1603,0,0,0.18724584286412715,-11827154123,2425.6924430866848,1757.6220416206384,668.0704014660464,0.7597764700767891,0.5966983818192452,-1603
1927,2022-04-12,2022,253273,253273,614524248.8499999,4065047.56666667,190026,0,56,0.8825417632357182,65978315,13305997228,324780,324780,571761205.7833327,4059600.749999904,191452,0,56,0.6966069339245098,11921311738,-71507,-71507,42763043.0666672,5446.81666676607,-1426,0,0,0.18593482931120842,-11855333423,2426.331463874949,1760.4569424944045,665.8745213805444,0.7502813169978639,0.5894821109674241,-1426
1928,2022-04-13,2022,249064,249064,615027286.550001,4007924.2833333323,185824,0,48,0.8828333279799566,65616139,13324596900,322474,322474,572376422.3999957,4002200.7166668256,187278,0,48,0.6904091492647392,11944470310,-73410,-73410,42650864.15000534,5723.5666665066965,-1454,0,0,0.19242417871521744,-11878854171,2469.3544091077033,1774.953709136227,694.4006999714763,0.7460893585584428,0.5807537972053561,-1454
1929,2022-04-14,2022,246313,246313,615524239.4166667,3971402.3666666658,185678,0,75,0.886006828709812,66601322,13352661743,321134,321134,572889879.0333449,3965809.8999997415,187174,0,75,0.6883575080807395,11971034771,-74821,-74821,42634360.38332188,5592.4666669243015,-1496,0,0,0.19764932062907248,-11904433449,2498.9514943046725,1783.9589673885196,714.9925269161529,0.753829477128694,0.582853263746598,-1496
1930,2022-04-15,2022,243392,243392,615507917.8500003,3951257.2999999966,184783,0,56,0.8841416316066263,67673457,13365342157,315830,315830,572980765.9333266,3946331.3166663377,185936,0,56,0.688430484754466,11997944280,-72438,-72438,42527151.91667366,4925.983333658893,-1153,0,0,0.1957111468521603,-11930270823,2528.874892560151,1814.2062689843478,714.6686235758029,0.7591991519852748,0.5887217807048095,-1153
1931,2022-04-16,2022,245250,245250,616188201.183333,3998247.0833333344,186928,0,59,0.8914006116207964,68177856,13389186952,314250,314250,573685606.0166669,3993072.9666663944,188610,0,60,0.7050596658711259,12015752140,-69000,-69000,42502595.16666615,5174.116666940041,-1682,0,-1,0.18634094574967053,-11947574284,2512.4901169554864,1825.5707430920188,686.9193738634676,0.7621936799184506,0.6001909307875894,-1682
1932,2022-04-17,2022,244252,244252,616964105.1833332,3996455.483333329,182441,0,55,0.8701873474935728,67669360,13409521873,312840,312840,574553025.399992,3991094.9666663916,184012,0,55,0.6889336401994494,12039218139,-68588,-68588,42411079.78334117,5360.516666937619,-1571,0,0,0.1812537072941235,-11971548779,2525.932664556823,1836.5714914972255,689.3611730595976,0.7469375890473773,0.5881984400971743,-1571
1933,2022-04-18,2022,256460,256460,618403444.1333343,4153171.1333333342,194357,0,69,0.8886376043047649,69143902,13438030804,322990,322990,576056863.4666564,4148438.3499995726,196019,0,69,0.7148951979937564,12067952204,-66530,-66530,42346580.66667783,4732.7833337616175,-1662,0,0,0.17374240631100846,-11998808302,2411.3056388260716,1783.5129987512196,627.792640074852,0.7578452780160649,0.6068887581658875,-1662
1934,2022-04-19,2022,256826,256826,619327648.6999999,4158818.433333333,192501,0,70,0.8806117760662853,68175176,13462837893,330962,330962,577010268.9333237,4154592.7333335206,194527,0,70,0.6934089109928072,12097879345,-74136,-74136,42317379.76667619,4225.699999812525,-2026,0,0,0.18720286507347805,-12029704169,2411.4678759159897,1743.4335933833,668.0342825326898,0.7495385981170131,0.5877623412959796,-2026
1935,2022-04-20,2022,262100,262100,620052591.7500002,4170593.349999999,196516,0,57,0.877298740938573,68787802,13479878269,336862,336862,577049328.4833285,4165349.8833334697,197996,0,57,0.6903895363680046,12105403124,-74762,-74762,43003263.26667178,5243.466666529421,-1480,0,0,0.18690920457056837,-12036615322,2365.710002861504,1713.0140190443815,652.6959838171226,0.7497748950782144,0.5877659100759361,-1480
1936,2022-04-21,2022,263781,263781,620577092.4000006,4195357.033333337,197390,0,116,0.8742858659266592,68128988,13497607105,341217,341217,577618920.5999889,4189654.9333336437,198863,0,116,0.6836470633057657,12114811884,-77436,-77436,42958171.800011635,5702.099999693222,-1473,0,0,0.1906388026208935,-12046682896,2352.622411773405,1692.8198788453944,659.8025329280106,0.748310151223932,0.5828050771210109,-1473
1937,2022-04-22,2022,266734,266734,621457129.8499999,4238067.683333335,203287,0,70,0.8948428021924463,68570465,13518013652,346932,346932,578619330.0833302,4232532.733333656,204842,0,71,0.6962661270796543,12134498502,-80198,-80198,42837799.76666975,5534.949999679811,-1555,0,-1,0.19857667511279198,-12065928037,2329.8759432618263,1667.8176993858456,662.0582438759807,0.7621338112126688,0.5904384720925138,-1555
1938,2022-04-23,2022,262868,262868,621836492.083333,4180040.583333338,198804,0,45,0.8836336107856405,65549404,13533392840,342802,342802,579055491.1499977,4173747.733333571,200330,0,45,0.6854423253073243,12154173432,-79934,-79934,42781000.933335304,6292.8499997672625,-1526,0,0,0.19819128547831621,-12088624028,2365.584597909723,1689.1835262046245,676.4010717050985,0.7562883272212669,0.5843898226964837,-1526
1939,2022-04-24,2022,257547,257547,613145219.8000003,4138301.783333328,196388,0,79,0.8954715061716891,67434529,13330402851,338574,338573,571046317.3833336,4133016.1500002877,198434,0,67,0.6906436997524854,11965967877,-81027,-81026,42098902.416666746,5285.633333040401,-2046,0,12,0.20482780641920373,-11898533348,2380.7119469456075,1686.6268644674371,694.0850824781703,0.7625326639409505,0.5860875318246528,-2046
1940,2022-04-25,2022,257288,257288,614355777.816667,4147363.71666666,195334,0,47,0.8918177295482115,68022298,13361165110,344995,344995,571817558.0166606,4172204.883333601,200305,0,47,0.6825200365222553,11971335703,-87707,-87707,42538219.80000639,-24841.16666694125,-4971,0,0,0.20929769302595613,-11903313405,2387.813570071931,1657.4662183992828,730.3473516726481,0.7592036939149902,0.5806026174292381,-4971
1941,2022-04-26,2022,263390,263390,614957298.8666675,4194922.1833333345,202297,0,36,0.9057671134059756,68699171,13376738173,347919,347919,571507228.5666668,4189699.2000001115,205358,0,38,0.698102144464678,11961256101,-84529,-84529,43450070.30000067,5222.983333223034,-3061,0,-2,0.2076649689412976,-11892556930,2334.7784610906547,1642.6444907195837,692.133970371071,0.7680511788602452,0.5902465803822154,-3061
1942,2022-04-27,2022,266543,266543,616157388.3333328,4268206.749999993,202647,0,37,0.8972698588970636,69063521,13405393880,344174,344174,571000799.633341,4262912.800000439,204293,0,37,0.7031646783312981,11888034073,-77631,-77631,45156588.69999182,5293.949999553151,-1646,0,0,0.19410518056576542,-11818970552,2311.6622396136186,1659.0468763861911,652.6153632274275,0.7602788293070911,0.5935747616031426,-1646
1943,2022-04-28,2022,262862,262862,617121908.3166666,4219881.816666664,199629,0,49,0.8893792179927122,68823225,13431884759,340310,340310,571999015.7166705,4214137.916667094,201114,0,49,0.6941994064235543,11915978400,-77448,-77448,45122892.59999609,5743.89999956917,-1485,0,0,0.19517981156915798,-11847155175,2347.7030088665024,1680.8175361190401,666.8854727474622,0.7594441189673669,0.5909729364403045,-1485
1944,2022-04-29,2022,253455,253455,617217402.4833329,4109249.833333332,193510,0,38,0.8888323371012604,68414037,13447450791,334900,334900,572199398.8333482,4103842.816666599,195010,0,38,0.6807644072857485,11944009068,-81445,-81445,45018003.64998472,5407.016666733194,-1500,0,0,0.20806792981551192,-11875595031,2435.214939469858,1708.567927242007,726.6470122278511,0.7634885877177409,0.5822932218572708,-1500
1945,2022-04-30,2022,247962,247962,617175678.9833331,4042742.799999998,191498,0,35,0.8899670110742782,69392220,13467774251,323004,323004,572240066.8000072,4037674.8166663754,192989,0,35,0.691452737427404,11962662545,-75042,-75042,44935612.18332589,5067.983333622571,-1491,0,0,0.19851427364687424,-11893270325,2488.9929867614114,1771.6191341283923,717.3738526330192,0.7722876892427065,0.5974817649317037,-1491
1946,2022-05-01,2022,233912,233912,616327642.1833323,3885873.7333333325,180558,0,46,0.8813186155477271,69198732,13487379801,310321,310321,571504172.983326,3881412.0499997535,181630,0,46,0.6707667222005532,11984954592,-76409,-76409,44823469.200006366,4461.683333578985,-1072,0,0,0.21055189334717384,-11915755860,2634.8697039199883,1841.654844445996,793.2148594739922,0.7719056739286569,0.5852971600375095,-1072
1947,2022-05-02,2022,231869,231869,616607796.2666677,3870362.1500000083,178603,0,39,0.8760075732417881,69399320,13515601606,301267,301267,571792377.6666646,3866201.366666381,179679,0,40,0.6806122144144533,12011662881,-69398,-69398,44815418.60000312,4160.783333627507,-1076,0,-1,0.19539535882733483,-11942263561,2659.293809291745,1897.9588792222999,761.3349300694454,0.770275457262506,0.5964111568807735,-1076
1948,2022-05-03,2022,233333,233333,617134348.8166671,3882000.533333333,178268,0,33,0.8665383807691152,67903548,13543860880,296777,296777,572324077.2333275,3877878.099999701,179249,0,36,0.687735235547222,12034359098,-63444,-63444,44810271.58333957,4122.433333632071,-981,0,-3,0.1788031452218931,-11966455550,2644.865273307535,1928.4650671491643,716.4002061583708,0.7640068057240081,0.6039854840503138,-981
1949,2022-05-04,2022,238526,238526,618139665.7666663,3942872.533333333,183550,0,32,0.8722235731115262,68835344,13567214663,303213,303213,573322025.050001,3938549.149999716,184583,0,33,0.6924142434526157,12065441217,-64687,-64687,44817640.71666527,4323.383333617356,-1033,0,-1,0.1798093296589105,-11996605873,2591.498057933585,1890.8227056557635,700.6753522778217,0.7695177884171956,0.6087568804767606,-1033
1950,2022-05-05,2022,239120,239120,618636884.0666661,3961244.1500000022,185575,0,49,0.8832176313148203,68642586,13583188332,304646,304646,573883745.0833244,3957236.0666664983,186522,0,49,0.6990342889780339,12091104439,-65526,-65526,44753138.983341694,4008.0833335039206,-947,0,0,0.18418334233678646,-12022461853,2587.1398631091756,1883.7724607686444,703.3674023405313,0.7760747741719639,0.6122581619322098,-947
1951,2022-05-06,2022,240401,240401,619186618.1666675,3963971.966666667,185139,0,48,0.8783865291741711,67887980,13600402908,306194,306194,574480880.250007,3959189.9833331164,186078,0,48,0.694954832557133,12113252228,-65793,-65793,44705737.91666043,4781.983333550394,-939,0,0,0.18343169661703818,-12045364248,2575.6407758980513,1876.1990119009747,699.4417639970766,0.7701257482290007,0.6077127572715337,-939
1952,2022-05-07,2022,237794,237794,619464284.05,3974044.2833333323,184782,0,36,0.885030740893379,69432345,13614356701,305950,305950,574827736.8500041,3969527.6833330565,185657,0,37,0.6928713842130919,12127826502,-68156,-68156,44636547.199995875,4516.600000275765,-875,0,-1,0.19215935668028705,-12058394157,2605.045897078984,1878.8290140545973,726.2168830243868,0.7770675458590208,0.606821376041837,-875
1953,2022-05-08,2022,235975,235975,620227657.3833334,3926786.716666661,182975,0,30,0.8827545290814706,69257213,13635995004,302918,302918,575632232.1833322,3922522.783333013,183823,0,31,0.692718821595291,12149726255,-66943,-66943,44595425.20000124,4263.933333648369,-848,0,-1,0.1900357074861796,-12080469042,2628.361722145708,1900.29061390651,728.0711082391979,0.7753999364339442,0.6068407951987006,-848
1954,2022-05-09,2022,237152,237152,621120478.4833335,3960629.9999999995,183018,0,57,0.8827713871272439,69684375,13659722120,304081,304081,576598502.2999922,3956356.666666435,183913,0,57,0.6938447321601725,12175316392,-66929,-66929,44521976.183341265,4273.333333564457,-895,0,0,0.1889266549670714,-12105632017,2619.0817639460493,1896.2003620745531,722.8814018714961,0.7717328970449332,0.6048158221000326,-895
1955,2022-05-10,2022,241414,241414,621969176.3500003,3999551.9999999995,183193,0,38,0.8786524393779981,69513132,13679624017,304451,304451,577556679.45001,3995115.6499998523,184178,0,38,0.7023888901662434,12197525600,-63037,-63037,44412496.89999032,4436.350000147242,-985,0,0,0.1762635492117547,-12128012468,2576.3591852585196,1897.043134855888,679.3160504026316,0.7588333733751977,0.6049512072550263,-985
1956,2022-05-11,2022,240534,240534,622939349.4166672,4017531.1166666616,184442,0,30,0.8820249943874889,68841507,13700904982,305613,305613,578572823.5499908,4013100.999999814,185378,0,30,0.70020908796419,12220431724,-65079,-65079,44366525.86667645,4430.116666847374,-936,0,0,0.18181590642329892,-12151590217,2589.818276903337,1893.155145723483,696.663131179854,0.7668021984418003,0.6065775997748787,-936
1957,2022-05-12,2022,239936,239936,623659512.4833323,3983219.1833333354,182661,0,69,0.8726160309415849,69330023,13724700186,304888,304888,579252602.5499971,3978055.9833330708,183545,0,69,0.6922476450368577,12249715937,-64952,-64952,44406909.933335185,5163.200000264682,-884,0,0,0.18036838590472726,-12180385914,2599.2744418650486,1899.886524067845,699.3879177972037,0.7612905108028808,0.6020079504604969,-884
1958,2022-05-13,2022,239655,239655,624252059.4833337,3939265.966666669,184626,0,166,0.8796895537334913,69652716,13739183716,305528,305528,579922201.8500023,3931917.9999997383,185257,0,169,0.6946302793852136,12267442977,-65873,-65873,44329857.63333142,7347.966666930821,-631,0,-3,0.18505927434827774,-12197790261,2604.7946401424283,1898.0983800175509,706.6962601248774,0.7703824247355574,0.6063503181377812,-631
1959,2022-05-14,2022,234907,234907,624352972.3499999,3947880.533333335,184388,0,121,0.8887772607883114,70151573,13757071393,302789,302789,580182957.7166761,3943722.1666663624,185315,0,124,0.6954149589318028,12287795673,-67882,-67882,44170014.63332379,4158.366666972637,-927,0,-3,0.1933623018565086,-12217644100,2657.872998037521,1916.1295744451618,741.7434235923592,0.7849404232313213,0.6120268569862182,-927
1960,2022-05-15,2022,233953,233953,625017906.8666673,3917729.383333336,183624,0,34,0.8898582193859453,69919070,13776763556,298512,298512,580909299.8499926,3913489.266666471,184568,0,34,0.7038142520233698,12309870201,-64559,-64559,44108607.01667464,4240.116666865069,-944,0,0,0.18604396736257556,-12239951131,2671.5532900482885,1946.0165750455346,725.5367150027539,0.7848755946707244,0.6182934019402905,-944
1961,2022-05-16,2022,236961,236961,625899423.2500015,3969122.683333337,183023,0,61,0.8802123556197012,70139486,13804642539,304137,304137,581756329.0166591,3964988.066666476,183941,0,61,0.6914811417223058,12336429735,-67176,-67176,44143094.23334241,4134.6166668608785,-918,0,0,0.18873121389739544,-12266290249,2641.3604907558693,1912.8101119451403,728.550378810729,0.7723760450031861,0.6047965226197405,-918
1962,2022-05-17,2022,242086,242086,626774956.35,3994436.833333331,185721,0,33,0.8759862197731383,71656703,13816238421,304622,304622,582814606.8833306,3989975.3666664185,186587,0,33,0.7017122860463333,12359846478,-62536,-62536,43960349.46666944,4461.46666691266,-866,0,0,0.174273933726805,-12288189775,2589.0590796245965,1913.2387249881183,675.8203546364782,0.7671695182703667,0.6125197786108686,-866
1963,2022-05-18,2022,241492,241492,627470348.1666675,3993862.0166666675,185042,0,42,0.8690267172411507,70611373,13838780814,309866,309866,583611495.2166666,3989861.8333330657,185869,0,33,0.6821916570388499,12379149104,-68374,-68374,43858852.95000088,4000.1833336018026,-827,0,9,0.18683506020230078,-12308537731,2598.306975662413,1883.4318551137155,714.8751205486976,0.766244844549716,0.5998367036073657,-827
1964,2022-05-19,2022,246855,246855,628276077.2333342,4048187.0666666715,189045,0,52,0.8707135767960956,69289343,13859782938,313391,313391,584469661.100019,4044054.566666407,189948,0,52,0.6903197602994441,12401334157,-66536,-66536,43806416.133315206,4132.500000264496,-903,0,0,0.18039381649665154,-12332044814,2545.1219429759744,1864.9854689509878,680.1364740249867,0.7658139393571125,0.6061054720780111,-903
1965,2022-05-20,2022,251200,251200,628503713.8166671,4068989.2833333323,191781,0,77,0.8678742038216565,67990071,13871211824,320236,320236,584796461.0499982,4064544.5166665083,192524,0,76,0.6853445583881864,12423985128,-69036,-69036,43707252.766668916,4444.766666823998,-743,0,1,0.18252964543347006,-12355995057,2502.005230161891,1826.1421609375527,675.8630692243385,0.7634593949044586,0.601194119336989,-743
1966,2022-05-21,2022,249106,249106,628543905.0000001,4066691.6000000015,191576,0,55,0.8731503857795475,68581488,13873741450,321618,321618,584965656.3166525,4062054.066666387,192555,0,56,0.6822565901162236,12438107457,-72512,-72512,43578248.68334758,4637.533333614469,-979,0,-1,0.19089379566332387,-12369525969,2523.1985781153408,1818.8212609886652,704.3773171266755,0.7690541375960435,0.5987071619125796,-979
1967,2022-05-22,2022,247831,247831,629317469.2666662,4012054.683333335,190186,0,49,0.870258361544763,68723415,13887032435,320502,320502,585787934.2833376,4007639.983333131,191333,0,49,0.6793530149577901,12448187719,-72671,-72671,43529534.98332858,4414.700000204146,-1147,0,0,0.1909053465869729,-12379464304,2539.3008512521283,1827.7200587931982,711.5807924589301,0.7674019795747908,0.5969791140148891,-1147
1968,2022-05-23,2022,245518,245518,630304035.0666667,4021531.099999995,186642,0,40,0.8622219144828479,67518729,13914196384,322127,322127,586791116.0500026,4018373.349999781,187565,0,41,0.6622046584111315,12466865629,-76609,-76609,43512919.01666415,3157.7500002137385,-923,0,-1,0.2000172560717164,-12399346900,2567.241648541723,1821.6141957985594,745.6274527431635,0.7601968083806483,0.5822703467886889,-923
1969,2022-05-24,2022,245255,245255,631134816.2333333,4020460.6499999985,186784,0,54,0.8700006116083254,66868995,13933373588,315623,315623,587650956.9500036,4015760.4999996945,187699,0,55,0.6810530284548237,12489969443,-70368,-70368,43483859.283329725,4700.150000303984,-915,0,-1,0.18894758315350169,-12423100448,2573.382056363105,1861.8762160869253,711.5058402761799,0.7615909971254409,0.5946936693460235,-915
1970,2022-05-25,2022,248772,248772,631765128.2833335,4080395.000000001,191248,0,52,0.8765455919476481,67553265,13941516496,316943,316943,588347778.0833383,4076142.61666635,192145,0,53,0.6931814237891271,12507747103,-68171,-68171,43417350.19999528,4252.383333650883,-897,0,-1,0.18336416815852108,-12440193838,2539.5347076171497,1856.3204679811142,683.2142396360355,0.7687681893460678,0.6062446559791508,-897
1971,2022-05-26,2022,255380,255380,632724122.1333344,4132180.95,194773,0,55,0.8649189443182709,68674439,13960679275,324288,324288,589308620.4833326,4127610.3666663994,195711,0,55,0.6858934033945108,12525716510,-68908,-68908,43415501.650001764,4570.583333600778,-938,0,0,0.1790255409237601,-12457042071,2477.578988696587,1817.238443862655,660.3405448339322,0.7626791448038217,0.6035098431024275,-938
1972,2022-05-27,2022,257989,257989,633563848.9666674,4153167.4999999995,195873,0,54,0.8645446123671944,69654519,13983971472,330421,330421,589971917.0833242,4148064.4166668397,196902,0,54,0.6806256260951864,12542861956,-72432,-72432,43591931.88334322,5103.083333159797,-1029,0,0,0.18391898627200798,-12473207437,2455.778536940208,1785.515802819204,670.2627341210041,0.759230044691828,0.5959124874024351,-1029
1973,2022-05-28,2022,253136,253136,633990507.7333332,4144117.383333338,195639,0,47,0.8802027368687181,69330873,14000117456,329211,329211,590446436.6166717,4139037.583332972,196700,0,48,0.6826989377633269,12567495354,-76075,-76075,43544071.11666155,5079.8000003658235,-1061,0,-1,0.19750379910539118,-12498164481,2504.545018224722,1793.5197688311498,711.025249393572,0.7728612287466026,0.5974891482969888,-1061
1974,2022-05-29,2022,250701,250701,634626483.0666662,4099285.600000005,193874,0,49,0.8775393795796587,68028440,14020396024,323629,323629,591075099.6833354,4094554.7166663045,194709,0,49,0.6842155678261134,12587410350,-72928,-72928,43551383.38333082,4730.883333700709,-835,0,0,0.1933238117535453,-12519381910,2531.4078646142866,1826.3972007556042,705.0106638586824,0.7733275894392124,0.6016426216439195,-835
1975,2022-05-30,2022,253458,253458,635667982.4333336,4116248.8500000034,192794,0,38,0.8665064823363244,67278282,14045468537,327434,327434,592059003.033328,4111638.3166664424,193909,0,38,0.6769119883701832,12607582829,-73976,-73976,43608979.40000558,4610.5333335609175,-1115,0,0,0.18959449396614125,-12540304547,2507.9815292211474,1808.178145926593,699.8033832945544,0.7606546252239029,0.5922078953315782,-1115
1976,2022-05-31,2022,253948,253948,636599660.3499998,4110504.550000001,191751,0,57,0.864909351520784,68574310,14066852150,325289,325289,593075800.5333372,4105798.933333013,192818,0,57,0.6807915422900842,12631210395,-71341,-71341,43523859.81666255,4705.616666988004,-1067,0,0,0.18411780923069976,-12562636085,2506.811080811819,1823.2273471692472,683.5837336425718,0.755079780112464,0.592759054256369,-1067
1977,2022-06-01,2022,251465,251465,637398721.8666663,4095908.1999999993,193423,0,43,0.8753424929910717,68813032,14084643788,324621,324621,593905133.6499921,4090917.8833331284,194548,0,43,0.6847954999830644,12658278879,-73156,-73156,43493588.21667421,4990.316666870844,-1125,0,0,0.19054699300800726,-12589465847,2534.7413034285737,1829.5339292590193,705.2073741695544,0.7691845783707474,0.5993081162340083,-1125
1978,2022-06-02,2022,251166,251166,638084129.4666669,4126700.466666671,193585,0,43,0.8797687585103076,68480645,14100967177,322418,322418,594690194.6833532,4121826.4333330663,194700,0,43,0.6920333232015696,12679006221,-71252,-71252,43393934.78331375,4874.03333360469,-1115,0,0,0.18773543530873793,-12610525576,2540.487683311702,1844.4695850831938,696.018098228508,0.7707452441811392,0.6038744735095435,-1115
1979,2022-06-03,2022,257939,257939,638905096.033333,4128453.949999999,196522,0,46,0.8639639604712739,68702379,14119034788,328107,328107,595558960.0500041,4123640.8999997484,197590,0,43,0.6858860066990365,12692008264,-70168,-70168,43346135.98332882,4813.0500002503395,-1068,0,3,0.17807795377223734,-12623305885,2476.96197951195,1815.1364038255938,661.8255756863564,0.7618933158615021,0.602212083253329,-1068
1980,2022-06-04,2022,251434,251434,639088240.9499999,4098183.266666666,193545,0,53,0.8767549337002944,67521012,14133196533,327763,327763,595753231.2833391,4093289.48333308,194597,0,53,0.6784780466373584,12710206832,-76329,-76329,43335009.666660786,4893.783333586063,-1052,0,0,0.198276887062936,-12642685820,2541.7733518537666,1817.6341786087482,724.1391732450184,0.7697646300818505,0.5937125300903396,-1052
1981,2022-06-05,2022,248481,248481,639801418.5833338,4045686.9666666635,191540,0,43,0.8838905187921805,68113673,14156360238,321560,321560,596463710.366681,4040855.8833331303,192554,0,45,0.689037815648701,12729301132,-73079,-73079,43337708.21665287,4831.083333533257,-1014,0,-2,0.19485270314347947,-12661187459,2574.8504657633134,1854.9064260687926,719.9440396945208,0.7708436459930538,0.5988120412986689,-1014
1982,2022-06-06,2022,247997,247997,640752530.7000005,4022483.6166666658,190655,0,37,0.8761517276418673,66891034,14181211372,323340,323340,597412723.6833428,4017768.4666663324,191614,0,37,0.6772623244881695,12753388766,-75343,-75343,43339807.01665771,4715.15000033332,-959,0,0,0.19888940315369785,-12686497732,2583.710813840492,1847.6301221109136,736.0806917295783,0.7687794610418675,0.5926083998268077,-959
1983,2022-06-07,2022,243275,243275,641025839.4499998,4022161.1500000036,186834,0,47,0.8726379611550706,66544363,14194768657,315498,315498,597828439.166668,4017875.78333301,187836,0,47,0.6784480408750622,12774366131,-72223,-72223,43197400.28333175,4285.366666993592,-1002,0,0,0.19418992028000848,-12707821768,2634.9844392148793,1894.8723578807728,740.1120813341065,0.7679950673106567,0.5953635205294486,-1002
1984,2022-06-08,2022,244509,244509,641044324.4833328,4032111.4000000022,187439,0,67,0.8755137847686592,67136426,14200433609,311940,311940,597980182.0500023,4027606.5499997437,188360,0,68,0.6919631980509036,12782643241,-67431,-67431,43064142.43333042,4504.850000258535,-921,0,-1,0.1835505867177556,-12715506815,2621.7616712813547,1916.9717960184726,704.7898752628821,0.7665934587274906,0.603834070654613,-921
1985,2022-06-09,2022,247182,247182,641864698.8333344,4059219.800000001,191006,0,79,0.8795179260625772,68049118,14214269374,314211,314211,598890545.8500056,4054174.399999723,192089,0,63,0.6982473560760137,12805874412,-67029,-67029,42974152.98332882,5045.400000278372,-1083,0,16,0.18127056998656343,-12737825294,2596.7291260420843,1906.0139392001095,690.7151868419749,0.7727342605853177,0.6113376043486701,-1083
1986,2022-06-10,2022,245865,245865,642001894.0000005,4062303.2000000034,191198,0,73,0.8846643483212331,68003140,14223064896,314908,314908,599099455.0666655,4057756.9999997113,192052,0,73,0.6954888411853799,12823561206,-69043,-69043,42902438.93333495,4546.200000292156,-854,0,0,0.18917550713585318,-12755558066,2611.196770585486,1902.4586706805337,708.7380999049522,0.7776544038395055,0.6098670087771667,-854
1987,2022-06-11,2022,246877,246877,642278832.5999995,4090012.583333335,192537,0,88,0.8920717604313082,69258451,14230116349,315534,315534,599509781.1833366,4085479.2166664205,193533,0,89,0.7034772797860199,12837330869,-68657,-68657,42769051.41666293,4533.3666669144295,-996,0,-1,0.18859448064528828,-12768072418,2601.6147012479883,1899.984728058899,701.6299731890892,0.7798903907613913,0.6133507007168799,-996
1988,2022-06-12,2022,248078,248078,643087748.9000005,4073948.2666666633,192872,0,72,0.8864268496198767,68250548,14248594811,315370,315370,600312505.2833419,4069139.7999996776,193864,0,74,0.7030694105336702,12850760403,-67292,-67292,42775243.61665857,4808.466666985769,-992,0,-2,0.1833574390862065,-12782509855,2592.280447681779,1903.518106615537,688.7623410662422,0.7774651520892623,0.6147192186955005,-992
1989,2022-06-13,2022,245365,245365,644134140.4333323,4049227.2166666603,188889,0,67,0.8729892201414233,67255747,14274872407,316980,316980,601415155.516671,4044667.116666408,189740,0,68,0.6809577891349675,12875219181,-71615,-71615,42718984.91666138,4560.100000252482,-851,0,-1,0.1920314310064558,-12807963434,2625.2079165053383,1897.328397743299,727.8795187620392,0.7698286226641942,0.5985866616190296,-851
1990,2022-06-14,2022,249493,249493,644553822.3833337,4097852.6999999983,193886,0,83,0.8775075853831575,68157661,14287231069,316330,316330,601866927.6666726,4093561.583333042,194642,0,83,0.6970442259665564,12894196891,-66837,-66837,42686894.716661096,4291.116666956339,-756,0,0,0.1804633594166012,-12826039230,2583.454535330986,1902.6552260824853,680.7993092485005,0.7771199993586995,0.6153131223722063,-756
1991,2022-06-15,2022,255568,255568,645737176.433334,4158987.6166666728,196929,0,71,0.8703750078257059,69592241,14312065404,322383,322383,603021046.5166568,4154223.5499997493,197801,0,72,0.6950676679601595,12913785578,-66815,-66815,42716129.91667724,4764.066666923463,-872,0,-1,0.17530733986554636,-12844193337,2526.6746088451373,1870.5113064791158,656.1633023660215,0.7705542164903274,0.6135590276162205,-872
1992,2022-06-16,2022,259959,259959,646577812.5666656,4174806.9500000016,198051,0,86,0.8646632738239498,70938832,14324576860,330375,330375,603944378.9333366,4171427.583333085,198998,0,86,0.6846220204313326,12936728025,-70416,-70416,42633433.633329034,3379.366666916758,-947,0,0,0.18004125339261723,-12865789193,2487.2299576728087,1828.057143952589,659.1728137202197,0.761854754018903,0.6023397654180855,-947
1993,2022-06-17,2022,260778,260778,647579202.4666667,4180572.0999999973,201244,0,47,0.8799553643328806,70232269,14350617923,335056,335056,605010173.5166678,4175470.816666588,202226,0,47,0.6896399407860215,12954899284,-74278,-74278,42569028.949998856,5101.283333409112,-982,0,0,0.19031542354685904,-12884667015,2483.2585665457464,1805.6986698243513,677.559896721395,0.7717062022103092,0.6035588080798434,-982
1994,2022-06-18,2022,257050,257050,647801332.2833333,4160519.250000003,199734,0,52,0.8874965959929977,69542723,14360236427,333774,333774,605312878.0666729,4155503.8833330423,200768,0,53,0.6895833707838478,12981671780,-76724,-76724,42488454.21666038,5015.36666696053,-1034,0,-1,0.1979132252091499,-12912129057,2520.137452959865,1813.5411328224275,706.5963201374377,0.7770239253063607,0.601508805359315,-1034
1995,2022-06-19,2022,249386,249386,648082151.483333,4082577.5499999993,194122,0,53,0.8886625552356578,67879811,14375636317,325919,325919,605647423.6166743,4077360.1166665303,195051,0,53,0.6853113810486707,12995251062,-76533,-76533,42434727.86665869,5217.433333469089,-929,0,0,0.20335117418698712,-12927371251,2598.7110402481817,1858.2759017322535,740.4351385159282,0.7783997497854731,0.5984646491919772,-929
1996,2022-06-20,2022,254039,254039,648895019.366667,4142238.099999997,195324,0,41,0.8747633237416307,67718849,14398471681,327001,327001,606506935.3000075,4137408.9499996947,196225,0,41,0.6844566224568145,13009739210,-72962,-72962,42388084.06665957,4829.150000302121,-901,0,0,0.1903067012848162,-12942020361,2554.3126030517637,1854.755597995136,699.5570050566278,0.7688740705167317,0.600074617508815,-901
1997,2022-06-21,2022,256075,256075,649840261.1999996,4174049.583333331,196581,0,38,0.8795391975007322,69020172,14417429943,326537,326537,607464970.0000011,4169228.416666444,197567,0,38,0.6951677757803636,13034662188,-70462,-70462,42375291.1999985,4821.166666887235,-986,0,0,0.18437142172036858,-12965642016,2537.6950549643643,1860.3250780156645,677.3699769486998,0.7676696280386606,0.6050371014617026,-986
1998,2022-06-22,2022,257464,257464,649916590.2666672,4163821.666666663,197326,0,33,0.8723976944349492,68330197,14411298860,329430,329430,607510839.9833257,4159233.649999849,198103,0,33,0.6855416932276978,13037069454,-71966,-71966,42405750.28334153,4588.016666813754,-777,0,0,0.18685600120725143,-12968739257,2524.300835327142,1844.1272500480397,680.1735852791023,0.7664217133269117,0.6013508180797135,-777
1999,2022-06-23,2022,255221,255221,650480458.9499997,4138484.116666665,198694,0,43,0.8922306550009599,68850692,14425671137,329471,329471,608007291.8166537,4133436.1499996246,199741,0,43,0.6963920952071575,13045708960,-74250,-74250,42473167.13334596,5047.966667040251,-1047,0,0,0.19583855979380238,-12976858268,2548.6948916821098,1845.4045782987084,703.2903133834013,0.7785174417465648,0.6062475908350052,-1047
2000,2022-06-24,2022,255376,255376,650646575.216667,4166138.616666672,199525,0,109,0.8940660046363007,68720554,14426417984,328726,328726,608163317.200014,4161499.549999727,200809,0,109,0.7016055924995398,13049571677,-73350,-73350,42483258.01665306,4639.066666944884,-1284,0,0,0.1924604121367609,-12980851123,2547.7984431452724,1850.0615016762106,697.7369414690618,0.7812989474343712,0.61087045137896,-1284
2001,2022-06-25,2022,256921,256921,650898261.9166658,4189312.7166666663,201751,0,49,0.8952907703146097,69292217,14430948425,328792,328792,608416043.6666758,4184831.6666668607,202824,0,50,0.705388208958859,13055804165,-71871,-71871,42482218.24998999,4481.049999805633,-1073,0,-1,0.18990256135575068,-12986511948,2533.4568288176747,1850.4587814383435,682.9980473793312,0.7852647311819586,0.6168763230248911,-1073
2002,2022-06-26,2022,253593,253593,651281214.7333333,4107136.266666667,197207,0,37,0.8891373184591059,68360820,14445307010,327071,327071,608863607.6333307,4102651.71666639,198197,0,37,0.695066208865969,13068225135,-73478,-73478,42417607.10000265,4484.550000276882,-990,0,0,0.1940711095931369,-12999864315,2568.214480420727,1861.5640262613645,706.6504541593624,0.7776515913294136,0.6059754609855352,-990
2003,2022-06-27,2022,248680,248680,651504108.4666677,4097565.4499999946,191956,0,63,0.8826403410004828,67927552,14462328578,324904,324904,609110985.7166713,4092721.099999743,193020,0,63,0.6819152734346036,13085506670,-76224,-76224,42393122.749996305,4844.35000025155,-1064,0,0,0.20072506756587927,-13017579118,2619.849237842479,1874.7414181317292,745.1078197107497,0.7718996300466463,0.594083175337946,-1064
2004,2022-06-28,2022,248575,248575,651205976.4500002,4092589.583333331,192698,0,81,0.8821844513728249,67422419,14458545728,318192,318192,608947899.0166858,4087963.8999997303,193697,0,81,0.6945492029969316,13097960345,-69617,-69617,42258077.43331432,4625.683333600871,-999,0,0,0.1876352483758933,-13030537926,2619.756517952329,1913.775013252017,705.9815047003119,0.7752107009956754,0.6087425202393524,-999
2005,2022-06-29,2022,251427,251427,651674411.5499997,4122974.8500000043,195222,0,41,0.8822958552581858,68548212,14472300980,320171,320171,609513905.5333353,4118475.94999982,196197,0,42,0.6985329714433856,13102327187,-68744,-68744,42160506.016664386,4498.900000184309,-975,0,-1,0.18376288381480022,-13033778975,2591.903063513464,1903.713657805783,688.1894057076811,0.776455989213569,0.6127881663236208,-975
2006,2022-06-30,2022,255725,255725,652448470.2833337,4121757.2833333374,194989,0,63,0.8711623814644642,67889561,14489781526,325395,325395,610291706.0333307,4118661.8833330167,195804,0,63,0.6888735229490431,13118427372,-69670,-69670,42156764.25000298,3095.4000003207475,-815,0,0,0.1822888585154211,-13050537811,2551.3675639195762,1875.5411301136485,675.8264338059278,0.7624948675334833,0.6017424975798644,-815
2007,2022-07-01,2022,257755,257755,652506278.1166673,4143915.3166666687,197031,0,39,0.8699617854163834,69034309,14495503652,330352,330352,610472576.3166759,4138930.3833330306,197752,0,39,0.682623383542414,13132573652,-72597,-72597,42033701.79999137,4984.933333638124,-721,0,0,0.18733840187396933,-13063539343,2531.49804316761,1847.9457557898118,683.5522873777982,0.7644119415724234,0.5986099675497651,-721
2008,2022-07-02,2022,258709,258709,652554173.4166656,4179577.0333333327,197902,0,55,0.8760074060044309,69507448,14509568689,335661,335661,610540911.1166615,4174132.36666638,198751,0,56,0.6797989638355227,13146783059,-76952,-76952,42013262.300004005,5444.666666952893,-849,0,-1,0.1962084421689082,-13077275611,2522.348172721728,1818.9212065645445,703.4269661571836,0.764959858373694,0.5921182383416602,-849
2009,2022-07-03,2022,261521,261521,652915742.9333329,4181709.0833333354,199344,0,57,0.8721288156591633,69222646,14519527285,337424,337424,610978291.8000088,4176681.3500001696,200181,0,57,0.6804880506425259,13157473540,-75903,-75903,41937451.133324146,5027.733333165757,-837,0,0,0.1916407650166374,-13088250894,2496.6092318908727,1810.7137956992058,685.8954361916669,0.7622485383582963,0.5932624828109441,-837
2010,2022-07-04,2022,262712,262712,654049348.4499995,4224042.450000003,198826,0,36,0.8628574256219731,67111741,14539564080,341785,341785,612153967.0333227,4219468.666666307,199564,0,36,0.667039220562641,13174855093,-79073,-79073,41895381.41667676,4573.783333696425,-738,0,0,0.19581820505933212,-13107743352,2489.6059123679142,1791.0498325945337,698.5560797733806,0.756821157769725,0.5838875316353849,-738
2011,2022-07-05,2022,263707,263707,654982991.1166669,4243690.533333327,198682,0,47,0.8588130007925462,68928418,14555489941,338619,338619,613148611.2999904,4238470.099999767,199440,0,47,0.6729185308562068,13190516979,-74912,-74912,41834379.8166765,5220.433333559893,-758,0,0,0.1858944699363394,-13121588561,2483.7527677182134,1810.7330400833694,673.019727634844,0.7534195148403342,0.5889805356462573,-758
2012,2022-07-06,2022,259630,259630,655673040.6166667,4239347.016666672,199539,0,47,0.8717367022300961,69311829,14572598390,337362,337362,613919021.5833393,4234493.699999744,200396,0,48,0.6750493535134381,13211623680,-77732,-77732,41754019.03332734,4853.31666692812,-857,0,-1,0.19668734871665805,-13142311851,2525.4132442963705,1819.7634042462973,705.6498400500732,0.7685514000693294,0.594008809528044,-857
2013,2022-07-07,2022,262080,262080,656843304.0500003,4251298.050000001,201728,0,36,0.879292582417583,68888663,14592369867,334583,334583,615073402.7666707,4246342.766666436,202635,0,36,0.6934482624640127,13232285068,-72503,-72503,41769901.283329606,4955.2833335651085,-907,0,0,0.1858443199535703,-13163396405,2506.2702382860207,1838.3283154454073,667.9419228406134,0.7697191697191698,0.6056344763481707,-907
2014,2022-07-08,2022,264337,264337,657411469.2833343,4261707.783333335,205008,0,35,0.8847796562721069,69860715,14604038524,338875,338875,615715667.3833401,4256590.599999968,206004,0,36,0.6953566949465065,13255706952,-74538,-74538,41695801.899994135,5117.183333367109,-996,0,-1,0.18942296132560033,-13185846237,2487.0202403875896,1816.94036852332,670.0798718642695,0.7755554462674541,0.6079055699004058,-996
2015,2022-07-09,2022,260459,260459,657652424.683334,4289212.750000001,203945,0,33,0.896640162175237,70630734,14615474801,336375,336375,616004645.733331,4283661.849999918,204849,0,33,0.6993236714975828,13268044850,-75916,-75916,41647778.95000303,5550.90000008326,-904,0,0,0.19731649067765422,-13197414116,2524.9748508722446,1831.3032946364353,693.6715562358092,0.7830215120230055,0.6089899665551839,-904
2016,2022-07-10,2022,257979,257979,658655747.1833327,4231542.766666664,203048,0,43,0.8959954104791479,70159148,14636230316,330949,330949,617077565.6499915,4226676.966666493,203988,0,44,0.7035857488616136,13284235180,-72970,-72970,41578181.53334117,4865.800000171177,-940,0,-1,0.19240966161753426,-13214076032,2553.1370661307033,1864.569965916173,688.5671002145302,0.7870718159230015,0.6163729154643163,-940
2017,2022-07-11,2022,259768,259768,659682092.0000001,4242880.63333333,203127,0,80,0.8928659419174034,70020307,14664616627,334364,334364,618117231.2333316,4238028.083333117,203981,0,79,0.6987654173296087,13312352303,-74596,-74596,41564860.76666856,4852.550000213087,-854,0,1,0.1941005245877947,-13242331996,2539.5048350836137,1848.6357120782488,690.8691230053648,0.7819554371593114,0.610056704669163,-854
2018,2022-07-12,2022,258479,258479,660492676.9000003,4237511.400000001,201161,0,47,0.8869192468246946,70174597,14682884407,328796,328796,619046518.8333449,4232862.749999805,201961,0,47,0.7016539130646234,13340570599,-70317,-70317,41446158.0666554,4648.65000019595,-800,0,0,0.18526533376007115,-13270396002,2555.304983770443,1882.7677916803882,672.5371920900548,0.7782489099694753,0.6142440905607124,-800
2019,2022-07-13,2022,258019,258019,661206234.7000003,4231782.166666666,201742,0,46,0.8914886113038201,69707567,14701898379,329623,329623,619828712.0833383,4226753.899999885,202722,0,47,0.7034278554591246,13364011505,-71604,-71604,41377522.616662025,5028.266666781157,-980,0,-1,0.1880607558446955,-13294303938,2562.6261426484107,1880.4170585284955,682.2090841199151,0.7818881555234305,0.6150116951790379,-980
2020,2022-07-14,2022,261549,261549,662143668.0833333,4270055.999999995,206197,0,78,0.9010931030132028,71991442,14722907642,331997,331997,620807609.5666636,4265142.116666613,207256,0,77,0.7167384042626762,13383235965,-70448,-70448,41336058.51666963,4913.883333382197,-1059,0,1,0.18435469875052657,-13311244523,2531.623780183955,1869.9193353152698,661.7044448686854,0.7883685275034505,0.6242707012412763,-1059
2021,2022-07-15,2022,266325,266325,663191548.9999996,4296210.116666667,211666,0,58,0.9110597953628096,74546237,14748031205,338266,338266,621844707.733338,4291081.233333293,212793,0,59,0.7248467182631322,13410865430,-71941,-71941,41346841.266661644,5128.883333373815,-1127,0,-1,0.18621307709967738,-13336319193,2490.1588247442023,1838.3305083376338,651.8283164065685,0.7947657936731437,0.6290700218171498,-1127
2022,2022-07-16,2022,262493,262493,663727841.2000003,4312251.166666665,211411,0,57,0.9198302430921966,75597092,14770877454,337949,337949,622398447.2833385,4307061.56666665,212550,0,57,0.7221858919541229,13439243667,-75456,-75456,41329393.91666174,5189.60000001546,-1139,0,0,0.19764435113807377,-13363646575,2528.554442213698,1841.6934131580165,686.8610290556817,0.8053967153409806,0.6289410532358433,-1139
2023,2022-07-17,2022,263299,263299,664742642.8833336,4267195.233333334,210964,0,43,0.9151990702585268,75762960,14802854335,336442,336442,623498285.6166571,4262156.783333074,211971,0,45,0.7230488464579313,13466490690,-73143,-73143,41244357.266676426,5038.450000260025,-1007,0,-2,0.19215022380059543,-13390727730,2524.6683158057326,1853.2118035698786,671.456512235854,0.8012335785551787,0.6300372723976198,-1007
2024,2022-07-18,2022,262920,262920,665443253.8999999,4280457.833333336,209057,0,30,0.9093260307317822,75224489,14829579807,340515,340515,624279661.5833244,4275273.166666583,210147,0,30,0.7085179801183455,13499873697,-77595,-77595,41163592.316675425,5184.666666752659,-1090,0,0,0.20080805061343665,-13424649208,2530.9723638369082,1833.3396813160196,697.6326825208887,0.795135402403773,0.6171446191797718,-1090
2025,2022-07-19,2022,265871,265871,666378759.2333332,4322215.483333337,210117,0,48,0.903193654065317,76255860,14856839343,345914,345914,625291235.7333275,4321980.949999938,214261,0,49,0.7101447180513062,13528446243,-80043,-80043,41087523.50000572,234.53333339933306,-4144,0,-1,0.19304893601401085,-13452190383,2506.3988145880267,1807.6494034162465,698.7494111717801,0.7902967980712451,0.6194054013425302,-4144
2026,2022-07-20,2022,268734,268734,667619311.7333338,4325943.250000001,209920,0,89,0.891725646922235,76790334,14886664085,350455,350455,624960485.5000086,4321172.283333355,210811,0,89,0.6885220641737154,13488400281,-81721,-81721,42658826.23332524,4770.966666646302,-891,0,0,0.20320358274851957,-13411609947,2484.312784140949,1783.2831190880672,701.0296650528819,0.7811441797465152,0.6015351471658272,-891
2027,2022-07-21,2022,270193,270193,668190663.550001,4315857.416666671,210194,0,124,0.8911000655087298,75117695,14895517507,347997,347997,625510926.8666615,4311191.433333154,211268,0,125,0.6977071641422182,13507305694,-77804,-77804,42679736.68333948,4665.983333516866,-1074,0,-1,0.19339290136651155,-13432187999,2473.012489405725,1797.4606874963335,675.5518019093913,0.7779402131069273,0.6070971876194335,-1074
2028,2022-07-22,2022,272048,272048,669163189.5833333,4348779.1333333375,214609,0,122,0.9019364229841802,75452105,14915611082,351379,351379,626437742.2666675,4343981.516666647,215549,0,123,0.7034654888311498,13522402946,-79331,-79331,42725447.31666577,4797.616666690446,-940,0,-1,0.1984709341530304,-13446950841,2459.7247161652845,1782.79789704754,676.9268191177446,0.7888644650943951,0.6134373425845028,-940
2029,2022-07-23,2022,270044,270044,669177995.2333329,4367726.0833333405,214276,0,135,0.9047229340403792,75939501,14923475838,348192,348192,626463629.9666538,4362348.900000089,215125,0,136,0.7064694191710411,13531747017,-78148,-78148,42714365.26667905,5377.183333251625,-849,0,-1,0.19825351486933807,-13455807516,2478.033191751466,1799.1901880762734,678.8430036751924,0.7934855060656781,0.6178344131973165,-849
2030,2022-07-24,2022,272731,272731,669843578.0166671,4357153.100000004,216396,0,126,0.9079239250396909,76085369,14942670971,349819,349819,627271152.5333343,4351595.666666732,217448,0,127,0.7141293068701309,13550394594,-77088,-77088,42572425.48333287,5557.433333272114,-1052,0,-1,0.19379461816956,-13474309225,2456.0595532472184,1793.1305976328738,662.9289556143447,0.7934411563041972,0.6216014567533495,-1052
2031,2022-07-25,2022,270828,270828,670465156.5333327,4344496.483333332,210746,0,136,0.8923154179036149,75175428,14960447535,351732,351732,627899037.8166783,4339075.216666722,211860,0,137,0.6942558538887842,13567789683,-80904,-80904,42566118.71665442,5421.266666610725,-1114,0,-1,0.1980595640148307,-13492614255,2475.61240541352,1785.16324308473,690.4491623287897,0.7781544005789652,0.602333594896114,-1114
2032,2022-07-26,2022,269036,269036,670356398.2833341,4336421.633333331,209638,0,131,0.8904793410547281,73664605,14963635127,347635,347635,627766291.4666672,4331316.166666664,210608,0,133,0.6945618249025588,13586298671,-78599,-78599,42590106.81666696,5105.466666666791,-970,0,-2,0.19591751615216935,-13512634066,2491.697758974019,1805.8201604172973,685.8775985567218,0.7792191379592323,0.6058308283113035,-970
2033,2022-07-27,2022,273304,273304,670827672.2833337,4361546.199999999,212742,0,126,0.8942020607089549,73124812,14970703252,349393,349393,628375861.633341,4356515.266666697,213688,0,128,0.7050112623893706,13600192624,-76089,-76089,42451810.649992704,5030.933333301917,-946,0,-2,0.1891907983195843,-13527067812,2454.5109924601675,1798.4786805498134,656.0323119103541,0.7784079267043292,0.6115978282335365,-946
2034,2022-07-28,2022,274521,274521,671310822.4999996,4363482.249999998,213446,0,129,0.8887480374907563,73501122,14977436254,352223,352223,628925460.1000168,4358398.883333263,214291,0,130,0.697714232176773,13605341921,-77702,-77702,42385362.39998281,5083.36666673515,-845,0,-1,0.19103380531398328,-13531840799,2445.389687856301,1785.5888459868231,659.8008418694778,0.77752157394152,0.6083958174224852,-845
2035,2022-07-29,2022,273619,273619,671706171.6833332,4339277.333333331,213712,0,124,0.8927267477770185,73225165,14992023765,370977,370976,629457814.7833359,4389083.533334411,223722,0,125,0.6907247619124626,13622260432,-97358,-97357,42248356.899997234,-49806.20000107959,-10010,0,-1,0.20200198586455598,-13549035267,2454.8959380866577,1696.761555419585,758.1343826670727,0.7810568710506215,0.6030616453311122,-10010
2036,2022-07-30,2022,269299,269299,671694738.000001,4337352.16666667,212241,0,130,0.9007311575609255,74525731,14997932941,363599,363599,621844451.1833417,4332563.333333254,213199,0,131,0.6730244032574322,13230609588,-94300,-94300,49850286.81665921,4788.833333415911,-958,0,-1,0.2277067543034933,-13156083857,2494.234059539772,1710.2479687329771,783.9860908067947,0.7881239811510625,0.5863574982329435,-958
2037,2022-07-31,2022,268166,268166,672102536.9166679,4303070.166666664,211361,0,139,0.9034739676170734,73708388,15000139653,347920,347920,622089565.7000012,4297901.900000012,212470,0,139,0.7031817659231806,13209041689,-79754,-79754,50012971.2166667,5168.266666652635,-1109,0,0,0.20029220169389284,-13135333301,2506.2928817100897,1788.0247347091322,718.2681470009575,0.7881722515158521,0.610686364681536,-1109
2038,2022-08-01,2022,279072,279072,672763214.883333,4402699.833333333,216670,0,123,0.8933859362458434,74271374,15022678177,358599,358599,622724927.7333428,4397440.266666735,217805,0,124,0.7022942060630449,13226271952,-79527,-79527,50038287.1499902,5259.566666598432,-1135,0,-1,0.19109173018279846,-13152000578,2410.715567607402,1736.5495378775256,674.1660297298765,0.7763946221763559,0.6073776000490799,-1135
2039,2022-08-02,2022,283361,283361,673339750.3666669,4475855.583333331,217094,0,130,0.8842889459029298,74803995,15038386396,362649,362649,623373459.7333308,4469809.900001715,218356,0,131,0.6973961047734819,13244354571,-79288,-79288,49966290.63333607,6045.683331616223,-1262,0,-1,0.18689284112944793,-13169550576,2376.2612016708968,1718.9443779889943,657.3168236819024,0.76613930639714,0.6021138897391142,-1262
2040,2022-08-03,2022,285845,285845,674128914.5500011,4500097.849999997,218421,0,132,0.8822438734279062,73608535,15055656282,367470,367470,624068036.466671,4493396.333335033,219608,0,133,0.692725936811169,13253216207,-81625,-81625,50060878.083330154,6701.516664964147,-1187,0,-1,0.18951793661673721,-13179607672,2358.3722456226315,1698.282952259153,660.0892933634784,0.7641239133096608,0.5976215745503034,-1187
2041,2022-08-04,2022,285415,285415,674781888.7166669,4484875.083333331,220047,0,130,0.8878685422980567,73587399,15070775087,368164,368164,624618972.2333481,4479044.850000165,221233,0,130,0.6949375821644623,13269258389,-82749,-82749,50162916.483318806,5830.233333165757,-1186,0,0,0.19293096013359434,-13195670990,2364.213123755468,1696.5780799680256,667.6350437874426,0.7709720932676979,0.6009088341065395,-1186
2042,2022-08-05,2022,281980,281980,674885809.6166673,4455450.149999995,219293,0,126,0.8936343003049865,73514348,15081740507,366122,366122,624696585.3499848,4449702.316668148,220414,0,126,0.6938042510419943,13279847152,-84142,-84142,50189224.266682506,5747.833331846632,-1121,0,0,0.1998300492629922,-13206332804,2393.3818342317445,1706.2525206078433,687.1293136239012,0.7776899070856089,0.6020233692594272,-1121
2043,2022-08-06,2022,279534,279534,674771109.2499993,4453340.349999994,219252,0,124,0.9003985203946567,74384955,15089985400,363595,363595,624880908.3999923,4448964.150001604,220607,0,125,0.6993275485086272,13299209501,-84061,-84061,49890200.85000694,4376.1999983899295,-1355,0,-1,0.20107097188602951,-13224824546,2413.914261771374,1718.6179908964434,695.2962708749308,0.7843482367082358,0.6067382664778118,-1355
2044,2022-08-07,2022,270392,270392,675095691.3000007,4350718.649999992,212886,0,129,0.9024675286251069,73257203,15107658433,355043,355043,625351865.049998,4346224.000001129,214160,0,130,0.6943750475294344,13320727621,-84651,-84651,49743826.25000262,4494.649998863228,-1274,0,-1,0.20809248109567258,-13247470418,2496.729530829317,1761.3412038823412,735.3883269469757,0.7873235894553093,0.6031945426328642,-1274
2045,2022-08-08,2022,273370,273370,675645856.2500018,4359672.483333333,213541,0,119,0.8975820316786776,73274407,15130497750,353953,353953,625906783.7166619,4354512.366667804,214586,0,119,0.6985418968055239,13343977018,-80583,-80583,49739072.53333986,5160.116665529087,-1045,0,0,0.19904013487315364,-13270702611,2471.5435353184394,1768.333037766771,703.2104975516684,0.7811427735303801,0.6062556328100058,-1045
2046,2022-08-09,2022,271345,271345,675883497.6833341,4345772.366666655,212138,0,124,0.8965965836849764,73911986,15146783727,351550,351550,626156407.9166697,4340775.700001168,213279,0,125,0.6979860617266321,13366388742,-80205,-80205,49727089.766664386,4996.666665486991,-1141,0,-1,0.19861052195834428,-13292476756,2490.8640206502205,1781.130444934347,709.7335757158735,0.7818017652803626,0.6066818375764471,-1141
2047,2022-08-10,2022,279602,279602,676141220.5999995,4404193.9,216248,0,128,0.890655288588781,74015290,15157167148,356412,356412,626553292.7666748,4399035.366667887,217468,0,130,0.7048724509836971,13383796878,-76810,-76810,49587927.83332479,5158.533332113177,-1220,0,-2,0.18578283760508385,-13309781588,2418.2274111057845,1757.9466818363994,660.2807292693851,0.7734136379568101,0.6101590294378416,-1220
2048,2022-08-11,2022,280334,280334,676571621.8166672,4420519.866666659,216292,0,126,0.8874271404824239,74970145,15171435968,362289,362289,626937959.7333355,4414483.150001612,217424,0,126,0.692717692229116,13400764242,-81955,-81955,49633662.083331704,6036.716665047221,-1132,0,0,0.19470944825330783,-13325794097,2413.44832170435,1730.4912921268256,682.9570295775243,0.7715510783565318,0.6001396675030155,-1132
2049,2022-08-12,2022,287223,287223,677521485.683333,4437713.900000006,220495,0,125,0.8825477068340619,75532626,15193624659,381444,381444,627953882.8166617,4442554.083334948,226667,0,126,0.6850940111785733,13418016691,-94221,-94221,49567602.866671324,-4840.183334941976,-6172,0,-1,0.19745369565548865,-13342484065,2358.8691911279147,1646.2544510246896,712.6147401032251,0.7676787722431699,0.5942340160023489,-6172
2050,2022-08-13,2022,284877,284877,677848765.6500002,4452672.149999999,219570,0,131,0.8873162803595936,74883887,15205171218,387897,387897,625165609.0499477,4460504.166666313,226032,0,131,0.6722145311771045,13351540473,-103020,-103020,52683156.600052476,-7832.016666313633,-6462,0,0,0.21510174918248914,-13276656586,2379.443639360146,1611.6794124469839,767.764226913162,0.7707536936993861,0.5827113898792721,-6462
2051,2022-08-14,2022,284336,284336,678483100.3500003,4446095.433333333,219501,0,121,0.8915016037364236,74821128,15220436317,379695,379695,617206236.4166662,4440518.533334904,220758,0,122,0.6738908861059624,13119585606,-95359,-95359,61276863.93333411,5576.8999984283,-1257,0,-1,0.21761071763046125,-13044764478,2386.2018891382036,1625.5316409662128,760.6702481719908,0.7719775195543301,0.5814087622960534,-1257
2052,2022-08-15,2022,275595,275595,679105250.3333329,4363329.249999988,214380,0,66,0.8999328725121997,73101701,15245184844,368587,368587,617785771.1000013,4358106.966666586,215613,0,68,0.6792751779091439,12990985075,-92992,-92992,61319479.23333156,5222.283333402127,-1233,0,-2,0.22065769460305573,-12917883374,2464.142130057994,1676.0921332005778,788.0499968574163,0.7778805856419746,0.5849717977031202,-1233
2053,2022-08-16,2022,284195,284195,679451303.216667,4479838.533333327,218648,0,64,0.8899663963123909,72937837,15254140027,365583,365583,618164671.3833246,4474009.000001685,219871,0,64,0.6990095272482612,13007697496,-81388,-81388,61286631.83334243,5829.533331641927,-1223,0,0,0.19095686906412979,-12934759659,2390.792600913693,1690.9010303633502,699.891570550343,0.7693590668379106,0.6014256680425513,-1223
2054,2022-08-17,2022,287994,287994,679768956.7000004,4549609.933333332,221069,0,73,0.8914664888851852,73359116,15262931312,369676,369676,618625735.1833401,4543947.983335307,222506,0,73,0.702631493524056,13019204691,-81682,-81682,61143221.51666033,5661.949998024851,-1437,0,0,0.18883499536112924,-12945845575,2360.358051556631,1673.4268256076675,686.9312259489634,0.7676166864587457,0.6018946320561789,-1437
2055,2022-08-18,2022,286920,286920,680805150.6833338,4576926.633333331,221806,0,61,0.8984351038617047,73966457,15282470955,368997,368997,619776677.2333332,4570725.066668675,223409,0,62,0.7075829884795802,13042395452,-82077,-82077,61028473.450000525,6201.566664655693,-1603,0,-1,0.19085211538212443,-12968428995,2372.8047911729186,1679.6252469080596,693.179544264859,0.7730586923184163,0.60544936679702,-1603
2056,2022-08-19,2022,287597,287597,681231872.8166667,4523310.683333332,221711,0,52,0.8910002538274047,73785484,15295887638,372459,372459,620372994.2833403,4517116.983335188,223302,0,55,0.6966753387621114,13066440435,-84862,-84862,60858878.53332639,6193.69999814406,-1591,0,-3,0.19432491506529326,-12992654951,2368.702986528603,1665.6141864831843,703.0888000454188,0.770908597794831,0.5995344454020443,-1591
2057,2022-08-20,2022,284494,284494,681319422.3166664,4529618.05,221242,0,49,0.8994565790491184,73963167,15306029604,372209,372209,620546735.9000049,4523669.100001879,222762,0,50,0.6954426142301762,13077574791,-87715,-87715,60772686.4166615,5948.949998120777,-1520,0,-1,0.20401396481894218,-13003611624,2394.8463669415396,1667.1997074224557,727.6466595190839,0.7776684218296344,0.5984863342906808,-1520
2058,2022-08-21,2022,282589,282589,681701990.2166669,4494206.699999997,220482,0,50,0.9027138352872889,74127431,15315572380,365934,365934,621095660.2166678,4488149.733335185,222080,0,52,0.7055315985943028,13093465304,-83345,-83345,60606329.999999166,6056.966664812528,-1598,0,-2,0.19718223669298607,-13019337873,2412.3443949221905,1697.2887466501275,715.0556482720631,0.7802214523566027,0.606885394634005,-1598
2059,2022-08-22,2022,281228,281228,682614546.7166672,4490234.466666669,217418,0,58,0.8990889954058621,74417247,15337613295,366634,366634,622149295.2666758,4484843.183334988,218936,0,58,0.6976603370118291,13119684444,-85406,-85406,60465251.449991345,5391.283331681043,-1518,0,0,0.201428658394033,-13045267197,2427.2638098506095,1696.9219855951053,730.3418242555042,0.7731022515538993,0.5971513825777206,-1518
2060,2022-08-23,2022,278877,278877,682873263.300001,4443657.416666667,214509,0,47,0.8934225482918989,73149625,15352083771,360966,360966,622557374.466667,4437635.516668121,216071,0,49,0.6986198146085605,13141077655,-82089,-82089,60315888.83333397,6021.899998545647,-1562,0,-2,0.19480273368333845,-13067928030,2448.6539345302804,1724.6981002827608,723.9558342475195,0.769188567002657,0.5985910030307564,-1562
2061,2022-08-24,2022,274395,274395,682522663.0166653,4413204.966666663,212664,0,51,0.8949397765994282,73131915,15356391374,357147,357147,622222461.0333204,4407959.716668047,213989,0,51,0.6949071390771601,13151759698,-82752,-82752,60300201.98334491,5245.249998616055,-1325,0,0,0.2000326375222682,-13078627783,2487.372812976422,1742.2026813421937,745.1701316342285,0.7750286995025419,0.5991622497179032,-1325
2062,2022-08-25,2022,281084,281084,682368847.8000001,4431609.349999998,218559,0,55,0.8961520399595841,73128555,15360116601,360667,360667,622234075.6499912,4425350.816668095,219501,0,59,0.7043782769147066,13166237977,-79583,-79583,60134772.15000892,6258.533331902698,-942,0,-4,0.1917737630448776,-13093109422,2427.633190789942,1725.2315172998672,702.4016734900749,0.7775575984403239,0.6085974042537854,-942
2063,2022-08-26,2022,288611,288611,680898547.6166662,4472928.25,223408,0,47,0.8834382611889371,73139012,15329870232,370818,370818,621848968.2499998,4467036.700001633,224760,0,47,0.6948206397747698,13161480724,-82207,-82207,59049579.366666436,5891.549998367205,-1352,0,0,0.18861762141416727,-13088341712,2359.225904822291,1676.9654338516464,682.2604709706445,0.7740799900211703,0.6061194440399333,-1352
2064,2022-08-27,2022,284825,284825,680308963.2166665,4525703.416666665,220625,0,50,0.8866988501711572,73852030,15325473955,373263,373263,621532640.2333267,4519634.066668446,222292,0,50,0.6851388967028548,13166802062,-88438,-88438,58776322.98333979,6069.349998218939,-1667,0,0,0.20155995346830247,-13092950032,2388.515626144708,1665.1332712680514,723.3823548766568,0.7745984376371456,0.5955371949536922,-1667
2065,2022-08-28,2022,282179,282179,680588522.4499989,4451358.800000002,217394,0,61,0.8806076993681307,73324343,15337652160,366211,366211,621830744.0333285,4445058.216668158,218813,0,61,0.6854490990166798,13180223250,-84032,-84032,58757778.41667032,6300.583331843838,-1419,0,0,0.19515860035145083,-13106898907,2411.9035167393704,1698.0121952462612,713.8913214931092,0.7704116890342655,0.5975052633591017,-1419
2066,2022-08-29,2022,286500,286500,681095715.7999997,4487917.016666667,216434,0,38,0.8694938917975574,73345081,15362467741,374189,374188,622355026.8500217,4482225.550000064,217994,0,38,0.6741700049974684,13193056804,-87689,-87688,58740688.949977994,5691.46666660253,-1560,0,0,0.19532388680008905,-13119711723,2377.297437347294,1663.2148194223805,714.0826179249134,0.7554415357766143,0.5825772537407566,-1560
2067,2022-08-30,2022,286086,286086,681543418.7833337,4501495.6166666625,215359,0,43,0.8703956153044887,73513806,15371430667,371610,371610,622999107.5500001,4495371.433335032,216698,0,43,0.6776190091763012,13217173688,-85524,-85524,58544311.23333359,6124.183331630193,-1339,0,0,0.19277660612818748,-13143659882,2382.302590071984,1676.4863904362103,705.8161996357737,0.7527771369448347,0.5831328543365356,-1339
2068,2022-08-31,2022,286244,286244,682076802.4999999,4474891.566666671,216656,0,71,0.875641061472031,73210380,15387764274,374535,374535,623627704.0500003,4468803.216668287,218110,0,71,0.6764788337538639,13233344768,-88291,-88291,58449098.44999957,6088.349998383783,-1454,0,0,0.19916222771816716,-13160134388,2382.851002990455,1665.0718999559463,717.7791030345088,0.7568927208954598,0.5823487791528161,-1454
2069,2022-09-01,2022,287892,287892,681931417.5500003,4518696.966666666,217126,0,105,0.8681936281661181,73978589,15399111297,378544,378544,623588307.4999918,4513278.500001804,218387,0,105,0.6667177395494287,13253938385,-90652,-90652,58343110.050008535,5418.466664861888,-1261,0,0,0.2014758886166894,-13179959796,2368.7056866811176,1647.3337511623267,721.3719355187909,0.7541925444263821,0.5769131197430153,-1261
2070,2022-09-02,2022,283548,283548,682120169.1499993,4515067.649999993,217424,0,48,0.8804964238859029,73142706,15412985297,371707,371707,623914054.9833301,4509360.183335253,218520,0,38,0.6773399478621616,13270427985,-88159,-88159,58206114.16666913,5707.466664739884,-1096,0,10,0.20315647602374132,-13197285279,2405.6603084839226,1678.5103723721375,727.1499361117851,0.7667978613850213,0.5878823912382602,-1096
2071,2022-09-03,2022,277498,277498,682222614.7166657,4489977.533333333,213474,0,54,0.8923667918327333,73117909,15425245161,361792,361792,624049360.4833277,4484348.216666723,214833,0,51,0.6913972669379007,13285362380,-84294,-84294,58173254.233338,5629.316666610539,-1359,0,3,0.20096952489483255,-13212244471,2458.4775916102667,1724.884354776578,733.5932368336887,0.7692812200448291,0.5938025163629931,-1359
2072,2022-09-04,2022,274028,274028,682560688.8166661,4423098.883333334,211545,0,74,0.900922533463734,73028329,15439481201,355966,355966,624503456.5833308,4416960.266668287,212957,0,45,0.701190563143646,13305683998,-81938,-81938,58057232.233335376,6138.616665046662,-1412,0,29,0.19973197032008794,-13232655669,2490.842865753376,1754.3907468222549,736.452118931121,0.7719831550060577,0.5982509565520302,-1412
2073,2022-09-05,2022,271327,271327,682289483.3166662,4369896.299999996,206615,0,50,0.8905858981966415,71503645,15447727235,356612,356612,624323937.4833364,4364246.966667811,208135,0,50,0.6859976669321136,13329862464,-85285,-85285,57965545.8333298,5649.333332184702,-1520,0,0,0.20458823126452785,-13258358819,2514.639100851247,1750.7092792259837,763.9298216252632,0.7614981185064517,0.5836455307168575,-1520
2074,2022-09-06,2022,291863,291863,682328083.9666668,4555018.416666664,220681,0,49,0.8847507220853624,72739613,15451247632,370213,370212,624374446.9999903,4548776.333335436,222207,0,47,0.7060448984773731,13340763663,-78350,-78349,57953636.96667647,6242.083331228234,-1526,0,2,0.17870582360798937,-13268024050,2337.8368754061557,1686.5321680550342,651.3047073511216,0.7561116003056229,0.6002139308992391,-1526
2075,2022-09-07,2022,291547,291547,682760899.316666,4627701.766666667,222320,0,62,0.8888309603597367,73344260,15466170122,376457,376457,624832846.8166662,4621756.650002319,223969,0,34,0.6962946631354986,13329734191,-84910,-84910,57928052.49999976,5945.116664347239,-1649,0,28,0.19253629722423815,-13256389931,2341.8553417344924,1659.7721567580527,682.0831849764397,0.7625528645467111,0.5949391298342175,-1649
2076,2022-09-08,2022,289899,289899,683340519.0999995,4592870.933333331,219751,0,40,0.8795304571592164,72832605,15474400250,376068,376068,625475519.8666657,4586703.18333551,221405,0,41,0.6870113915568457,13344290716,-86169,-86169,57864999.233333826,6167.749997820705,-1654,0,-1,0.19251906560237075,-13271458111,2357.1675621509544,1663.1979319342931,693.9696302166612,0.7580260711489174,0.5887366114638842,-1654
2077,2022-09-09,2022,287832,287832,683547677.7000014,4556083.116666672,221948,0,63,0.8931043108479939,73003443,15480254581,374175,374174,625770764.1000032,4551065.416668821,223648,0,63,0.6956584485868886,13364296485,-86343,-86342,57776913.59999812,5017.699997850694,-1700,0,0,0.19744586226110528,-13291293042,2374.814745059623,1672.4057900869736,702.4089549726493,0.7711025876205564,0.5977096278479321,-1700
2078,2022-09-10,2022,287041,287041,683119169.4166672,4593879.333333338,221972,0,45,0.8993175191000584,74407970,15485857938,372927,372927,625470097.2999963,4588202.650002154,223784,0,39,0.7028024251394943,13371158287,-85886,-85886,57649072.116670966,5676.683331184089,-1812,0,6,0.1965150939605641,-13296750317,2379.8661843313926,1677.1917756021855,702.674408729207,0.773311129768918,0.6000745454204174,-1812
2079,2022-09-11,2022,295558,295558,683784524.9333329,4655110.383333327,227531,0,60,0.8976546058641621,74898871,15504621971,379796,379796,626365461.7666603,4648957.533336107,229269,0,60,0.7081222551053774,13391916385,-84238,-84238,57419063.16667259,6152.849997220561,-1738,0,0,0.18953235075878472,-13317017514,2313.5375287873544,1649.215530881474,664.3219979058804,0.7698353622639211,0.603663545692951,-1738
2080,2022-09-12,2022,290836,290836,684833573.0166663,4601080.33333333,221709,0,46,0.8899414102793329,73900436,15536187977,380681,380681,627490607.6999959,4595171.983335528,223238,0,36,0.6883926437095508,13415900278,-89845,-89845,57342965.31667042,5908.3499978026375,-1529,0,10,0.20154876656978216,-13341999842,2354.707027385421,1648.3370793393835,706.3699480460375,0.7623162194501368,0.5864174991659683,-1529
2081,2022-09-13,2022,282541,282541,684273215.266666,4495583.599999999,214633,0,57,0.8880268704365024,72242898,15534131102,371499,371499,627179631.2666612,4490339.033335019,216062,0,42,0.6834042621918083,13431352255,-88958,-88958,57093584.00000489,5244.566664979793,-1429,0,15,0.20462260824469414,-13359109357,2421.854581340995,1688.2404293595976,733.6141519813975,0.7596525813952665,0.5815951052358149,-1429
2082,2022-09-14,2022,271512,271512,683349639.6166673,4388098.050000001,206393,0,44,0.885957158431303,72129713,15538543215,358894,358894,626402110.2166864,4382471.450000009,207820,0,44,0.6774395782598895,13445978418,-87382,-87382,56947529.3999809,5626.599999992177,-1427,0,0,0.20851758017141342,-13373848705,2516.8303412617756,1745.3680201304185,771.4623211313572,0.7601616134830136,0.5790567688509699,-1427
2083,2022-09-15,2022,280007,280007,683340344.1333338,4449912.633333331,213261,0,73,0.8810529736756583,70676944,15549335189,360401,360401,626608112.2000028,4444239.349999448,214679,0,61,0.6920458045343914,13456057142,-80394,-80394,56732231.93333101,5673.2833338826895,-1418,0,12,0.18900716914126692,-13385380198,2440.44021804217,1738.6414360670553,701.7987819751145,0.7616273878867315,0.5956670486485887,-1418
2084,2022-09-16,2022,293829,293829,683508738.2500001,4628581.516666662,225151,0,109,0.8995742421612574,73421082,15544860523,375452,375452,626911649.3166504,4622548.816669049,226483,0,109,0.7103997315236078,13464471322,-81623,-81623,56597088.93334973,6032.6999976132065,-1332,0,0,0.18917451063764956,-13391050240,2326.2126551497645,1669.7517906860276,656.4608644637369,0.7662654128761966,0.6032275763612925,-1332
2085,2022-09-17,2022,286102,286102,683422829.4999995,4606835.200000002,221940,0,113,0.9065543058070199,73205647,15550631577,373243,373243,626881677.816662,4600217.8833356295,223755,0,113,0.7040560707099831,13471503918,-87141,-87141,56541151.68333757,6617.316664372571,-1815,0,0,0.2024982350970368,-13398298271,2388.738385261199,1679.5537433164507,709.1846419447481,0.7757373244507204,0.5994888048804666,-1815
2086,2022-09-18,2022,275139,275139,683822921.1500001,4406657.6000000015,211908,0,220,0.9002685915119263,71023984,15569243900,363677,363677,627282154.6666626,4400413.883334592,213497,0,222,0.6893479653648794,13483682206,-88538,-88538,56540766.48333752,6243.716665409505,-1589,0,-2,0.21092062614704687,-13412658222,2485.3725613235497,1724.8331752259905,760.5393860975591,0.7701852518181719,0.5870511470343189,-1589
2087,2022-09-19,2022,271594,271594,683891977.4333348,4347763.533333335,208559,0,67,0.8938378609247625,70903870,15587825544,360162,360162,627512030.8000042,4341999.616667845,209837,0,70,0.6813600546420941,13511553169,-88568,-88568,56379946.63333058,5763.916665489785,-1278,0,-3,0.21247780628266832,-13440649299,2518.0673263523304,1742.304937222706,775.7623891296244,0.7679072439008225,0.5826183772857769,-1278
2088,2022-09-20,2022,289560,289560,684174739.4499996,4587906.266666664,224460,0,56,0.9058468020444809,72804672,15599400322,370934,370934,627915246.3499992,4581877.86666885,226276,0,56,0.7170601778214059,13529055087,-81374,-81374,56259493.10000038,6028.399997813627,-1816,0,0,0.18878662422307502,-13456250415,2362.8081898397554,1692.7950696080682,670.0131202316873,0.775176129299627,0.6100168763176198,-1816
2089,2022-09-21,2022,287482,287482,684981782.999999,4430382.283333335,219952,0,69,0.8892730675311855,70788132,15615702926,368380,368380,628840431.1833344,4424642.450001043,221560,0,53,0.7025082794939992,13539778980,-80898,-80898,56141351.816664696,5739.833332291804,-1608,0,16,0.18676478803718632,-13468990848,2382.6945095692913,1707.0428122681317,675.6516973011596,0.7650983365915084,0.6014441609207883,-1608
2090,2022-09-22,2022,284736,284736,684620311.0666673,4206023.200000001,215444,0,57,0.8798465947403912,69521589,15624667051,381141,381141,628607819.7833378,4201252.916667107,216392,0,49,0.6618784124510341,13558885904,-96405,-96405,56012491.28332949,4770.283332894556,-948,0,8,0.2179681822893571,-13489364315,2404.4037672323393,1649.2789277021832,755.1248395301561,0.7566447516295797,0.5677478938240703,-948
2091,2022-09-23,2022,291474,291474,684936023.9833332,4542516.199999994,221928,0,47,0.8881375354234001,71894127,15629076177,380849,380849,628993066.9333333,4536472.433335321,223418,0,38,0.6863927698378944,13568388601,-89375,-89375,55942957.04999995,6043.766664672643,-1490,0,9,0.2017447655855057,-13496494474,2349.9043619099243,1651.5549914358007,698.3493704741236,0.7613989583976616,0.5866314471089592,-1490
2092,2022-09-24,2022,287474,287474,684986047.7000002,4622899.550000001,220725,0,43,0.8980986106569633,72305928,15630906042,384582,384582,629122858.766661,4629579.550002494,226987,0,44,0.6933631839243423,13574090711,-97108,-97108,55863188.93333912,-6680.0000024931505,-6262,0,-1,0.20473542673262102,-13501784783,2382.775651711112,1635.8614255650577,746.9142261460543,0.7678085670356276,0.5902174308729998,-6262
2093,2022-09-25,2022,291697,291697,685215451.5499996,4525439.999999996,223385,0,53,0.8862518298097003,70030875,15637281531,387263,387263,628158370.8499981,4525003.950001917,227682,0,43,0.6857871782225461,13537239677,-95566,-95566,57057080.70000148,436.0499980794266,-4297,0,10,0.2004646515871542,-13467208802,2349.065816755056,1622.0459244750934,727.0198922799625,0.7658117841458774,0.587926034761906,-4297
2094,2022-09-26,2022,286708,286708,685661081.3166674,4557364.450000001,217973,0,51,0.884188791383567,72062485,15655204802,381101,381101,627049720.9666655,4551126.483335405,219519,0,41,0.6731732532845711,13483808815,-94393,-94393,58611360.35000193,6237.966664596461,-1546,0,10,0.21101553809899587,-13411746330,2391.496160960515,1645.363620055223,746.1325409052922,0.7602613111597862,0.5760126580617736,-1546
2095,2022-09-27,2022,282097,282097,685993627.0833328,4548453.316666667,213748,0,50,0.8863086101589167,71868056,15664636729,365170,365170,627509801.2333292,4542435.3000020785,215437,0,50,0.6937700249198905,13495612237,-83073,-83073,58483825.8500036,6018.016664588824,-1689,0,0,0.19253858523902623,-13423744181,2431.7650562867834,1718.4045820667886,713.3604742199948,0.757711000116981,0.589963578607224,-1689
2096,2022-09-28,2022,287195,287195,686810852.9166657,4598492.866666665,218087,0,69,0.8859485715280566,72210829,15679631489,367326,367326,628340563.4999993,4593018.100002429,219955,0,58,0.7023597567283514,13515198772,-80131,-80131,58470289.41666639,5474.766664235853,-1868,0,11,0.18358881479970524,-13442987943,2391.444324994048,1710.580148151776,680.8641768422722,0.7593690697957833,0.5988005205185585,-1868
2097,2022-09-29,2022,290362,290362,686975375.9166676,4583286.150000001,221012,0,59,0.8857495126772791,72572027,15682083883,372158,372158,628667582.7333354,4577557.566668751,222740,0,40,0.7000951208895111,13527329143,-81796,-81796,58307793.183332205,5728.583331250586,-1728,0,19,0.185654391787768,-13454757116,2365.9272766982854,1689.2491434641613,676.6781332341241,0.7611602069141279,0.5985092353247814,-1728
2098,2022-09-30,2022,293244,293244,687228648.0499998,4611881.849999998,223246,0,45,0.884297717941374,73851009,15683478556,378321,378316,629071294.199996,4605459.216668974,224971,0,51,0.6943495074288691,13538743588,-85077,-85072,58157353.85000384,6422.633331024088,-1725,0,-6,0.18994821051250488,-13464892579,2343.5386505776755,1662.8196909461826,680.7189596314929,0.7612977588629264,0.5946563896796636,-1725
2099,2022-10-01,2022,287084,287084,687040822.0166675,4558450.383333337,219724,0,47,0.8874406097170159,74052100,15689191510,374553,374551,628987607.449996,4551620.833335536,221581,0,47,0.6903909460076675,13546740540,-87469,-87467,58053214.56667149,6829.549997800961,-1857,0,0,0.1970496637093484,-13472688440,2393.17001998254,1679.3109815485634,713.8590384339766,0.7653648409524738,0.5915878393711972,-1857
2100,2022-10-02,2022,275261,275261,686548062.9666662,4443402.900000001,210683,0,41,0.8902060226475956,72219339,15699670302,364142,364142,628577994.7833322,4437240.9666682705,212573,0,41,0.6833625343959283,13564973332,-88881,-88881,57970068.18333399,6161.9333317307755,-1890,0,0,0.20684348825166732,-13492753993,2494.1712155614714,1726.1892195443872,767.9819960170842,0.765393571919015,0.5837640261216778,-1890
2101,2022-10-03,2022,274551,274551,686948543.1166662,4396371.6000000015,208492,0,69,0.8851943719017595,72134570,15722018365,358564,358564,629031599.3999987,4391414.516668092,210384,0,69,0.688412668310255,13587812939,-84013,-84013,57916943.71666753,4957.083331909031,-1892,0,0,0.1967817035915045,-13515678369,2502.0799163604074,1754.3077369730331,747.7721793873743,0.759392608294998,0.5867404424314767,-1892
2102,2022-10-04,2022,269454,269454,686801413.0333335,4318697.0666666655,205568,0,47,0.891773735034552,71097024,15728307371,367468,367468,629040256.8166595,4333387.266667694,216159,0,39,0.688596013802567,13605084802,-98014,-98014,57761156.21667409,-14690.200001028366,-10591,0,8,0.20317772123198508,-13533987778,2548.8633051776314,1711.823224924781,837.0400802528504,0.7629057278793412,0.5882389759108276,-10591
2103,2022-10-05,2022,274826,274826,686605743.3000008,4398525.666666664,209891,0,69,0.8925611113941174,71164767,15736462500,364894,364894,613395050.7833395,4392041.283334761,211568,0,50,0.6809731045179952,13052415365,-90068,-90068,73210692.51666129,6484.3833319032565,-1677,0,19,0.21158800687612223,-12981250598,2498.328918297398,1681.0225730851685,817.3063452122296,0.7637232285154971,0.57980673839526,-1677
2104,2022-10-06,2022,278624,278624,687140570.0666658,4501558.583333325,213338,0,57,0.8979664350522569,70722464,15739853061,356690,356690,614097117.4333388,4494657.816668472,215009,0,43,0.7115562533292171,13059898245,-78066,-78066,73043452.633327,6900.766664852388,-1671,0,14,0.1864101817230398,-12989175781,2466.1930417575863,1721.6549873372921,744.5380544202942,0.7656842195934306,0.6027895371330847,-1671
2105,2022-10-07,2022,279241,279241,687731268.433333,4454352.699999997,212761,0,50,0.8946107484216151,70857509,15744285041,389354,389354,614871056.8166546,4488523.966668335,232773,0,51,0.7030542899263782,13071197492,-110113,-110113,72860211.61667848,-34171.2666683374,-20012,0,-1,0.19155645849523695,-13000339983,2462.859209189671,1579.2082701517245,883.6509390379467,0.7619260781905236,0.5978441212880823,-20012
2106,2022-10-08,2022,276943,276943,687571651.9833333,4417206.01666666,212298,0,146,0.8984159195213445,70481375,15742888571,370715,370715,582145828.599992,4411080.6500013955,213747,0,146,0.6786722954291128,11850997241,-93772,-93772,105425823.38334131,6125.366665264592,-1449,0,0,0.2197436240922317,-11780515866,2482.71901432184,1570.3325427889133,912.3864715329266,0.7665765157451172,0.5765803919452949,-1449
2107,2022-10-09,2022,260539,260539,687207876.4666666,4225571.399999997,200273,0,91,0.8925957342278886,69689742,15750717014,345545,345545,581914514.3833482,4219769.566666361,201757,0,92,0.6805191798463393,11842720766,-85006,-85006,105293362.08331835,5801.833333635703,-1484,0,-1,0.21207655438154938,-11773031024,2637.639188246929,1684.0484289552685,953.5907592916603,0.7686872214908325,0.5838805365437207,-1484
2108,2022-10-10,2022,282763,282763,687548852.4499992,4376768.599999996,221260,0,57,0.9169304329067103,71102916,15769600537,369046,369046,582404070.7833326,4371574.616667788,222535,0,48,0.7087951095527439,11860650265,-86283,-86283,105144781.66666663,5193.983332208358,-1275,0,9,0.20813532335396634,-11789547349,2431.5375507050044,1578.1340829688781,853.4034677361262,0.7824927589536114,0.6030007099385984,-1275
2109,2022-10-11,2022,273668,273668,687530490.2999994,4403786.516666667,207818,0,55,0.8949310843796124,68717221,15769439915,361359,361359,582441323.699995,4397082.216667997,209433,0,56,0.6863202521592087,11873869886,-87691,-87691,105089166.60000432,6704.299998669885,-1615,0,-1,0.20861083222040377,-11805152665,2512.2794418784783,1611.8079906685457,900.4714512099326,0.7593799786602745,0.5795704548662134,-1615
2110,2022-10-12,2022,276489,276489,687955382.0333326,4436862.033333333,208501,0,46,0.8870153966342247,68920396,15777386732,358135,358135,583047201.6166643,4431173.050001589,210145,0,41,0.6931966995686013,11887409904,-81646,-81646,104908180.4166683,5688.983331744559,-1644,0,5,0.19381869706562338,-11818489508,2488.183551726588,1628.0095539856877,860.1739977409004,0.7541023331850454,0.586775936448546,-1644
2111,2022-10-13,2022,289424,289424,688987765.2500002,4484152.416666666,222234,0,60,0.9016356625573555,70989771,15794653674,365026,365026,584286780.9999912,4476964.766668359,223814,0,49,0.7233210784985203,11905095609,-75602,-75602,104700984.25000906,7187.649998307228,-1580,0,11,0.17831458405883516,-11834105838,2380.5481413082543,1600.6716809213349,779.8764603869195,0.7678492453977556,0.6131453649876996,-1580
2112,2022-10-14,2022,271509,271509,688880603.8166667,4305732.049999999,207123,0,75,0.889697947397692,69202509,15801866440,360693,360693,584407962.4333365,4299654.216667662,208649,0,76,0.677892279584036,11918054776,-89184,-89184,104472641.38333023,6077.833332336508,-1526,0,-1,0.21180566781365606,-11848852267,2537.229350837971,1620.2364959490105,916.9928548889607,0.7628586897671901,0.5784670065679123,-1526
2113,2022-10-15,2022,259584,259584,688413025.2500001,4226839.233333337,195692,0,48,0.8764330621301769,70054623,15807477097,345327,345327,584124659.9999942,4220913.133333113,197243,0,34,0.6669475598490554,11941093236,-85743,-85743,104288365.25000596,5926.100000224076,-1551,0,14,0.2094855022811215,-11871038613,2651.985581738474,1691.5116976083368,960.4738841301373,0.7538677268244576,0.5711774636793532,-1551
2114,2022-10-16,2022,246888,246888,687561474.25,4026982.3999999985,187018,0,75,0.8802574446712682,68393994,15813877097,327306,327306,583504180.4333427,4021137.8666663226,188224,0,75,0.6703237948586331,11954288606,-80418,-80418,104057293.8166573,5844.533333675936,-1206,0,0,0.20993364981263507,-11885894612,2784.91248764622,1782.7481941465867,1002.1642934996335,0.757501377142672,0.5750704233958437,-1206
2115,2022-10-17,2022,270713,270713,687170700.6666677,4270563.233333329,211220,0,96,0.903750466361054,71348366,15828712733,351941,351941,583216562.5166457,4265797.366666429,212219,0,96,0.7012510619677633,11979371496,-81228,-81228,103954138.15002203,4765.866666899994,-999,0,0,0.20249940439329073,-11908023130,2538.3734828643906,1657.1429941855188,881.2304886788718,0.7802358955794513,0.6029959567086529,-999
2116,2022-10-18,2022,288486,288486,688287323.2666664,4798984.100000001,226814,0,53,0.92315398320889,76036638,15844127399,355123,355123,584735780.8833276,4793072.98333625,228118,0,42,0.7570025033579866,11997070667,-66637,-66637,103551542.38333881,5911.116663750261,-1304,0,11,0.1661514798509034,-11921034029,2385.8603996958827,1646.5725421426594,739.2878575532234,0.7862218617194595,0.6423633501631829,-1304
2117,2022-10-19,2022,299088,299088,690019660.4833336,4901689.51666666,236547,0,46,0.9300540309206655,76569017,15873357343,371298,371298,586577259.4333262,4895488.250003478,238010,0,39,0.7560477029232552,12025529665,-72210,-72210,103442401.05000734,6201.266663182527,-1463,0,7,0.17400632799741034,-11948960648,2307.0790552724734,1579.8018288095445,727.2772264629289,0.790894318728936,0.6410214975572182,-1463
2118,2022-10-20,2022,339698,339698,691214404.733333,5128549.399999986,285329,0,177,1.1751997362363038,92353333,15898123588,425347,425345,588047253.2833258,5119576.150003632,295522,0,42,1.0788532656866059,12072692647,-85649,-85647,103167151.4500072,8973.249996354803,-10193,0,135,0.09634647054969792,-11980339314,2034.7909164414657,1382.5183163862882,652.2726000551775,0.8399490135355522,0.6947786160476035,-10193
2119,2022-10-21,2022,381554,381554,693432739.6666675,5541238.833333334,325280,0,231,1.3354492417849109,102143936,15940986256,489364,489364,590441641.8166581,5530374.250005507,344125,0,56,1.3652046329521537,12126358393,-107810,-107810,102991097.85000932,10864.583327827044,-18845,0,175,-0.029755391167242795,-12024214457,1817.3908271612077,1206.5489938300695,610.8418333311381,0.8525136677901424,0.7032086544984919,-18845
2120,2022-10-22,2022,382864,382864,695134066.9166657,5574012.866666665,324190,0,195,1.2909806093025216,101569894,15983801351,518355,518355,592286275.783318,5562239.1833390305,342167,0,78,1.2361354670062332,12177575069,-135491,-135491,102847791.13334763,11773.683327634819,-17977,0,117,0.05484514229628834,-12076005175,1815.616163746567,1142.6267245098784,672.9894392366887,0.8467497597057964,0.660101667775945,-17977
2121,2022-10-23,2022,367879,367879,695957734.5833334,5486050.183333335,314178,0,184,1.2962658917741987,103016051,16019563614,513544,513544,593239869.616561,5474061.016666665,330780,0,49,1.205727259981629,12225429567,-145665,-145665,102717864.96677232,11989.166666670702,-16602,0,135,0.0905386317925696,-12122413516,1891.811532007354,1155.188006512706,736.623525494648,0.8540253724730142,0.6441122863863661,-16602
2122,2022-10-24,2022,375390,375390,697221783.9666662,5505957.499999996,323136,0,189,1.3125309677934955,104478610,16069292576,515625,515625,594623516.1332314,5493853.14999994,339787,0,96,1.222239030303047,12278585841,-140235,-140235,102598267.83343482,12104.350000056438,-16651,0,93,0.0902919374904485,-12174107231,1857.3264710478868,1153.2092434099034,704.1172276379834,0.8608007672021099,0.6589808484848485,-16651
2123,2022-10-25,2022,382755,382755,698547335.7999995,5612963.333333335,327035,0,171,1.3155282099515362,104491168,16107075854,519798,519798,596155964.3666716,5600786.10000569,345161,0,45,1.26389289685605,12321772352,-137043,-137043,102391371.43332791,12177.233327644877,-18126,0,126,0.05163531309548608,-12217281184,1825.050844012487,1146.8993038962665,678.1515401162205,0.8544238481535186,0.6640291036133267,-18126
2124,2022-10-26,2022,398267,398267,699850784.916667,5825561.849999995,342130,0,196,1.3707462581634937,103942580,16142056531,536343,536343,597655886.1333181,5814488.133339814,360872,0,55,1.3031828512723873,12365140356,-138076,-138076,102194898.78334892,11073.71666018106,-18742,0,141,0.0675634068911064,-12261197776,1757.2402054819179,1114.3165588687054,642.9236466132124,0.8590468203491628,0.6728380905502636,-18742
2125,2022-10-27,2022,376907,376907,699718460.9999999,5131288.650000002,315952,0,191,1.2794853902952186,99014408,16169946145,526349,526349,597630192.7499508,5119091.916665967,333423,0,86,1.192877729415287,12400755516,-149442,-149442,102088268.25004911,12196.733334035613,-17471,0,105,0.08660766087993155,-12301741108,1856.475101284932,1135.4257208619201,721.0493804230118,0.8382757550271022,0.6334637284387356,-17471
2126,2022-10-28,2022,344598,344598,695767845.0166659,4951698.633333329,287917,0,159,1.2717630398319237,95860385,16152653952,509829,509829,593742372.7833015,4940575.433332703,302782,0,67,1.0513740881746336,12415434306,-165231,-165231,102025472.23336446,11123.200000626035,-14865,0,92,0.2203889516572901,-12319573921,2019.0710480521243,1164.5912115303395,854.4798365217848,0.8355155862773435,0.5938893236751931,-14865
2127,2022-10-29,2022,355133,355133,695093581.166667,5188980.699999999,298763,0,152,1.270574686103516,101390506,16164350693,506173,506173,593029977.566672,5177767.733337648,315588,0,67,1.1232226926366706,12429172870,-151040,-151040,102063603.59999502,11212.966662351042,-16825,0,85,0.14735199346684547,-12327782364,1957.2767981760833,1171.5954378575545,785.6813603185287,0.8412707351893516,0.6234785340190014,-16825
2128,2022-10-30,2022,337500,337500,694744299.9000002,5199245.4833333315,284937,0,146,1.2318370370370368,101603140,16181733606,467879,467879,593201607.13331,5189157.166665934,299741,0,139,1.0970913419922632,12431296176,-130379,-130379,101542692.76669025,10088.316667397507,-14804,0,7,0.13474569504477363,-12329693036,2058.5016293333338,1267.8526010641854,790.6490282691484,0.8442577777777778,0.6406378572237694,-14804
2129,2022-10-31,2022,337746,337746,695121497.2166674,5195056.716666669,286822,0,165,1.2414654799760765,103109655,16213645790,458458,458458,593704668.4666727,5184763.200004649,301054,0,122,1.122207486836341,12466692380,-120712,-120712,101416828.74999475,10293.516662019305,-14232,0,43,0.11925799313973551,-12363582725,2058.1191108604316,1295.0033993662946,763.115711494137,0.8492239730448325,0.6566664776271763,-14232
2130,2022-11-01,2022,333206,333206,695443785.6333331,5205913.133333336,284060,0,159,1.2594581129991649,101019360,16238344480,451140,451140,594342393.1333245,5196342.833332725,297679,0,68,1.151930664538675,12511533273,-117934,-117934,101101392.50000858,9570.300000610761,-13619,0,91,0.10752744846048978,-12410513913,2087.1286400404947,1317.4234010137086,769.7052390267861,0.8525056571610355,0.6598373010595381,-13619
2131,2022-11-02,2022,354911,354911,696099754.6666653,5370155.633333334,302736,0,165,1.2666753073305725,101054258,16271055582,465861,465861,595037134.6333399,5359629.766671681,318539,0,69,1.2131000448631568,12550884947,-110950,-110950,101062620.03332543,10525.866661652923,-15803,0,96,0.05357526246741573,-12449830689,1961.3360945889683,1277.2847150401942,684.0513795487741,0.8529913133151692,0.6837640412054239,-15803
2132,2022-11-03,2022,369149,369149,695496227.1666669,5449409.999999999,313427,0,165,1.2776439865745266,101074960,16280636461,489951,489951,594783460.8166766,5438549.366671723,329287,0,55,1.2116783106882105,12577311704,-120802,-120802,100712766.34999025,10860.633328275755,-15860,0,110,0.06596567588631608,-12476236744,1884.052854448114,1213.9651941044647,670.0876603436493,0.8490528214894256,0.6720814938636721,-15860
2133,2022-11-04,2022,362032,362032,694595135.2333336,5315341.466666664,306206,0,163,1.261866354355415,97462070,16286585514,501669,501669,594254643.9333235,5306780.450004607,323346,0,65,1.1735108208799263,12607864017,-139637,-139637,100340491.30001009,8561.016662056558,-17140,0,98,0.08835553347548863,-12510401947,1918.6014916729284,1184.5552424672912,734.0462492056372,0.8457981614884872,0.6445405237317833,-17140
2134,2022-11-05,2022,384710,384710,694547437.9333338,5582956.183333341,327002,0,195,1.333604533284812,97596205,16299412771,524154,524154,594417413.2665533,5573037.116666507,345931,0,71,1.288613651713027,12626635211,-139444,-139444,100130024.66678047,9919.066666834056,-18929,0,124,0.04499088157178499,-12529039006,1805.3792153396942,1134.051086639715,671.3281286999791,0.849996100959164,0.6599797006223361,-18929
2135,2022-11-06,2022,402642,402642,695869553.8000004,5862865.666666661,346408,0,229,1.4072178262575668,98463073,16326729446,536315,536315,595239945.9166709,5850701.950006461,365584,0,93,1.3334234544996186,12649210088,-133673,-133673,100629607.88332951,12163.716660200618,-19176,0,136,0.07379437175794812,-12550747015,1728.2587355516823,1109.8700314491873,618.388704102495,0.8603374710040185,0.6816590995963193,-19176
2136,2022-11-07,2022,396687,396687,696976652.833333,5677008.833333335,338302,0,219,1.3456705160491755,99063812,16360116596,541499,541499,596627741.2665824,5664955.833333008,355741,0,52,1.2260835200064715,12673873312,-144812,-144812,100348911.56675065,12053.000000326894,-17439,0,167,0.11958699604270406,-12574809500,1756.9939343445412,1101.8076511066176,655.1862832379236,0.8528184689692377,0.656955968524411,-17439
2137,2022-11-08,2022,396852,396852,697956091.1499993,5850880.250000005,340026,0,200,1.3654410208339633,100763356,16391403994,548761,548761,597781923.5832386,5839387.016666931,356408,0,52,1.2084331794715255,12714902747,-151909,-151909,100174167.56676066,11493.233333073556,-16382,0,148,0.15700784136243784,-12614139391,1758.7314443419696,1089.3301885214848,669.4012558204847,0.8568080795863445,0.6494776414504675,-16382
2138,2022-11-09,2022,395400,395400,699263339.6166668,5854022.583333331,338706,0,213,1.3891274658573585,100844141,16421946988,533213,533213,599315568.3666564,5842187.383339688,357089,0,72,1.3285234981142633,12749379677,-137813,-137813,99947771.25001037,11835.199993642978,-18383,0,141,0.06060396774309518,-12648535536,1768.4960536587425,1123.9702864833687,644.5257671753739,0.8566160849772383,0.6696929744773664,-18383
2139,2022-11-10,2022,389403,389403,699357655.2833335,5661514.933333333,331480,0,185,1.3393451000634293,101659655,16452198025,536950,536950,599616932.4499928,5650276.133339221,349157,0,67,1.2253152062574961,12796032609,-147547,-147547,99740722.83334076,11238.799994111992,-17677,0,118,0.1140298938059332,-12694372954,1795.9739788428274,1116.7090649967274,679.2649138461,0.8512517879934156,0.6502598007263246,-17677
2140,2022-11-11,2022,389441,389441,700108321.2500011,5644435.249999998,333462,0,184,1.3285889261788035,103512371,16494541127,537800,537800,600475088.5665647,5633527.616666571,350507,0,57,1.1935366307177404,12838423780,-148359,-148359,99633232.6834364,10907.6333334269,-17045,0,127,0.13505229546106312,-12734911409,1797.7262826718325,1116.539770484501,681.1865121873313,0.8562580724679734,0.65174228337672,-17045
2141,2022-11-12,2022,362696,362696,699071472.7333335,5409655.666666672,310419,0,176,1.301635529479232,102841097,16522994417,516698,516698,599695893.1998936,5398833.133333086,326773,0,64,1.1381096888317959,12888943310,-154002,-154002,99375579.53343987,10822.533333585598,-16354,0,112,0.16352584064743603,-12786102213,1927.4308862886094,1160.6313420990473,766.7995441895621,0.8558655182301431,0.6324255174202339,-16354
2142,2022-11-13,2022,373910,373910,699251940.1833341,5428694.649999995,321438,0,163,1.3304003637238921,100924624,16557032108,519397,519397,600088966.8499082,5417083.449999583,339946,0,67,1.2121325306076087,12926038204,-145487,-145487,99162973.33342588,11611.20000041183,-18508,0,96,0.11826783311628342,-12825113580,1870.1076199709398,1155.3570137099525,714.7506062609873,0.8596667647294803,0.6545012774428809,-18508
2143,2022-11-14,2022,379448,379448,700270044.8833345,5489453.816666668,323027,0,214,1.3371133857603685,99511466,16598845121,525280,525280,601244330.9499966,5478015.8000053065,343023,0,72,1.2929218702405985,12967849815,-145832,-145832,99025713.93333793,11438.016661361791,-19996,0,142,0.044191515519770075,-12868338349,1845.4967344229894,1144.6168347357534,700.879899687236,0.8513076890641141,0.6530288607980506,-19996
2144,2022-11-15,2022,374064,374064,700173992.4833341,5533292.333333337,316782,0,200,1.3462134821848666,97455761,16606402851,517133,517133,601297437.8332355,5522682.299999732,335474,0,53,1.2762152096269335,12989294049,-143069,-143069,98876554.65009856,10610.033333605155,-18692,0,147,0.06999827255793312,-12891838288,1871.8026660767518,1162.7520151164895,709.0506509602624,0.8468657769793404,0.6487189949200689,-18692
2145,2022-11-16,2022,369819,369819,700891251.7166659,5571998.866666667,311223,0,190,1.3546870225704997,98041091,16631964444,507407,507407,602336085.5999191,5560935.633333864,329263,0,75,1.2634906495180562,13022629034,-137588,-137588,98555166.11674678,11063.233332803473,-18040,0,115,0.09119637305244344,-12924587943,1895.2278052687013,1187.0866692811078,708.1411359875935,0.8415549228135926,0.6489130027768636,-18040
2146,2022-11-17,2022,360440,360440,701828144.733333,5518140.033333332,306670,0,166,1.3315281322827683,100071914,16667997670,493031,493031,603329202.8999703,5507730.283334161,322899,0,54,1.2428569400301495,13060596054,-132591,-132591,98498941.8333627,10409.749999171123,-16229,0,112,0.08867119225261888,-12960524140,1947.1427830799385,1223.714539045152,723.4282440347865,0.8508212185107091,0.6549263636566464,-16229
2147,2022-11-18,2022,360830,360830,702471372.0833342,5412295.933333333,306852,0,172,1.297946401352438,98558104,16702531759,494519,494519,604142831.1333399,5401683.050005016,323118,0,47,1.1815926182815626,13100491069,-133689,-133689,98328540.94999433,10612.883328316733,-16266,0,125,0.1163537830708754,-13001932965,1946.8208632412334,1221.677693138868,725.1431701023653,0.8504060083695923,0.6533985549594656,-16266
2148,2022-11-19,2022,369392,369392,702984519.3000011,5484028.0333333295,316059,0,183,1.321011283406247,97213410,16718500357,497823,497823,604924287.5999981,5473858.533338717,333052,0,56,1.2160366234585345,13136898949,-128431,-128431,98060231.70000303,10169.499994612299,-16993,0,127,0.1049746599477126,-13039685539,1903.0853924827857,1215.1392916759532,687.9461008068324,0.8556195044830424,0.6690168995807747,-16993
2149,2022-11-20,2022,372701,372701,703486920.7666662,5449416.416666665,320948,0,172,1.3283946112299143,96870982,16745473250,509056,509056,605675849.3166659,5441578.183338823,338144,0,52,1.2375789697007706,13174164988,-136355,-136355,97811071.45000029,7838.2333278423175,-17196,0,120,0.09081564152914368,-13077294006,1887.536982102721,1189.8020047237749,697.734977378946,0.8611406999176283,0.6642569776213226,-17196
2150,2022-11-21,2022,370199,370199,704252458.4499999,5446078.899999997,317469,0,184,1.3106005148582247,96367350,16770927686,518947,518947,606762448.416663,5471671.600005218,337127,0,70,1.1614211085139863,13213077008,-148748,-148748,97490010.03333688,-25592.70000522118,-19658,0,114,0.14917940634423843,-13116709658,1902.3618606479215,1169.2185298627087,733.1433307852128,0.8575630944437992,0.6496366680990544,-19658
2151,2022-11-22,2022,374063,374063,704472472.1999993,5508171.150000006,322884,0,193,1.3463373816710034,95587608,16799155497,529604,529604,605953469.7999225,5517045.549998509,344716,0,69,1.2021982462367842,13202104939,-155541,-155541,98519002.40007687,-8874.399998502806,-21832,0,124,0.1441391354342192,-13106517331,1883.29899562373,1144.1633178750963,739.1356777486337,0.8631808010950027,0.6508938754239016,-21832
2152,2022-11-23,2022,378618,378618,705183163.4166654,5498671.433333327,326777,0,176,1.3350131266870553,96264413,16827613837,522452,522452,600350784.3666714,5487615.316672066,343214,0,52,1.2170055813739633,12927132457,-143834,-143834,104832379.04999399,11056.116661260836,-16437,0,124,0.11800754531309199,-12830868044,1862.5188538755829,1149.1022799542761,713.4165739213067,0.8630783533799238,0.6569292490027792,-16437
2153,2022-11-24,2022,389585,389585,706218702.7166674,5648341.31666667,336260,0,179,1.3437966040786995,97271111,16854253882,537137,537137,601639540.099945,5637962.633331941,359740,0,56,1.2344951101860477,12954801474,-147552,-147552,104579162.61672246,10378.683334728703,-23480,0,123,0.10930149389265176,-12857530363,1812.746134262529,1120.085825590017,692.660308672512,0.8631235802199777,0.6697360263768833,-23480
2154,2022-11-25,2022,390776,390776,707284546.6500003,5731279.53333333,337535,0,175,1.385755522345283,98531236,16886515251,530258,530258,591814682.7666628,5719969.666672688,353933,0,58,1.2707021864827919,12537817740,-139482,-139482,115469863.8833375,11309.866660642438,-16398,0,117,0.11505333586249122,-12439286504,1809.948785621431,1116.088173618621,693.8606120028098,0.863755706594059,0.6674731922950714,-16398
2155,2022-11-26,2022,364824,364824,707759489.9833342,5495974.250000004,314833,0,179,1.3497028704251905,96956308,16914373948,509588,509588,592597948.783332,5487051.766665665,331905,0,52,1.1984524753330215,12576229417,-144764,-144764,115161541.2000022,8922.483334338292,-17072,0,127,0.1512503950921691,-12479273109,1940.0025491287147,1162.8962000347967,777.106349093918,0.8629722825252725,0.6513202822672434,-17072
2156,2022-11-27,2022,352409,352409,707642437.0166683,5261390.916666668,301582,0,168,1.3086470549844094,97294204,16948967680,504470,504470,592633399.1666505,5260118.566665376,325787,0,53,1.2040260074929354,12617703989,-152061,-152061,115009037.85001779,1272.3500012923032,-24205,0,115,0.10462104749147394,-12520409785,2008.0146563131711,1174.7644045565653,833.2502517566058,0.8557726959300131,0.64580054314429,-24205
2157,2022-11-28,2022,333496,333496,706783238.7500005,5120059.83333333,282454,0,142,1.2304795259913168,97940108,16985308135,471641,471641,584708621.2999947,5110440.700004041,295385,0,63,1.0482973278404593,12379915368,-138145,-138145,122074617.45000577,9619.133329289034,-12931,0,79,0.18218219815085757,-12281975260,2119.3154902907395,1239.732383953038,879.5831063377016,0.8469486890397486,0.6262920314391667,-12931
2158,2022-11-29,2022,307499,307499,705153759.9166665,4815362.1833333345,257352,0,91,1.1529500908946055,98161927,16999934811,427775,427775,583446873.2833513,4807486.366667032,267234,0,72,0.9642685991467345,12407795848,-120276,-120276,121706886.6333152,7875.816666302271,-9882,0,19,0.18868149174787108,-12309633921,2293.1904166084005,1363.9106382639268,929.2797783444737,0.8369197948611214,0.6247069136812576,-9882
2159,2022-11-30,2022,302554,302554,703794071.5333334,4818023.866666669,253835,0,103,1.1663967423997021,98532858,17011189868,417610,417610,582575495.2833656,4812222.2666669525,266397,0,68,1.0145446708651793,12443885648,-115056,-115056,121218576.24996781,5801.599999716505,-12562,0,35,0.15185207153452285,-12345352790,2326.1767206294858,1395.0228569319834,931.1538636975024,0.8389741996470051,0.6379085749862312,-12562
2160,2022-12-01,2022,307440,307440,704065696.5166669,4956952.799999996,260204,0,118,1.2146565183450433,97763594,17037273115,412421,412421,582740096.249997,4947677.88333691,275078,0,60,1.1947572989735857,12457024543,-104981,-104981,121325600.26666987,9274.916663086042,-14874,0,58,0.019899219371457555,-12359260949,2290.091388617834,1412.9738695410686,877.1175190767656,0.8463570127504554,0.6669834950208646,-14874
2161,2022-12-02,2022,321056,321056,704912336.65,5056512.700000004,273269,0,122,1.225281570816305,96151139,17061818807,423234,423234,583811442.8000152,5048852.583333849,289449,0,66,1.2201973376429631,12489209444,-102178,-102178,121100893.84998477,7660.116666154936,-16180,0,56,0.0050842331733418344,-12393058305,2195.6055537040265,1379.4058199483388,816.1997337556877,0.851156807535134,0.6838982690426573,-16180
2162,2022-12-03,2022,314237,314237,705212599.3500006,4933163.75,268781,0,132,1.2275734557038156,95863070,17089084995,426242,426242,583820861.6166658,4923946.46666582,282084,0,59,1.1301232633105067,12514441103,-112005,-112005,121391737.73333478,9217.283334179781,-13303,0,73,0.09745019239330888,-12418578033,2244.2061226080973,1369.6934173935601,874.5127052145372,0.8553448511792056,0.6617930659109145,-13303
2163,2022-12-04,2022,304799,304799,705464494.7999994,4902068.1333333375,262658,0,118,1.2396562980849692,94985479,17119694760,418721,418721,584329501.3666401,4892422.683332625,276745,0,69,1.1364106409757149,12542110731,-113922,-113922,121134993.43335927,9645.450000712648,-14087,0,49,0.10324565710925437,-12447125252,2314.5236526366534,1395.5103789077693,919.0132737288841,0.8617416723808149,0.6609293539134651,-14087
2164,2022-12-05,2022,332838,332838,707037910.1666669,5136165.083333328,286690,0,135,1.2711889868344333,96184334,17166323515,434233,434233,586123548.9166657,5126864.166670971,302568,0,82,1.270992761950385,12587744162,-101395,-101395,120914361.25000119,9300.916662357748,-15878,0,53,0.00019622488404835714,-12491559828,2124.2703963089157,1349.7904325941734,774.4799637147423,0.8613499660495496,0.696787208710531,-15878
2165,2022-12-06,2022,351694,351694,708250328.0166667,5333817.583333325,301298,0,150,1.3164711368405493,98119204,17199811993,466120,466120,587519415.916663,5323576.850005008,319591,0,82,1.3333004376555888,12634384903,-114426,-114426,120730912.1000036,10240.73332831636,-18293,0,68,-0.016829300815039527,-12536265699,2013.8254505810921,1260.4467002417039,753.3787503393883,0.85670497648524,0.6856410366429245,-18293
2166,2022-12-07,2022,372389,372389,710018463.2166662,5617914.199999994,321314,0,180,1.389667793624408,98999298,17238242382,494276,494276,589482989.0000033,5607718.483339043,340312,0,181,1.3667363982875418,12682601752,-121887,-121887,120535474.21666288,10195.716660950333,-18998,0,-1,0.022931395336866167,-12583602454,1906.6579926277795,1192.619081242066,714.0389113857136,0.8628450357019138,0.6885060168812567,-18998
2167,2022-12-08,2022,372014,372014,711189591.1999998,5673281.100000011,321161,0,150,1.3958318772949427,98023941,17264897391,498405,498405,590998260.9166722,5662082.000005919,340059,0,106,1.331351009721018,12729161705,-126391,-126391,120191330.28332758,11199.099994092248,-18898,0,44,0.0644808675739248,-12631137764,1911.7280295902838,1185.779157345276,725.9488722450078,0.8633035315875209,0.6822945195172601,-18898
2168,2022-12-09,2022,361232,361232,712471063.3833333,5441754.133333336,310697,0,133,1.3368721486468542,97411821,17307284921,491610,491610,592426978.099955,5431243.249999026,328032,0,58,1.218667236223844,12767584627,-130378,-130378,120044085.28337836,10510.883334309794,-17335,0,75,0.11820491242301023,-12670172806,1972.3365133303066,1205.0751166574214,767.2613966728852,0.8601037560349027,0.6672606334289376,-17335
2169,2022-12-10,2022,346076,346076,712467101.6,5270831.216666663,296905,0,157,1.2970676961129926,94957146,17329980872,473524,473524,592681916.1333234,5259978.350004769,310023,0,157,1.1134113582416012,12807485076,-127448,-127448,119785185.4666766,10852.866661894135,-13118,0,0,0.18365633787139135,-12712527930,2058.70127255285,1251.6407112064508,807.060561346399,0.8579184918919543,0.6547144389724703,-13118
2170,2022-12-11,2022,337268,337268,712074842.8833338,5154395.450000004,291231,0,118,1.2948693620503564,92217835,17352147146,483388,483388,592523250.5499729,5193892.783332125,313512,0,54,1.1181390518589522,12840771370,-146120,-146120,119551592.33336091,-39497.33333212137,-22281,0,64,0.17673031019140417,-12748553535,2111.302711444115,1225.7715345643105,885.5311768798047,0.8635002431300924,0.6485721614934586,-22281
2171,2022-12-12,2022,341326,341326,712574060.683333,5195247.183333329,291664,0,117,1.2875110598079258,92020849,17382134902,478763,478763,588495611.749978,5191013.300000106,312512,0,109,1.1757383089336158,12668513212,-137437,-137437,124078448.9333551,4233.883333222941,-20848,0,8,0.11177275087431005,-12576492363,2087.664170568117,1229.2002760237904,858.4638945443264,0.8545027334571641,0.6527488548613823,-20848
2172,2022-12-13,2022,319445,319445,712027103.5499992,5008134.933333332,270670,0,99,1.2408646245832602,91845371,17389128368,450457,450457,584473174.8666874,5000151.633333729,285228,0,56,1.090259447627641,12552513514,-131012,-131012,127553928.68331182,7983.29999960307,-14558,0,43,0.15060517695561915,-12460668143,2228.9505346773285,1297.5115823856381,931.4389522916904,0.8473133090203321,0.6331969533162988,-14558
2173,2022-12-14,2022,328342,328342,711716451.066667,5007634.566666666,279631,0,95,1.2434656547136835,93834245,17408884276,459013,459013,584516768.7333438,5014412.70000364,299360,0,37,1.1037922673213845,12566383813,-130671,-130671,127199682.33332312,-6778.133336973377,-19729,0,58,0.13967338739229906,-12472549568,2167.607101944518,1273.4209461024934,894.1861558420246,0.8516455403207631,0.6521819643452365,-19729
2174,2022-12-15,2022,327965,327965,712619536.1833324,5016359.966666667,279667,0,103,1.230677053953929,94727724,17439880423,449653,449653,583255943.7666628,5007031.650003856,292805,0,37,1.0739792684581082,12556373730,-121688,-121688,129363592.4166696,9328.316662810743,-13138,0,66,0.1566977854958207,-12461646006,2172.8523963939215,1297.1245466318758,875.7278497620457,0.8527342856707271,0.6511799098415889,-13138
2175,2022-12-16,2022,300001,300001,712615768.3666663,4751378.050000006,253103,0,78,1.1616427945240169,93633872,17465668658,414810,414810,583468136.8166647,4744088.933333383,261120,0,47,0.9476676068561551,12543628099,-114809,-114809,129147631.55000162,7289.116666623391,-8017,0,31,0.21397518766786172,-12449994227,2375.377976628966,1406.5912991891823,968.7866774397835,0.8436738544204853,0.6294930209011355,-8017
2176,2022-12-17,2022,268718,268718,711646356.566666,4554284.333333329,225976,0,63,1.1410809845265284,92756779,17478725519,371642,371642,582781888.7166692,4547776.716666402,232316,0,64,0.9029361589916968,12576140502,-102924,-102924,128864467.8499968,6507.616666927002,-6340,0,-1,0.23814482553483163,-12483383723,2648.3017757153075,1568.1270919774115,1080.174683737896,0.8409410608891105,0.6251069577711884,-6340
2177,2022-12-18,2022,301567,301567,712131152.8999996,4747688.266666666,258976,0,103,1.2176730212523246,93610388,17505177235,395577,395577,583598486.9,4739628.23333635,271550,0,83,1.134972457953784,12605463832,-94010,-94010,128532665.99999964,8060.033330315724,-12574,0,20,0.08270056329854047,-12511853444,2361.435942593187,1475.3094515100727,886.1264910831144,0.8587677033627684,0.6864655932978915,-12574
2178,2022-12-19,2022,328037,328037,713603703.1000005,5102044.2833333295,281968,0,129,1.275755478802695,94630724,17540257605,420155,420155,585347706.0833255,5094396.233337389,296909,0,60,1.237564708262475,12651603628,-92118,-92118,128255997.016675,7648.049995940179,-14941,0,69,0.03819077054022002,-12556972904,2175.375653051334,1393.1708680923123,782.2047849590219,0.8595615738468526,0.7066653972938558,-14941
2179,2022-12-20,2022,324021,324021,712448579.333333,5009386.800000006,276905,0,125,1.2451106564080714,95126306,17523157917,438052,438052,584882126.9166647,5001705.816665842,292620,0,45,1.1561321486946057,12656995538,-114031,-114031,127566452.4166683,7680.983334164135,-15715,0,80,0.08897850771346572,-12561869232,2198.772855257323,1335.1888061615168,863.5840490958062,0.854589671657084,0.6680028855021778,-15715
2180,2022-12-21,2022,299920,299920,712607509.6666658,4826429.683333339,255600,0,100,1.1819651907175257,92957240,17545562244,413388,413388,585025559.6499802,4818168.499999366,265216,0,57,0.9752169874306695,12682475065,-113468,-113468,127581950.0166856,8261.1833339734,-9616,0,43,0.20674820328685617,-12589517825,2375.9919634124626,1415.1972472591856,960.794716153277,0.8522272606028274,0.6415667605252209,-9616
2181,2022-12-22,2022,290182,290182,712907271.5666668,4653305.566666668,244897,0,101,1.145026224920912,92249460,17567030513,389635,389635,585636775.3666825,4645881.066666344,251817,0,101,0.9267339946360058,12714968099,-99453,-99453,127270496.19998431,7424.5000003241,-6920,0,0,0.21829223028490619,-12622718639,2456.7591083067414,1503.0394481160124,953.719660190729,0.8439427669531535,0.6462894760480963,-6920
2182,2022-12-23,2022,282479,282479,712605201.4833335,4612226.999999999,240441,0,82,1.1510059154839833,91392954,17568467003,378326,378326,585699079.949972,4604925.933332731,246943,0,62,0.9325370183386718,12752648083,-95847,-95847,126906121.53336143,7301.066667268053,-6502,0,20,0.2184688971453116,-12661255129,2522.683815375067,1548.1333028921408,974.550512482926,0.8511818577664181,0.6527254272770044,-6502
2183,2022-12-24,2022,283031,283031,712212696.4666668,4611027.633333336,243951,0,106,1.1949150446417527,92219781,17573681653,374673,374673,585582624.7333207,4603223.399999839,252486,0,55,1.0256810605514568,12779581217,-91642,-91642,126630071.7333461,7804.233333496377,-8535,0,51,0.16923398409029589,-12687361436,2516.376992155159,1562.9165291689571,953.4604629862017,0.8619232522232547,0.6738836265223275,-8535
2184,2022-12-25,2022,301232,301232,712405119.6666665,4729583.1499999985,261231,0,135,1.2448079885271153,93936135,17593565730,396643,396643,586058035.5166562,4720927.716669826,274815,0,56,1.1698882874524723,12805539228,-95411,-95411,126347084.15001035,8655.433330172673,-13584,0,79,0.07491970107464296,-12711603093,2364.97158225775,1477.5453884643273,887.4261937934227,0.8672086630902427,0.6928522626139879,-13584
2185,2022-12-26,2022,328042,328042,714143492.7500004,5060994.766666676,284406,0,130,1.3082654050395974,96386849,17649947997,427718,427718,587881096.7333229,5052220.816670819,299855,0,66,1.2506815238077353,12842280125,-99676,-99676,126262396.0166775,8773.949995856732,-15449,0,64,0.05758388123186209,-12745893276,2176.9879855323416,1374.4595661939009,802.5284193384407,0.8669804476256089,0.701057706245704,-15449
2186,2022-12-27,2022,327628,327628,715386297.2166663,5060004.966666668,282638,0,125,1.2732611376317031,96917945,17683526596,436068,436068,589609206.3999765,5050276.183332425,296897,0,68,1.1719823513763654,12889647016,-108440,-108440,125777090.81668985,9728.783334243111,-14259,0,57,0.1012787862553377,-12792729071,2183.532229286466,1352.1038150012762,831.42841428519,0.8626796244521225,0.680850234367117,-14259
2187,2022-12-28,2022,313439,313439,715793875.9166671,4954777.183333326,269844,0,101,1.2523936076876176,96328496,17703173344,425834,425834,590404814.8499768,4945635.783333745,283441,0,43,1.1206831770125996,12930393655,-112395,-112395,125389061.06669033,9141.399999581277,-13597,0,58,0.1317104306750181,-12834065159,2283.6784060588093,1386.4670619301812,897.2113441286281,0.8609139258356491,0.6656138307415566,-13597
2188,2022-12-29,2022,306425,306425,716103632.3333324,4850189.083333333,265950,0,101,1.2495423023578347,94880363,17738620056,415728,415728,590888320.5333208,4841374.366670071,279160,0,47,1.1089750991032603,12970880359,-109303,-109303,125215311.80001163,8814.716663261876,-13210,0,54,0.1405672032545744,-12875999996,2336.9621680128334,1421.3339504034388,915.6282176093946,0.867912213429061,0.6714967478736097,-13210
2189,2022-12-30,2022,302534,302534,716345520.4500002,4840695.183333338,262884,0,93,1.257247119332045,93542868,17760478400,400968,400968,591449728.0499889,4832322.883332776,275559,0,53,1.1462286267233388,13012213732,-98434,-98434,124895792.4000113,8372.300000562333,-12675,0,40,0.11101849260870611,-12918670864,2367.818230182393,1475.0546877805432,892.7635424018499,0.8689403505060588,0.6872343927694978,-12675
2190,2022-12-31,2022,301322,301322,714474434.583333,4848905.950000004,261994,0,94,1.2598681808829106,93793658,17721095724,402599,402599,590110481.999988,4840240.283332679,275015,0,70,1.1360683955995643,12989930189,-101277,-101277,124363952.58334506,8665.66666732449,-13021,0,24,0.12379978528334634,-12896136531,2371.1326573676433,1465.752478272395,905.3801790952484,0.8694818167939945,0.6830990638327468,-13021
