,date,year,num_segs_new,num_segs_distinct_new,sum_seg_length_h_new,sum_seg_day_length_h_new,num_segs_with_idents_new,min_num_idents_new,max_num_idents_new,avg_num_idents_new,total_msg_count_new,total_cumul_msg_count_new,num_segs_old,num_segs_distinct_old,num_segs_stale_old,num_segs_with_stale_old,sum_seg_length_h_old,sum_seg_day_length_h_old,num_segs_with_idents_old,min_num_idents_old,max_num_idents_old,avg_num_idents_old,total_msg_count_old,num_segs_diff,num_segs_distinct_diff,sum_seg_length_h_diff,sum_seg_day_length_h_diff,num_segs_with_idents_diff,min_num_idents_diff,max_num_idents_diff,avg_num_idents_diff,total_msg_count_diff,avg_seg_length_h_new,avg_seg_length_h_old,avg_seg_length_h_diff,prop_segs_with_idents_new,prop_segs_with_idents_old,prop_segs_with_idents_diff
0,2017-01-01,2017,166801,166801,209688399.08333325,2592368.4000000004,129882,0,99,0.8380405393253035,24494883,1292482385,167253,167253,317620,484873,208426630.49999723,2587648.716666665,130512,0,99,0.29189499105951233,1352495062,-452,-452,1261768.5833360255,4719.683333335444,-630,0,0,0.5461455482657912,-1328000179,1257.1171580705945,1246.1757367580685,10.941421312526018,0.7786643964964238,0.7803268102814299,-630
1,2017-01-02,2017,170414,170414,210429930.9999999,2557511.933333334,132682,0,103,0.831580738671706,23725939,1306982472,170943,170943,317755,488698,209134618.43332946,2553482.2333333404,133208,0,103,0.292434182255702,1363575659,-529,-529,1295312.5666704476,4029.699999993667,-526,0,0,0.5391465564160041,-1339849720,1234.815983428591,1223.4172702791543,11.398713149436617,0.7785862663865645,0.7792539033478996,-526
2,2017-01-03,2017,176294,176294,211325868.61666656,2696579.9666666677,137459,0,107,0.8412084359081995,26067465,1322633323,176875,176875,321866,498741,210029060.78333008,2691730.549999917,138153,0,109,0.3019362755418147,1374915730,-581,-581,1296807.8333364725,4849.416666750796,-694,0,-2,0.5392721603663848,-1348848265,1198.7127674036924,1187.4434531919721,11.269314211720257,0.7797145677107559,0.7810770318021202,-694
3,2017-01-04,2017,179639,179639,211888505.88333282,2715950.0166666633,139372,0,89,0.8338000100200966,26621557,1336642027,180504,180504,322644,503148,210649979.33332986,2710607.8166665803,140112,0,89,0.30204035393164524,1388942326,-865,-865,1238526.5500029624,5342.200000083074,-740,0,0,0.5317596560884514,-1362320769,1179.523966863169,1167.0100348653207,12.513931997848431,0.7758448889161039,0.7762265656162745,-740
4,2017-01-05,2017,176772,176772,212158545.8833334,2685404.7,137501,0,90,0.8378872219582292,26830896,1349670668,177420,177420,329498,506918,210949608.96666276,2680530.449999945,138160,0,90,0.29681329130155,1403676414,-648,-648,1208936.9166706502,4874.250000055414,-659,0,0,0.5410739306566792,-1376845518,1200.1818494067693,1188.9843815052575,11.1974679015118,0.7778437761636459,0.7787171683012062,-659
5,2017-01-06,2017,173661,173661,212296678.5,2677392.299999996,134804,0,119,0.8353285999735116,26822129,1361307163,174557,174557,336392,510949,211098461.46666312,2672430.0499999058,135726,0,119,0.28909538916800454,1418982352,-896,-896,1198217.0333368778,4962.250000090338,-922,0,0,0.546233210805507,-1392160223,1222.4775770034723,1209.3382761313676,13.13930087210474,0.7762479773812198,0.7775454436086779,-922
6,2017-01-07,2017,169599,169599,212409092.40000007,2635892.4000000022,132300,0,67,0.8375815895140887,26627361,1372456437,170157,170157,343472,513629,211211601.4666624,2631171.5333332783,133045,0,67,0.2808895136372735,1433001527,-558,-558,1197490.9333376586,4720.866666723974,-745,0,0,0.5566920758768152,-1406374166,1252.4194859639506,1241.2748312832407,11.144654680709891,0.7800753542178904,0.7818955435274482,-745
7,2017-01-08,2017,165816,165816,212740911.5499997,2591348.950000002,129518,0,88,0.8376513726057807,26032704,1383956207,166429,166429,350511,516940,211526651.36666256,2587019.7666665968,130266,0,90,0.2727647309165454,1446240639,-613,-613,1214260.183337152,4329.1833334052935,-748,0,-2,0.5648866416892353,-1420207935,1282.9938700125424,1270.9723147207671,12.021555291775258,0.7810947073865007,0.7827121475223668,-748
8,2017-01-09,2017,172137,172137,213274756.9666667,2625863.6666666674,133601,0,88,0.8306697572282553,25894891,1396593580,172733,172733,355437,528170,212074490.79999572,2621190.316666622,134318,0,88,0.27483196698032064,1459791810,-596,-596,1200266.166670978,4673.350000045262,-717,0,0,0.5558377902479347,-1433896919,1238.9826531580468,1227.7589736761113,11.223679481935505,0.7761318019949226,0.7776047425795881,-717
9,2017-01-10,2017,174783,174783,213558031.55000004,2644076.533333332,134145,0,105,0.820400153332991,26035659,1406174338,175421,175421,356867,532288,212346326.24999368,2639198.733333312,134964,0,105,0.2734722556210203,1468205279,-638,-638,1211705.3000063598,4877.800000019837,-819,0,0,0.5469278977119707,-1442169620,1221.84669876361,1210.4954723208377,11.351226442772258,0.767494550385335,0.7693719680083912,-819
10,2017-01-11,2017,173809,173809,214014591.01666692,2669386.2000000016,133817,0,107,0.8243128951895469,26427621,1416783420,174121,174121,360372,534493,212795642.18332928,2664469.81666658,134498,0,108,0.27238149049660326,1478458631,-312,-312,1218948.8333376348,4916.383333421778,-681,0,-1,0.5519314046929436,-1452031010,1231.320535856411,1222.1136002166843,9.20693563972668,0.769908347668993,0.7724398550433319,-681
11,2017-01-12,2017,174991,174991,214743777.8500002,2685149.6499999994,134942,0,80,0.8286483304855675,27084988,1429790448,175417,175417,363807,539224,213511694.83333007,2679502.66666661,135669,0,82,0.2727141225168076,1490572496,-426,-426,1232083.0166701376,5646.983333389275,-727,0,-2,0.5559342079687599,-1463487508,1227.1704136212732,1217.1664937453613,10.003919875911834,0.7711368013212108,0.7734085065871609,-727
12,2017-01-13,2017,169424,169424,215098228.73333335,2628192.15,130251,0,83,0.8194470677117769,26751325,1441169519,169643,169643,370802,540445,213912882.19999352,2623247.4333332833,130738,0,83,0.25976926421744395,1503214170,-219,-219,1185346.5333398283,4944.716666716617,-487,0,0,0.5596778034943329,-1476462845,1269.5853523310354,1260.9590858449421,8.6262664860933,0.7687871848144301,0.770665456281721,-487
13,2017-01-14,2017,165063,165063,215060303.3833332,2575966.433333333,125653,0,95,0.8118173061194812,26054675,1449579093,165319,165319,379269,544588,213878747.4833301,2571237.0333332717,126203,0,96,0.248900085936526,1514790395,-256,-256,1181555.9000031054,4729.400000061374,-550,0,-1,0.5629172201829552,-1488735720,1302.8983078178223,1293.733614910144,9.164692907678273,0.7612426770384642,0.7633907778295296,-550
14,2017-01-15,2017,165828,165828,215303506.56666642,2560756.066666665,126070,0,120,0.8156644233784414,25511306,1458178561,165917,165917,385092,551009,214134374.0499956,2555816.8166666217,126540,0,120,0.24825728799348315,1526936778,-89,-89,1169132.516670823,4939.2500000433065,-470,0,0,0.5674071353849582,-1501425472,1298.3543585321322,1290.6114144421342,7.742944089997991,0.7602455556359602,0.7626704918724423,-470
15,2017-01-16,2017,170492,170492,215980837.21666682,2621464.9166666684,130559,0,61,0.8186777092180283,26278457,1470603925,170856,170856,389152,560008,214810998.48332825,2616571.0999999563,131211,0,61,0.25259103441379094,1539618813,-364,-364,1169838.7333385646,4893.816666712053,-652,0,0,0.5660866748042374,-1513340356,1266.8092181255824,1257.2634176343133,9.54580049126912,0.7657778664101541,0.7679624947324062,-652
16,2017-01-17,2017,174415,174415,216372561.60000002,2663056.6666666684,133449,0,68,0.8167187455207414,27189499,1480791639,174753,174753,389457,564210,215188895.94999638,2657957.4999999655,134157,0,68,0.2559614327998444,1548682309,-338,-338,1183665.6500036418,5099.166666702833,-708,0,0,0.560757312720897,-1521492810,1240.5616581142679,1231.3888514073944,9.172806706873416,0.7651234125505261,0.7676949751935589,-708
17,2017-01-18,2017,173933,173933,216803999.13333353,2655053.8166666715,133340,0,55,0.8217072090977552,27099564,1491680546,174241,174241,393072,567313,215623619.53332794,2649752.233333261,133898,0,56,0.254882225508665,1560246504,-308,-308,1180379.6000055969,5301.583333410323,-558,0,-1,0.5668249835890902,-1533146940,1246.4799614410924,1237.5021925570213,8.97776888407111,0.7666170306957276,0.7684643683174454,-558
18,2017-01-19,2017,172032,172032,217165811.98333317,2607701.200000003,130781,0,77,0.8136102585565474,26354044,1501959196,172244,172244,399099,571343,215990267.08332708,2602217.6666666204,131233,0,78,0.24743280306225945,1571450167,-212,-212,1175544.9000060856,5483.533333382569,-452,0,-1,0.566177455494288,-1545096123,1262.3570730057963,1253.978467077675,8.37860592812126,0.7602132161458334,0.7619017208146582,-452
19,2017-01-20,2017,160527,160527,217106230.68333352,2538145.7166666696,120521,0,58,0.7902471235368497,25586441,1509118048,160906,160906,408935,569841,215924045.01666197,2533668.6166666173,120967,0,59,0.22468021781513825,1581626413,-379,-379,1182185.6666715443,4477.100000052247,-446,0,-1,0.5655669057217114,-1556039972,1352.4592790205604,1341.926621857867,10.53265716269334,0.7507833573168377,0.751786757485737,-446
20,2017-01-21,2017,154714,154714,216771548.41666678,2487731.883333334,117082,0,64,0.7985508745168515,24931948,1514426482,154941,154941,417193,572134,215606112.03332976,2484064.4333332684,117449,0,64,0.21771123547980428,1592655527,-227,-227,1165436.3833370209,3667.450000065379,-367,0,0,0.5808396390370472,-1567723579,1401.1113953272927,1391.536856179641,9.574539147651649,0.7567640937471722,0.7580240220471018,-367
21,2017-01-22,2017,151333,151333,216835143.56666663,2447727.0666666706,115104,0,101,0.802766085387853,24754059,1521522785,151657,151657,423020,574677,215684640.73333022,2444263.1999999373,115502,0,101,0.2130988363898285,1603748665,-324,-324,1150502.833336413,3463.8666667332873,-398,0,0,0.5896672489980245,-1578994606,1432.8345011773151,1422.1871772046804,10.647323972634695,0.7606007942748773,0.7616001899022136,-398
22,2017-01-23,2017,150219,150219,216896024.51666656,2461246.6833333313,114676,0,117,0.8031340908939626,24623037,1529183079,150689,150689,428242,578931,215766017.76666266,2458112.2166666333,115074,0,117,0.20999566442288037,1614288435,-470,-470,1130006.750003904,3134.46666669799,-398,0,0,0.5931384264710822,-1589665398,1443.8654532160815,1431.8630939661332,12.002359249948313,0.7633921141799639,0.7636522904790661,-398
23,2017-01-24,2017,148452,148452,216907621.49999994,2445759.466666668,113766,0,74,0.8034718292781522,24230244,1534403364,148991,148991,430157,579148,215746535.4999975,2442189.3999999515,114180,0,76,0.20765158474172962,1621121650,-539,-539,1161086.0000024438,3570.0666667167097,-414,0,-2,0.5958202445364226,-1596891406,1461.1296681755714,1448.0507916585398,13.078876517031631,0.7663487187777868,0.7663550147324335,-414
24,2017-01-25,2017,144065,144065,217024347.04999986,2391731.9166666665,111815,0,117,0.8150973518897724,24196212,1541190818,144487,144487,435042,579529,215849460.56666267,2388758.9833332757,112143,0,117,0.20411230499250463,1630594999,-422,-422,1174886.4833371937,2972.933333390858,-328,0,0,0.6109850468972677,-1606398787,1506.433533821538,1493.9022927091203,12.531241112417774,0.7761427133585534,0.776145950846789,-328
25,2017-01-26,2017,141155,141155,216828913.81666678,2314583.46666667,107384,0,80,0.7975913003435933,23529691,1546438249,141506,141506,441821,583327,215666492.04999632,2311327.866666613,107689,0,81,0.19449296878079975,1641236065,-351,-351,1162421.7666704655,3255.600000056904,-305,0,-1,0.6030983315627936,-1617706374,1536.1050888503191,1524.0801948327019,12.024894017617271,0.7607523644220892,0.7610207341031475,-305
26,2017-01-27,2017,132475,132475,216179059.0999999,2255524.400000001,103358,0,64,0.8176108699754682,23576061,1549501008,132693,132693,450020,582713,215057955.91666448,2252933.6333332867,103502,0,64,0.18667680316038862,1652275369,-218,-218,1121103.1833354235,2590.766666714102,-144,0,0,0.6309340668150796,-1628699308,1631.847964521607,1620.7181683786218,11.129796142985242,0.7802075863370447,0.7800110028411446,-144
27,2017-01-28,2017,133535,133535,215911273.0166665,2255904.649999997,102621,0,31,0.8104916314074968,24019771,1556033790,133736,133736,456237,589973,214824968.5666633,2252970.4499999667,102748,0,31,0.18403893059513107,1663769615,-201,-201,1086304.4500032067,2934.2000000304542,-127,0,0,0.6264527008123657,-1639749844,1616.8890030079492,1606.336129139972,10.552873867977269,0.7684951510839855,0.7682897649099719,-127
28,2017-01-29,2017,139404,139404,216412478.98333305,2267117.1333333333,105674,0,66,0.8022797050299841,24239221,1566536427,139614,139614,458759,598373,215312848.68333092,2264426.1333332565,105844,0,67,0.18778755057464583,1674926904,-210,-210,1099630.300002128,2691.000000076834,-170,0,-1,0.6144921544553383,-1650687683,1552.4122620823869,1542.2009876039,10.211274478486757,0.7580413761441566,0.7581188132995258,-170
29,2017-01-30,2017,138798,138798,217003484.51666677,2308767.2166666663,107689,0,70,0.8150765861179545,24270524,1577632494,139104,139104,464943,604047,215900019.2833311,2306005.066666648,107883,0,71,0.18814926653058855,1676033523,-306,-306,1103465.2333356738,2762.1500000185333,-194,0,-1,0.6269273195873659,-1651762999,1563.4482090279887,1552.07628309273,11.371925935258787,0.775868528364962,0.7755564182194618,-194
30,2017-01-31,2017,142450,142450,217328670.08333316,2346600.766666666,110954,0,82,0.8229764829764823,24095038,1585438066,142815,142815,463022,605837,216167072.30000025,2343918.8999999547,111224,0,82,0.19469428245550716,1680666748,-365,-365,1161597.783332914,2681.866666711401,-270,0,0,0.6282822005209752,-1656571710,1525.6487896337885,1513.6160228267356,12.032766807052894,0.7788978588978589,0.7787977453348738,-270
31,2017-02-01,2017,143840,143840,217945563.716667,2362574.133333333,112466,0,78,0.830791156840935,23932339,1595056668,144226,144226,223776,368002,216761552.89999902,2358964.6666664705,112840,0,80,0.32743300308151246,1669637133,-386,-386,1184010.816667974,3609.4666668623686,-374,0,-2,0.5033581537594225,-1645704794,1515.1944084862832,1502.9297969852803,12.264611501002946,0.7818826473859845,0.7823832041379502,-374
32,2017-02-02,2017,150676,150676,218536311.63333347,2404289.616666663,116182,0,87,0.8223539249780984,24494106,1605267016,151067,151067,229667,380734,217358539.96666247,2401066.5166666135,116462,0,87,0.32739918158084547,1677931826,-391,-391,1177771.6666710079,3223.1000000494532,-280,0,0,0.494954743397253,-1653437720,1450.372399276152,1438.8221118223203,11.550287453831743,0.7710717035227906,0.7709294551424203,-280
33,2017-02-03,2017,150832,150832,218992090.4666671,2407529.400000001,116789,0,62,0.8221531240055163,24359829,1614413611,151123,151123,234311,385434,217795805.39999682,2404078.8833332937,117040,0,62,0.32397245702247474,1685200885,-291,-291,1196285.0666702688,3450.516666707117,-251,0,0,0.4981806669830416,-1660841056,1451.8940971853922,1441.1823838859525,10.71171329943968,0.7742985573353135,0.7744684793181713,-251
34,2017-02-04,2017,152889,152889,219065606.26666683,2416824.9999999995,118206,0,59,0.8286534675483509,24452453,1621082717,153315,153315,241577,394892,217869359.44999695,2413079.7166666146,118632,0,60,0.3238910892092028,1692721730,-426,-426,1196246.8166698813,3745.2833333848976,-426,0,-1,0.5047623783391482,-1668269277,1432.8408601447247,1421.057035841222,11.783824303502797,0.7731491474206778,0.7737794736327169,-426
35,2017-02-05,2017,149666,149666,218987782.56666672,2392874.116666667,116268,0,58,0.8293333155158831,24224471,1626513832,149831,149831,248946,398777,217775578.46666285,2389319.0833332986,116588,0,58,0.3136991351055836,1699304451,-165,-165,1212204.1000038683,3555.0333333685994,-320,0,0,0.5156341804102995,-1675079980,1463.176556911167,1453.4747713534773,9.701785557689618,0.7768497855224299,0.7781300264965194,-320
36,2017-02-06,2017,153688,153688,219554053.1499997,2449578.0999999978,120167,0,48,0.8354718650772991,24607879,1636483450,154172,154172,254666,408838,218337015.0666666,2445463.4166664537,120606,0,49,0.31661440472754837,1705414758,-484,-484,1217038.0833331048,4114.683333544061,-439,0,-1,0.5188574603497507,-1680806879,1428.569915347976,1416.1911051725774,12.378810175398485,0.7818892821820832,0.7822821264561658,-439
37,2017-02-07,2017,155418,155418,220058337.61666682,2427255.0666666664,122068,0,59,0.8394716184740499,24364974,1644790676,155669,155669,256003,411672,218829633.3833331,2423645.783333136,122385,0,59,0.31895538195456397,1709212349,-251,-251,1228704.2333337367,3609.2833335306495,-317,0,0,0.520516236519486,-1684847375,1415.9128132949004,1405.736745166559,10.176068128341285,0.7854173905210464,0.7861873590759881,-317
38,2017-02-08,2017,163747,163747,220735637.73333344,2511271.7833333313,127870,0,70,0.8370718242166274,24579773,1653563613,164131,164131,260825,424956,219502883.8166634,2507263.7333332626,128224,0,70,0.32554899801391285,1716771037,-384,-384,1232753.9166700244,4008.0500000687316,-354,0,0,0.5115228262027145,-1692191264,1348.0285912617235,1337.363958159418,10.664633102305515,0.7808998027444778,0.7812296275536005,-354
39,2017-02-09,2017,153794,153794,220968451.86666664,2498056.183333329,121402,0,58,0.8440186223129649,25099648,1660118106,154242,154242,268158,422400,219740109.0166669,2494511.166666433,121793,0,59,0.3100781249999957,1723856111,-448,-448,1228342.8499997556,3545.01666689571,-391,0,-1,0.5339404973129691,-1698756463,1436.7820062334463,1424.6450967743344,12.136909459111848,0.7893806000234079,0.7896228005342254,-391
40,2017-02-10,2017,155476,155476,221283294.1833331,2500084.3,121866,0,59,0.8380843345596753,24954676,1667459564,155872,155872,275126,430998,220049717.09999782,2496482.6333331103,122222,0,61,0.30469978979020607,1731203157,-396,-396,1233577.0833352804,3601.666666889563,-356,0,-2,0.5333845447694693,-1706248481,1423.2633601541916,1411.7334550143569,11.529905139834682,0.783825156294219,0.7841177376308767,-356
41,2017-02-11,2017,160668,160668,221474997.01666638,2513371.516666665,126048,0,50,0.8395946921602309,24920467,1673958954,161078,161078,280772,441850,220248882.13333356,2510241.7333330754,126466,0,50,0.30771302478216145,1738341440,-410,-410,1226114.8833328187,3129.7833335897885,-418,0,0,0.5318816673780694,-1713420973,1378.4636456336443,1367.3430396040028,11.120606029641522,0.7845246097542758,0.7851227355691032,-418
42,2017-02-12,2017,166033,166033,221433354.2166668,2567318.1833333336,128720,0,54,0.8320936199430232,25248922,1678478926,166432,166432,287036,453468,220174271.8666622,2563333.4833333082,129239,0,55,0.30798424585637546,1744815011,-399,-399,1259082.3500045836,3984.700000025332,-519,0,-1,0.5241093740866478,-1719566089,1333.670741459028,1322.9082860667552,10.762455392272841,0.7752675672908398,0.7765273505095174,-519
43,2017-02-13,2017,167331,167331,222031709.91666645,2618719.6666666707,129695,0,64,0.8354518887713576,26035421,1689029102,167918,167918,290722,458640,220742586.9333294,2614557.933333287,130315,0,64,0.3088326356183571,1752829540,-587,-587,1289122.9833370447,4161.733333383687,-620,0,0,0.5266192531530005,-1726794119,1326.9012311924655,1314.5856128189318,12.315618373533653,0.7750805290113607,0.7760633166188259,-620
44,2017-02-14,2017,171027,171027,222678807.7666668,2645436.4499999993,132668,0,81,0.8364351827489229,25256805,1697620172,171409,171409,294073,465482,221394649.86666554,2641300.0999999125,133105,0,81,0.31019459399074556,1759605128,-382,-382,1284157.9000012577,4136.350000086706,-437,0,0,0.5262405887581774,-1734348323,1302.0096696233156,1291.6162504108042,10.39341921251139,0.7757137761873856,0.7765344876873443,-437
45,2017-02-15,2017,174478,174478,223268387.9333334,2684538.133333329,135443,0,86,0.8406274716583182,25964794,1706922615,175118,175118,300186,475304,221967717.3333333,2680245.533333102,136086,0,88,0.31301440762122223,1767839357,-640,-640,1300670.6000000834,4292.600000227336,-643,0,-2,0.527613064037096,-1741874563,1279.6363319921904,1267.5322772835077,12.104054708682725,0.7762755189766045,0.7771102913464064,-643
46,2017-02-16,2017,173877,173877,223804885.25000027,2609316.049999999,135122,0,57,0.8338825721630806,24239995,1714414025,174334,174334,307288,481622,222518851.316667,2603734.0666665505,135562,0,57,0.30369667498578545,1776436038,-457,-457,1286033.9333332777,5581.983333448414,-440,0,0,0.5301858971772951,-1752196043,1287.1448509578627,1276.393883675399,10.750967282463762,0.7771125565773507,0.7775993208438974,-440
47,2017-02-17,2017,175801,175801,224471896.2166669,2681276.2500000033,137066,0,59,0.8402113753619146,25350471,1722535056,176242,176242,316346,492588,223181857.36666602,2676039.549999941,137598,0,59,0.3031986162878502,1786284096,-441,-441,1290038.850000888,5236.700000062119,-532,0,0,0.5370127590740643,-1760933625,1276.8522148148584,1266.3375209465735,10.514693868284894,0.7796656446777891,0.7807333098807322,-532
48,2017-02-18,2017,171962,171962,224633909.16666654,2654375.8499999978,133247,0,60,0.8379467556785807,25062900,1728574128,172301,172301,325366,497667,223315620.31666374,2649026.849999905,133751,0,61,0.29291875892916586,1793164691,-339,-339,1318288.8500027955,5349.000000092667,-504,0,-1,0.5450279967494148,-1768101791,1306.2997009029118,1296.078492386369,10.221208516542902,0.7748630511392052,0.7762636316678371,-504
49,2017-02-19,2017,170315,170315,224812949.23333326,2625187.049999995,131969,0,137,0.8326806212018902,24737952,1734553655,170454,170454,334180,504634,223489498.98333192,2620350.716666501,132261,0,137,0.28359959891723363,1803355019,-139,-139,1323450.250001341,4836.333333494142,-292,0,0,0.5490810222846566,-1778617067,1319.9832617992147,1311.1425896918342,8.840672107380442,0.7748524792296627,0.7759336829877855,-292
50,2017-02-20,2017,171242,171242,225283787.63333347,2624643.2333333306,132376,0,119,0.8286752081849077,24543670,1741868108,171422,171422,342419,513841,223969077.9499943,2619651.3999999417,132709,0,118,0.27894426486014146,1811688155,-180,-180,1314709.6833391786,4991.833333388902,-333,0,1,0.5497309433247662,-1787144485,1315.5872252913039,1306.5363719358909,9.050853355412983,0.7730346527137034,0.774165509677871,-333
51,2017-02-21,2017,172239,172239,225839250.91666663,2663990.0499999993,133570,0,68,0.834973496130377,25059877,1750092896,172695,172695,347156,519851,224545191.33333045,2659433.5166665,134075,0,68,0.28002254492152584,1816507965,-456,-456,1294059.5833361745,4556.53333349945,-505,0,0,0.5549509512088511,-1791448088,1311.1969467813133,1300.241415983847,10.955530797466281,0.7754921939862632,0.7763687425808506,-505
52,2017-02-22,2017,172158,172158,226471573.55000037,2684267.883333334,134575,0,97,0.8430976196284818,24945732,1757908620,172509,172509,352499,525008,225180860.86666423,2678952.6999999885,135036,0,97,0.2798547831652091,1823819072,-351,-351,1290712.6833361387,5315.183333345223,-461,0,0,0.5632428364632727,-1798873340,1315.486782780936,1305.328190799693,10.158591981243035,0.7816947222899894,0.7827765507886545,-461
53,2017-02-23,2017,173941,173941,227016322.33333316,2696761.8833333333,136660,0,98,0.8447749524263973,25037058,1765520757,174352,174352,360077,534429,225716453.1166647,2692080.1833331482,137090,0,98,0.27797144241798044,1831148022,-411,-411,1299869.2166684568,4681.700000185054,-430,0,0,0.5668035100084169,-1806110964,1305.134053117627,1294.602029897361,10.532023220265955,0.7856687037558713,0.7862829219051115,-430
54,2017-02-24,2017,177223,177223,227595638.0833333,2724978.166666668,138891,0,85,0.8439931611585406,25322778,1773478613,177781,177781,365012,542793,226282281.2166649,2718328.3666665712,139463,0,86,0.279086134124795,1838812300,-558,-558,1313356.8666684031,6649.800000096671,-572,0,-1,0.5649070270337456,-1813489522,1284.2330740554742,1272.8147620761774,11.418311979296732,0.78370753231804,0.7844651565690371,-572
55,2017-02-25,2017,169938,169938,228034182.60000035,2708065.8666666644,133626,0,88,0.8430839482634841,25106262,1780882916,170396,170396,373724,544120,226727642.1666646,2703565.699999982,134224,0,89,0.2667260898331235,1846601567,-458,-458,1306540.4333357513,4500.166666682344,-598,0,-1,0.5763578584303606,-1821495305,1341.866931469126,1330.5925148868787,11.27441658224734,0.7863220704021466,0.7877180215498016,-598
56,2017-02-26,2017,171182,171182,228423245.71666655,2707239.800000003,133597,0,90,0.8394924700026876,25199475,1788045580,171579,171579,379883,551462,227107250.76666299,2702663.5166666247,134194,0,91,0.2636537059670445,1856432492,-397,-397,1315994.9500035644,4576.283333378378,-597,0,-1,0.575838764035643,-1831233017,1334.3882284157596,1323.630810103002,10.757418312757636,0.7804383638466661,0.7821120300269847,-597
57,2017-02-27,2017,179201,179201,229306039.433333,2789602.9666666673,140390,0,76,0.8451905960346203,25578474,1798653485,179912,179912,383943,563855,227983696.59999904,2784111.299999849,141169,0,76,0.27230582330563663,1866947519,-711,-711,1322342.833333969,5491.666666818317,-779,0,0,0.5728847727289836,-1841369045,1279.602454413385,1267.195610076032,12.40684433735305,0.783421967511342,0.7846558317399618,-779
58,2017-02-28,2017,181572,181572,229928906.24999997,2788640.683333337,141450,0,91,0.8405095499306056,25115045,1806270094,182110,182110,387245,569355,228581298.88333184,2782497.6999998423,142024,0,92,0.2712753905735421,1872999010,-538,-538,1347607.366668135,6142.983333494514,-574,0,-1,0.5692341593570635,-1847883965,1266.323586511136,1255.1825758241273,11.141010687008702,0.7790298063578085,0.7798802921311295,-574
59,2017-03-01,2017,179873,179873,230456019.51666623,2763388.899999997,141036,0,102,0.8480483452213514,25461837,1813540140,179941,179941,218536,398477,229104337.43333292,2758010.8666664865,141427,0,103,0.38714907008435545,1867084366,-68,-68,1351682.0833333135,5378.033333510626,-391,0,-1,0.46089927513699597,-1841622529,1281.215188030812,1273.219207592116,7.995980438696051,0.7840865499546903,0.7859631768190685,-391
60,2017-03-02,2017,180861,180861,230606408.63333315,2773520.81666667,141711,0,65,0.8496635537788684,25641650,1819115157,181605,181605,230650,412255,229306620.44999868,2769606.6333331796,142343,0,65,0.3776085189991643,1876272177,-744,-744,1299788.1833344698,3914.1833334905095,-632,0,0,0.47205503477970406,-1850630527,1275.0477362910365,1262.6668894028176,12.380846888218912,0.7835354222303316,0.7838055119627764,-632
61,2017-03-03,2017,186116,186116,231267683.76666653,2826406.516666668,146105,0,41,0.8517644909626259,25737456,1827516173,186977,186977,236442,423419,229969570.73333198,2821879.3999998067,146942,0,34,0.3798837558069002,1884062657,-861,-861,1298113.0333345532,4527.116666861344,-837,0,7,0.47188073515572565,-1858325201,1242.5996892618932,1229.9350761501787,12.664613111714516,0.7850211695931569,0.7858827556330458,-837
62,2017-03-04,2017,178549,178549,231650176.21666723,2804417.8000000003,139690,0,52,0.8472856190737558,25297646,1832775854,179334,179334,247027,426361,230350028.48333174,2800091.249999957,140513,0,52,0.3608350669972173,1892814977,-785,-785,1300147.733335495,4326.55000004312,-823,0,0,0.4864505520765385,-1867517331,1297.4039407482944,1284.4749377325645,12.929003015729904,0.7823622647004463,0.7835268270378177,-823
63,2017-03-05,2017,178632,178632,232028835.58333346,2745480.8333333344,140403,0,73,0.8512416588293251,25022227,1839666327,179467,179467,256440,435907,230720406.98333007,2740656.733333259,141288,0,73,0.3548050386894486,1902741696,-835,-835,1308428.6000033915,4824.10000007553,-885,0,0,0.4964366201398765,-1877719469,1298.9208853023729,1285.586804166393,13.334081135979886,0.7859901921268306,0.7872645110243108,-885
64,2017-03-06,2017,177092,177092,232295581.28333327,2701865.8166666664,138355,0,52,0.8422910125810316,24669294,1845355145,177925,177925,267848,445773,230987816.66666818,2697509.3333331565,139217,0,52,0.3404670089933668,1911920388,-833,-833,1307764.616665095,4356.483333509881,-862,0,0,0.5018240035876648,-1887251094,1311.7226147049741,1298.2313708959853,13.491243808988884,0.7812605877171188,0.7824476605311227,-862
65,2017-03-07,2017,180003,180003,232453921.6666663,2731600.7166666663,138954,0,39,0.831208368749409,23184022,1847986435,180642,180642,274991,455633,231100852.53332913,2727229.500000012,139572,0,34,0.3322849749688893,1912969459,-639,-639,1353069.13333717,4371.216666654218,-618,0,5,0.49892339378051964,-1889785437,1291.3891527733776,1279.3306790963848,12.05847367699289,0.7719538007699872,0.7726442355598366,-618
66,2017-03-08,2017,177666,177666,232181019.68333322,2738673.016666665,138236,0,45,0.82571792014229,14021701,1837263586,178110,178110,283743,461853,230897551.83332846,2734954.349999993,138584,0,32,0.31991780934627057,1908123210,-444,-444,1283467.8500047624,3718.6666666720994,-348,0,13,0.5058001107960194,-1894101509,1306.8399113129874,1296.37612617668,10.463785136307479,0.7780667094435626,0.7780809612037505,-348
67,2017-03-09,2017,181594,181594,232192639.85000026,2783482.8333333395,141884,0,35,0.8301155324515126,13901055,1831325814,182022,182022,289961,471983,230910572.7499912,2779267.900000052,142240,0,43,0.3215115798662259,1902743407,-428,-428,1282067.100009054,4214.933333287481,-356,0,-8,0.5086039525852867,-1888842352,1278.6360774585078,1268.5860651459232,10.050012312584613,0.7813253741863718,0.7814440012745713,-356
68,2017-03-10,2017,182306,182306,232526460.38333356,2777152.9666666626,143556,0,43,0.8356225247660525,14110106,1827883222,182730,182730,297008,479738,231245499.81666285,2773031.316666708,144005,0,39,0.3200830453289051,1897059149,-424,-424,1280960.5666707158,4121.649999954738,-449,0,4,0.5155394794371474,-1882949043,1275.473436877193,1265.5037476969455,9.969689180247542,0.7874452843022172,0.7880753023586713,-449
69,2017-03-11,2017,179634,179634,232558965.78333312,2746872.650000004,140509,0,44,0.8285402540721702,14081656,1823770350,179913,179913,308173,488086,231281761.51666197,2743298.366666721,140845,0,44,0.30723069295165384,1893201673,-279,-279,1277204.266671151,3574.2833332829177,-336,0,0,0.5213095611205164,-1879120017,1294.6266618977093,1285.5200097639524,9.106652133756825,0.7821960207978446,0.7828506000122282,-336
70,2017-03-12,2017,175935,175935,232609259.61666664,2667060.4666666645,138273,0,51,0.8302157046636542,13595348,1819322851,176279,176279,318574,494853,231320359.55000588,2663238.5499998974,138607,0,51,0.29723978636079856,1890920716,-344,-344,1288900.0666607618,3821.9166667670943,-334,0,0,0.5329759183028557,-1877325368,1322.1318078646468,1312.2400260383022,9.89178182634464,0.785932304544292,0.7862933191134508,-334
71,2017-03-13,2017,175563,175563,232497744.75000024,2685513.4833333404,138129,0,41,0.8330684711471096,13771733,1814912761,175932,175932,328916,504848,231185621.36666203,2682043.183333358,138428,0,41,0.29120646214305773,1888231447,-369,-369,1312123.383338213,3470.2999999825843,-299,0,0,0.5418620090040518,-1874459714,1324.2980853027132,1314.0623727727873,10.235712529925877,0.7867773961483912,0.786826728508742,-299
72,2017-03-14,2017,178563,178563,232730217.7999999,2749789.516666669,140090,0,45,0.8286151106332214,14152749,1812005348,179012,179012,333933,512945,231410238.71666062,2745988.6333333454,140425,0,45,0.2903332715983161,1880776336,-449,-449,1319979.083339274,3800.8833333235234,-335,0,0,0.5382818390349052,-1866623587,1303.3507378348252,1292.7079677153522,10.64277011947297,0.7845410303366319,0.7844446182378835,-335
73,2017-03-15,2017,185754,185754,233107729.13333336,2798216.8166666683,144842,0,43,0.8333441002616359,16975195,1811931633,186307,186307,338908,525215,231780773.73333108,2793945.583333288,145383,0,39,0.2974667517112012,1879346037,-553,-553,1326955.400002271,4271.233333380427,-541,0,4,0.5358773485504347,-1862370842,1254.9271032297197,1244.0797915984429,10.847311631276852,0.7797517146333323,0.7803410499873864,-541
74,2017-03-16,2017,196505,196505,233877358.3666665,2908259.5833333307,152661,0,51,0.8484720490572758,25609064,1822278549,197746,197746,342513,540259,232540193.71666545,2903252.8166665686,153910,0,51,0.3159577165766737,1883294026,-1241,-1241,1337164.650001049,5006.766666762065,-1249,0,0,0.5325143324806021,-1857684962,1190.1852795942418,1175.9539698232352,14.231309771006636,0.7768809953945193,0.7783216853943948,-1249
75,2017-03-17,2017,193660,193660,234414534.48333362,2907828.916666668,151927,0,48,0.8618041929154184,25715040,1830898900,194963,194963,354467,549430,233091984.13332993,2902741.316666565,153211,0,39,0.3105054329031886,1892783607,-1303,-1303,1322550.3500036895,5087.600000103004,-1284,0,9,0.5512987600122299,-1867068567,1210.443738941101,1195.570360187984,14.873378753116867,0.7845037694929258,0.7858465452419177,-1284
76,2017-03-18,2017,188929,188929,234639008.36666647,2904784.8000000026,147783,0,81,0.8553213111803896,25721327,1837155023,190216,190216,365585,555801,233267921.88332993,2899585.549999858,149086,0,81,0.2979069846941602,1903554496,-1287,-1287,1371086.483336538,5199.250000144821,-1303,0,0,0.5574143264862294,-1877833169,1241.9427846792523,1226.3317590703723,15.611025608880027,0.7822144826892642,0.7837721327333137,-1303
77,2017-03-19,2017,188204,188204,234938349.00000006,2854585.633333334,146619,0,110,0.8470702004208204,25382234,1843347816,189337,189337,375014,564351,233548632.21666437,2849784.933333207,147762,0,111,0.2882000740673776,1913429574,-1133,-1133,1389716.7833356857,4800.700000126846,-1143,0,-1,0.5588701263534428,-1888047340,1248.3175118488452,1233.507619834815,14.80989201403031,0.7790429533910013,0.7804179848629692,-1143
78,2017-03-20,2017,187867,187867,235613166.78333306,2836736.5666666646,146232,0,128,0.8470194339612596,25332204,1853647067,188761,188761,387770,576531,234244316.89999762,2832384.866666532,147170,0,128,0.2813049081489111,1923599613,-894,-894,1368849.8833354414,4351.700000132434,-938,0,0,0.5657145258123484,-1898267409,1254.1487689872786,1240.9571728270014,13.191596160277186,0.7783804499992015,0.7796631719475952,-938
79,2017-03-21,2017,189034,189034,235889513.98333335,2857083.316666669,146644,0,101,0.8459483479162477,25322639,1859345513,190202,190202,395254,585456,234486862.2166618,2851879.7999999025,147780,0,102,0.27948129321417786,1928100048,-1168,-1168,1402651.7666715384,5203.516666766722,-1136,0,-1,0.5664670547020698,-1902777409,1247.8681823552024,1232.8306864105625,15.037495944639886,0.7757546261519092,0.7769634388702538,-1136
80,2017-03-22,2017,188720,188720,236508413.7833336,2891391.599999996,147782,0,92,0.8555055108096657,25538400,1867945569,189928,189928,401904,591832,235099530.9833309,2886173.7666665195,148944,0,92,0.2788223685099784,1937298086,-1208,-1208,1408882.8000026941,5217.833333476447,-1162,0,0,0.5766831422996874,-1911759686,1253.2238966899831,1237.8350268698186,15.388869820164473,0.7830754557015684,0.7842129649130196,-1162
81,2017-03-23,2017,191471,191471,237249212.86666635,2921827.050000002,150082,0,119,0.8525364154362794,25514203,1876650093,192638,192638,409185,601823,235824208.21666545,2917021.066666591,151144,0,119,0.27653479511417584,1945316560,-1167,-1167,1425004.6500009,4805.983333411161,-1062,0,0,0.5760016203221037,-1919802357,1239.0869263056356,1224.1832256183382,14.903700687297487,0.7838367167873986,0.7846011690320706,-1062
82,2017-03-24,2017,190733,190733,237703429.4833332,2894057.7333333394,148044,0,82,0.8413384154813274,25329204,1882970504,191831,191831,417957,609788,236278561.28332886,2889067.449999829,149121,0,82,0.26810465276457046,1954026124,-1098,-1098,1424868.2000043392,4990.283333510626,-1077,0,0,0.573233762716757,-1928696920,1246.2627310603473,1231.701660749977,14.561070310370269,0.7761845092354234,0.7773561103262768,-1077
83,2017-03-25,2017,186075,186075,237689287.6666667,2849689.916666671,144905,0,69,0.8444336960902863,24982237,1886365612,186998,186998,430813,617811,236280418.34999844,2845100.2333331723,145914,0,69,0.2592799416002659,1961952125,-923,-923,1408869.3166682422,4589.683333498891,-1009,0,0,0.5851537544900204,-1936969888,1277.384321734068,1263.5451627824814,13.839158951586569,0.778745129652022,0.7802971154771708,-1009
84,2017-03-26,2017,185361,185361,237849735.51666695,2868465.816666668,146026,0,47,0.8567336171039215,25140252,1890861504,186412,186412,439777,626189,236431657.4666603,2864055.666666637,147122,0,47,0.25855292890804926,1970890408,-1051,-1051,1418078.0500066578,4410.1500000306405,-1096,0,0,0.5981806881958722,-1945750156,1283.1703298788145,1268.328527491043,14.841802387771622,0.7877924698291442,0.7892303070617771,-1096
85,2017-03-27,2017,196541,196541,238580868.60000005,2968542.4500000016,153366,0,57,0.8500669071593211,25249449,1899451646,197790,197790,443958,641748,237122778.66666222,2963561.4166665385,154546,0,41,0.26534247087642143,1977327023,-1249,-1249,1458089.9333378375,4981.033333463129,-1180,0,16,0.5847244362828996,-1952077574,1213.8987213863777,1198.8613108178483,15.037410568529367,0.780325733561954,0.7813640730067243,-1180
86,2017-03-28,2017,193640,193640,239052155.7,2962824.95,152027,0,52,0.8509089031191909,24355756,1904614009,194723,194723,449277,644000,237563547.1333307,2957553.8833332444,153079,0,36,0.2606195652173895,1979428497,-1083,-1083,1488608.5666692853,5271.066666755825,-1052,0,16,0.5902893379018014,-1955072741,1234.518465709564,1220.0076371734756,14.510828536088411,0.7851012187564553,0.7861372308355973,-1052
87,2017-03-29,2017,194044,194044,239528541.6666668,2981662.6999999993,152886,0,57,0.8547752056234668,25511090,1910185825,195085,195085,456963,652048,238004961.5333289,2976632.08333327,153798,0,35,0.258898117929968,1986923658,-1041,-1041,1523580.133337915,5030.616666729096,-912,0,22,0.5958770876934988,-1961412568,1234.4032367229433,1220.0064665829198,14.396770140023591,0.7878934674609882,0.7883640464412949,-912
88,2017-03-30,2017,192161,192161,240017428.38333338,2889393.9500000034,150697,0,51,0.8474924672540213,23787807,1915926618,193108,193108,465456,658564,238492758.86666232,2884652.483333194,151515,0,51,0.2508321135075719,1991578149,-947,-947,1524669.5166710615,4741.466666809283,-818,0,0,0.5966603537464494,-1967790342,1249.0433978972496,1235.0226757392875,14.020722157962155,0.7842226050030964,0.7846127555564761,-818
89,2017-03-31,2017,189818,189818,239931626.4166669,2872263.2333333315,149690,0,85,0.8554562791726806,25918974,1919689263,191021,191021,479356,670377,238373350.19999525,2867598.2499999274,150882,0,85,0.24762036883723176,1997579135,-1203,-1203,1558276.2166716456,4664.983333404176,-1192,0,0,0.6078359103354489,-1971660161,1264.0088211690509,1247.890808863922,16.118012305128786,0.7885974986566079,0.7898712706979861,-1192
90,2017-04-01,2017,189829,189829,239813747.55000025,2907576.216666663,149694,0,51,0.8629450716170868,26095796,1923342489,190976,190976,248034,439010,238243280.04999653,2902455.249999854,150930,0,54,0.3811644381676947,1984377439,-1147,-1147,1570467.5000037253,5120.966666809283,-1236,0,-3,0.4817806334493921,-1958281643,1263.314601825855,1247.5037703690334,15.810831456821688,0.7885728734808696,0.7903087298927614,-1236
91,2017-04-02,2017,192195,192195,240232432.46666658,2978619.249999997,151749,0,52,0.8659226306615676,26476208,1929871993,193458,193458,253457,446915,238651219.58332878,2973827.5833332,152943,0,36,0.38055558663280625,1993581531,-1263,-1263,1581212.8833377957,4791.666666797362,-1194,0,16,0.48536704402876135,-1967105323,1249.9411143196576,1233.6073958343868,16.333718485270765,0.7895574806836806,0.7905746983841454,-1194
92,2017-04-03,2017,194715,194715,240853301.4333335,2983602.0499999993,152094,0,47,0.8517166114577722,26501491,1938873776,195845,195845,260485,456330,239305395.3666634,2979200.2333331956,153125,0,38,0.37079306642122967,2002986475,-1130,-1130,1547906.06667009,4401.816666803788,-1031,0,9,0.48092354503654255,-1976484984,1236.9529899254474,1221.9122028474733,15.040787077974073,0.7811108543255527,0.7818683142280886,-1031
93,2017-04-04,2017,193803,193803,241171236.3666669,2941171.5999999987,151229,0,59,0.844966280191741,26495340,1946285248,194986,194986,270949,465935,239593345.3333314,2936129.199999846,152329,0,36,0.35830105057572303,2007126929,-1183,-1183,1577891.033335507,5042.400000152644,-1100,0,23,0.486665229616018,-1980631589,1244.4143608028096,1228.7720417534151,15.642319049394473,0.7803233180084932,0.7812304473141661,-1100
94,2017-04-05,2017,192814,192814,241322408.4999995,2822382.266666664,150070,0,42,0.839690063999502,24568507,1949934183,193947,193947,281777,475724,239727438.74999982,2817779.449999906,151073,0,45,0.346253289722611,2014418684,-1133,-1133,1594969.7499996722,4602.816666757688,-1003,0,-3,0.493436774276891,-1989850177,1251.5813607933007,1236.0461298705306,15.535230922770097,0.7783148526559275,0.7789396072122796,-1003
95,2017-04-06,2017,191905,191905,241617670.6333333,2916632.383333334,147903,0,49,0.8302753966806488,24026168,1952845317,192969,192969,293119,486088,240011296.59999758,2911927.999999877,148957,0,49,0.3339950790803321,2019140433,-1064,-1064,1606374.0333357155,4704.3833334567025,-1054,0,0,0.49628031760031666,-1995114265,1259.0483345057883,1243.7816260642776,15.266708441510673,0.7707094656210104,0.7719219149189767,-1054
96,2017-04-07,2017,193586,193586,242028582.1166666,2937414.7666666657,149229,0,47,0.8352101908195837,24693574,1957118189,194766,194766,298096,492862,240493643.43332645,2932908.5666665686,150318,0,47,0.33381555080327124,2021105849,-1180,-1180,1534938.6833401322,4506.200000097044,-1089,0,0,0.5013946400163125,-1996412275,1250.2380446760953,1234.7824745249502,15.455570151145139,0.7708666949056233,0.7717876836819568,-1089
97,2017-04-08,2017,191341,191341,241806361.3500001,2905099.116666667,147273,0,57,0.8341285976345895,24342237,1958056196,192770,192770,309156,501926,240282392.21666265,2899858.166666558,148585,0,57,0.3250837772898793,2026362908,-1429,-1429,1523969.133337468,5240.950000109151,-1312,0,0,0.5090448203447102,-2002020671,1263.7456757830266,1246.4719210284932,17.273754754533456,0.7696886710114403,0.7707890231882555,-1312
98,2017-04-09,2017,188905,188905,241841417.41666645,2873801.1166666616,145791,0,52,0.8345676398189565,23970533,1961074674,190329,190329,320768,511097,240313401.84999776,2868707.933333311,147212,0,53,0.315491971191381,2032510373,-1424,-1424,1528015.5666686893,5093.1833333503455,-1421,0,-1,0.5190756686275755,-2008539840,1280.2277198415418,1262.6210501289754,17.606669712566372,0.7717688785368306,0.7734606917495495,-1421
99,2017-04-10,2017,187980,187980,242096180.73333308,2897855.8333333316,146753,0,40,0.8442015107990207,24041105,1965065529,189230,189230,331184,520414,240577980.01666248,2892984.449999904,147945,0,41,0.31065459422690556,2039011414,-1250,-1250,1518200.7166706026,4871.3833334278315,-1192,0,-1,0.5335469165721152,-2014970309,1287.882650991239,1271.3522169669845,16.53043402425442,0.7806841153314182,0.7818263488875971,-1192
100,2017-04-11,2017,189285,189285,242188504.90000004,2908462.4333333345,146754,0,46,0.8352325857833423,24150098,1967163460,190551,190551,337861,528412,240671620.73333013,2903327.366666632,147886,0,38,0.3048132896300663,2036437024,-1266,-1266,1516884.1666699052,5135.06666670274,-1132,0,8,0.5304192961532759,-2012286926,1279.4912692500727,1263.0299538356142,16.461315414458568,0.7753070766304778,0.7760966880257779,-1132
101,2017-04-12,2017,194102,194102,242863328.08333322,2959665.5166666643,148802,0,42,0.8279409794850123,25086232,1974563215,195404,195404,344201,539605,241341361.8499993,2954299.249999895,150023,0,35,0.30387968977307644,2041716278,-1302,-1302,1521966.2333339155,5366.26666676905,-1221,0,7,0.5240612897119359,-2016630046,1251.2149698783796,1235.0891581032083,16.125811775171314,0.7666175515965833,0.7677580806943564,-1221
102,2017-04-13,2017,200558,200558,243549932.33333337,3011064.2166666607,152988,0,33,0.8211888830163845,25424234,1981536553,201714,201714,350896,552610,241993093.6999964,3006064.449999884,154059,0,43,0.30296773493060264,2047407370,-1156,-1156,1556838.6333369613,4999.766666776966,-1071,0,-10,0.5182211480857819,-2021983136,1214.3615928226916,1199.6841751192105,14.677417703481069,0.7628117552029837,0.763749665367798,-1071
103,2017-04-14,2017,201366,201366,243980561.11666706,3016725.266666663,153699,0,35,0.8246079278527657,25277058,1986335901,202654,202654,358633,561287,242428856.99999702,3011123.166666504,154931,0,30,0.3015302331962045,2054648090,-1288,-1288,1551704.1166700423,5602.100000158884,-1232,0,5,0.5230776946565612,-2029371032,1211.627390506178,1196.26978495365,15.357605552527957,0.7632817854056793,0.7645099529246894,-1232
104,2017-04-15,2017,197713,197713,244434547.43333298,3019402.8333333354,151412,0,47,0.8303197058362387,25203312,1992174072,198941,198941,368140,567081,242847564.9833299,3014321.9166665794,152556,0,39,0.29508130231836094,2061892981,-1228,-1228,1586982.4500030875,5080.916666755918,-1144,0,8,0.5352384035178778,-2036689669,1236.3099413459558,1220.701439036347,15.608502309608866,0.7658171187529399,0.7668404200240272,-1144
105,2017-04-16,2017,192242,192242,244557850.26666668,2960935.4833333334,148401,0,61,0.8372416017311504,25357961,1996311904,193546,193546,378679,572225,242999809.48333094,2955644.416666546,149660,0,61,0.287722486784045,2071177950,-1304,-1304,1558040.7833357453,5291.06666678749,-1259,0,0,0.5495191149471054,-2045819989,1272.1353828334427,1255.514500342714,16.620882490728718,0.7719488977434692,0.7732528701187315,-1259
106,2017-04-17,2017,193851,193851,245097946.54999977,2942752.6500000046,150031,0,42,0.8389175191255135,25088725,2003605992,195008,195008,389954,584962,243549308.26666498,2937881.1166665293,151144,0,41,0.2832372017327623,2080344779,-1157,-1157,1548638.2833347917,4871.533333475236,-1113,0,1,0.5556803173927511,-2055256054,1264.362559646325,1248.9195738978144,15.442985748510637,0.7739500956920522,0.7750656383327863,-1113
107,2017-04-18,2017,202340,202340,245678941.48333344,3046276.933333336,155075,0,46,0.8310912325788272,24954262,2010042313,203724,203724,395478,599202,244104941.99999607,3040931.316666512,156367,0,43,0.28625738899403086,2084515485,-1384,-1384,1573999.4833373725,5345.616666824091,-1292,0,3,0.5448338435847964,-2059561223,1214.1886996309847,1198.2139659539184,15.974733677066297,0.766408026094692,0.7675433429541929,-1292
108,2017-04-19,2017,200756,200756,246293572.84999973,3038910.4333333327,153631,0,40,0.8288071091274976,24848577,2016420170,202078,202078,398721,600799,244702112.48332986,3033159.6166665466,154893,0,47,0.2823024006364866,2086827088,-1322,-1322,1591460.3666698635,5750.816666786093,-1262,0,-7,0.546504708491011,-2061978511,1226.8304451672664,1210.929010002721,15.901435164545319,0.7652623084739684,0.7665010540484367,-1262
109,2017-04-20,2017,195071,195071,246431692.63333336,2982135.3666666686,151455,0,51,0.8416268948229113,24741289,2020053796,196453,196453,410938,607391,244852680.76666456,2976918.183333211,152734,0,34,0.2760528226463691,2094241627,-1382,-1382,1579011.8666687906,5217.183333457448,-1279,0,17,0.5655740721765422,-2069500338,1263.2923019481796,1246.3677356246255,16.924566323554018,0.7764096149607066,0.7774582215593552,-1279
110,2017-04-21,2017,191697,191697,246585508.9833335,2938101.516666661,148751,0,35,0.8384273097648894,24598602,2023616221,193023,193023,420866,613889,244995605.44999793,2933200.8833332187,149961,0,32,0.26766565291119515,2100052154,-1326,-1326,1589903.5333355665,4900.633333442267,-1210,0,3,0.5707616568536943,-2075453552,1286.3295147202798,1269.2560236344784,17.07349108580138,0.7759693683260562,0.776907415178502,-1210
111,2017-04-22,2017,190641,190641,246737856.59999996,2943321.066666663,147799,0,37,0.8382981625148846,24562571,2027155959,191936,191936,431005,622941,245156961.98333228,2938227.016666554,149058,0,43,0.2622832659914824,2104013267,-1295,-1295,1580894.616667688,5094.050000109244,-1259,0,-6,0.5760148965234022,-2079450696,1294.2538939682438,1277.2849386427365,16.968955325507295,0.7752739442197638,0.7766026175391797,-1259
112,2017-04-23,2017,192226,192226,246970019.2999998,2951271.249999999,147843,0,37,0.8314015793909258,24358770,2030275744,193405,193405,436534,629939,245414709.4499968,2945612.4999998817,148915,0,36,0.25853138160996564,2111335443,-1179,-1179,1555309.850003004,5658.750000117347,-1072,0,1,0.5728701977809603,-2086976673,1284.789879100641,1268.9160541350886,15.87382496555233,0.7691103180631133,0.7699645820945684,-1072
113,2017-04-24,2017,199280,199280,247684202.43333325,3025081.3999999985,152781,0,40,0.8317794058611008,24778556,2037483948,200655,200655,443052,643707,246156933.26666182,3020009.1666665543,154042,0,33,0.26304825021321854,2118239927,-1375,-1375,1527269.166671425,5072.233333444223,-1261,0,7,0.5687311556478822,-2093461371,1242.8954357353134,1226.767004393919,16.12843134139439,0.766664993978322,0.7676957962672248,-1261
114,2017-04-25,2017,199803,199803,248148765.3166669,3032102.1666666637,154422,0,40,0.8419993693788379,24847745,2043023625,201324,201324,447059,648383,246597286.6666655,3025714.7499998426,155819,0,35,0.2658120277675423,2120533001,-1521,-1521,1551478.6500014067,6387.416666821111,-1397,0,5,0.5761873416112956,-2095685256,1241.967164240111,1224.877742676807,17.089421563304086,0.7728712782090359,0.7739713099282748,-1397
115,2017-04-26,2017,196777,196777,248398637.46666703,2999506.133333331,152903,0,57,0.846038917149871,24836112,2046598686,198272,198272,457116,655388,246832459.71666783,2994374.3666665372,154246,0,35,0.2602473649197095,2126798250,-1495,-1495,1566177.7499991953,5131.76666679373,-1343,0,22,0.5857915522301615,-2101962138,1262.3357275833407,1244.918393503207,17.41733408013374,0.7770369504566083,0.7779515009683667,-1343
116,2017-04-27,2017,196481,196481,248839389.30000007,3021392.500000001,151183,0,39,0.8322687689903863,24928810,2051637540,197874,197874,466703,664577,247252214.14999932,3016243.6999997147,152466,0,35,0.2516683544570397,2132011427,-1393,-1393,1587175.150000751,5148.800000286195,-1283,0,4,0.5806004145333465,-2107082617,1266.4806739582966,1249.5437204988998,16.93695345939682,0.7694535349473995,0.7705206343430668,-1283
117,2017-04-28,2017,201266,201266,249315421.41666648,3030566.2999999993,154646,0,37,0.8281428557232713,24153073,2056503712,202740,202740,473612,676352,247726677.28332794,3025265.249999934,156032,0,34,0.2520374006434497,2137508885,-1474,-1474,1588744.1333385408,5301.050000065472,-1386,0,3,0.5761054550798216,-2113355812,1238.7359087807502,1221.8934462036498,16.842462577100378,0.7683662416901017,0.769616257275328,-1386
118,2017-04-29,2017,204650,204650,249803095.6833332,3109770.8333333326,156611,0,48,0.8263376496457374,25139798,2061560657,206221,206221,480077,686298,248203987.38333046,3104013.599999883,158141,0,34,0.2530110826492288,2143083141,-1571,-1571,1599108.300002724,5757.233333449345,-1530,0,14,0.5733265669965086,-2117943343,1220.6356984282102,1203.5825031559855,17.053195272224684,0.7652626435377474,0.7668520664723767,-1530
119,2017-04-30,2017,199853,199853,249867174.09999993,3045261.899999997,153929,0,54,0.8303903368976201,24398384,2063869027,201347,201347,488669,690016,248261075.73333165,3039637.999999921,155411,0,54,0.24658848490470617,2151127447,-1494,-1494,1606098.366668284,5623.900000076275,-1482,0,0,0.5838018519929139,-2126729063,1250.2548077837207,1233.0011161493921,17.25369163432856,0.7702111051622943,0.7718565461616016,-1482
120,2017-05-01,2017,187916,187916,249693427.88333333,2880120.849999996,145022,0,38,0.8228623427488876,23965117,2067214211,189086,189086,235657,424743,248073604.28333032,2874883.983333319,146234,0,31,0.37207205298262364,2136888833,-1170,-1170,1619823.600003004,5236.866666676942,-1212,0,7,0.45079028976626395,-2112923716,1328.7502282048006,1311.9617755060149,16.788452698785704,0.7717384363226122,0.7733729625672974,-1212
121,2017-05-02,2017,183663,183663,249840019.03333333,2892339.599999996,142767,0,38,0.8321654334297042,25285643,2072789649,184636,184636,250481,435117,248228542.6833322,2887937.299999785,143715,0,32,0.35826226049546234,2142482315,-973,-973,1611476.3500011265,4402.300000210758,-948,0,6,0.47390317293424183,-2117196672,1360.3176417315046,1344.4211458400973,15.896495891407312,0.7773313078845494,0.7783693320912498,-948
122,2017-05-03,2017,183701,183701,250119255.4666665,2886377.816666666,142526,0,37,0.8299737072743195,26336316,2078361183,184746,184746,257979,442725,248495194.39999896,2881983.2333330875,143479,0,40,0.35135354904286537,2147659303,-1045,-1045,1624061.066667527,4394.583333578426,-953,0,-3,0.47862015823145415,-2121322987,1361.5563087118007,1345.0640035508154,16.492305160985325,0.7758585963059537,0.7766284520368506,-953
123,2017-05-04,2017,184339,184339,250404644.03333303,2885951.7333333325,142356,0,30,0.8280342195628709,26570263,2083196339,185389,185389,269004,454393,248786974.39999825,2880796.5333331805,143300,0,25,0.34252288217468035,2155752966,-1050,-1050,1617669.6333347857,5155.200000151992,-944,0,5,0.4855113373881906,-2129182703,1358.3921147089495,1341.9726866210954,16.419428087854158,0.7722511242873185,0.7729692700214145,-944
124,2017-05-05,2017,186774,186774,250895870.46666688,2894803.3166666687,143635,0,42,0.8248310792722757,26522719,2091029773,187611,187611,278830,466441,249287592.64999765,2890311.4666666365,144410,0,37,0.33575307487978795,2162172261,-837,-837,1608277.8166692257,4491.850000032224,-775,0,5,0.4890780043924878,-2135649542,1343.3126156031722,1328.7472091188558,14.565406484316327,0.7690310214483814,0.7697309859230003,-775
125,2017-05-06,2017,185415,185415,251164815.1500005,2903689.8499999987,141927,0,56,0.8211309764582149,26531637,2096862834,186270,186270,289305,475575,249543258.41666597,2899278.6833332554,142758,0,50,0.32545865531198664,2168220927,-855,-855,1621556.7333345413,4411.166666743346,-831,0,6,0.4956723211462282,-2141689290,1354.6089321252352,1339.6857165226068,14.923215602628488,0.7654558692662405,0.7664036076662909,-831
126,2017-05-07,2017,183640,183640,251588158.18333322,2876196.1833333373,141277,0,38,0.8223208451317796,26114316,2104046517,184557,184557,298334,482891,249954863.96666554,2871888.3666665265,142247,0,31,0.31902230524072817,2178132894,-917,-917,1633294.216667682,4307.816666810773,-970,0,7,0.5032985398910514,-2152018578,1370.0073959014007,1354.350493162901,15.656902738499639,0.7693149640601176,0.7707483324934844,-970
127,2017-05-08,2017,183910,183910,252170268.4666668,2895311.2333333325,142185,0,37,0.8274155837094231,26338319,2112207640,184794,184794,309827,494621,250498578.6999997,2890929.599999801,143069,0,41,0.31270407038925,2188969489,-884,-884,1671689.7666670978,4381.633333531674,-884,0,-4,0.5147115133201732,-2162631170,1371.1612661990473,1355.5558010541451,15.605465144902155,0.7731227230710673,0.7742080370574802,-884
128,2017-05-09,2017,186260,186260,252226659.84999993,2907749.100000004,143458,0,36,0.8238161709438416,26189347,2115267452,187186,187186,316316,503502,250530233.81666267,2903186.783333242,144310,0,35,0.30982995102303623,2192355621,-926,-926,1696426.0333372653,4562.316666761879,-852,0,1,0.5139862199208054,-2166166274,1354.1643930527216,1338.4026252853455,15.761767767376114,0.7702029421239128,0.7709444082356587,-852
129,2017-05-10,2017,187698,187698,252857483.6,2937893.0500000045,144247,0,36,0.8233705207301092,26538541,2122438382,188678,188678,323993,512671,251103140.63332832,2933315.599999901,145093,0,32,0.3065455233473299,2197051859,-980,-980,1754342.9666716754,4577.450000103563,-846,0,4,0.5168249973827793,-2170513318,1347.150654775224,1330.8554290024715,16.295225772752474,0.7685057912178074,0.7689979753866375,-846
130,2017-05-11,2017,189330,189330,253335926.65000004,2938151.8333333363,144476,0,51,0.819870068135002,26563911,2128858387,190397,190397,333441,523838,251577844.0166603,2933462.7999999537,145427,0,51,0.3020303987110528,2202069390,-1067,-1067,1758082.633339733,4689.033333382569,-951,0,0,0.5178396694239491,-2175505479,1338.0654235990073,1321.3330252927321,16.732398306275172,0.7630908994876671,0.7638093037180208,-951
131,2017-05-12,2017,187813,187813,253695946.94999963,2922951.3166666687,144193,0,64,0.8250547086729897,26557361,2134521664,188647,188647,345512,534159,251946690.38333136,2918132.1833332125,145028,0,53,0.2950825503267723,2208746761,-834,-834,1749256.566668272,4819.133333456237,-835,0,11,0.5299721583462174,-2182189400,1350.7901314073022,1335.5457037924343,15.244427614867845,0.7677477064952906,0.7687797844651652,-835
132,2017-05-13,2017,187252,187252,254065008.0499997,2926648.083333333,142981,0,37,0.8207121953303574,26498095,2140534080,188081,188081,356510,544591,252293043.6333321,2921785.333333292,143917,0,37,0.28802165294689314,2214876336,-829,-829,1771964.4166676104,4862.750000040978,-936,0,0,0.5326905423834642,-2188378241,1356.8079809561432,1341.4063283018068,15.40165265433643,0.7635752889154722,0.7651862761257118,-936
133,2017-05-14,2017,185974,185974,254565200.0166664,2882728.800000001,141998,0,36,0.8175551421166394,25698056,2146854909,186780,186780,366172,552952,252768911.39999753,2878479.7666666275,142750,0,36,0.2792231513766159,2225226464,-806,-806,1796288.61666888,4249.033333373722,-752,0,0,0.5383319907400235,-2199528408,1368.821448249037,1353.2975232894182,15.523924959618853,0.7635368384827986,0.7642681229253667,-752
134,2017-05-15,2017,187383,187383,255382821.4666667,2925356.66666667,143344,0,54,0.8206667627266077,26173979,2156389935,188349,188349,378689,567038,253580242.5999952,2921325.0999998758,144176,0,55,0.27588274507176036,2235199707,-966,-966,1802578.8666715026,4031.5666667940095,-832,0,-1,0.5447840176548473,-2209025728,1362.8921591962276,1346.3317702774912,16.560388918736408,0.7649786800296718,0.7654726067035131,-832
135,2017-05-16,2017,188848,188848,255896699.38333344,2948707.4333333294,143939,0,69,0.817408709650089,26603711,2163445875,189741,189741,385339,575080,254116527.1999973,2944159.5499998867,144808,0,69,0.27311504486332777,2240496060,-893,-893,1780172.1833361387,4547.883333442733,-869,0,0,0.5442936647867613,-2213892349,1355.040558456184,1339.2810578630729,15.75950059311117,0.762194992798441,0.7631877137782557,-869
136,2017-05-17,2017,189751,189751,256652729.6833332,2967704.1333333286,145531,0,88,0.822435718388836,26831826,2172405114,190608,190608,394796,585404,254870480.79999876,2963220.649999876,146363,0,88,0.2708317674631507,2248036309,-857,-857,1782248.883334428,4483.483333452605,-832,0,0,0.5516039509256854,-2221204483,1352.5764274408734,1337.1447200537164,15.431707387157076,0.7669577498932812,0.7678743809283975,-832
137,2017-05-18,2017,188849,188849,257172035.8666662,2963006.583333332,145074,0,88,0.8233879978183641,26742003,2180515605,189669,189669,405110,594779,255373776.83333093,2958788.8499998543,145901,0,89,0.26538092299829075,2257106624,-820,-820,1798259.0333352685,4217.73333347775,-827,0,-1,0.5580070748200734,-2230364621,1361.7865906976801,1346.4181117279625,15.368478969717671,0.7682010495157506,0.7692400972220026,-827
138,2017-05-19,2017,189035,189035,257667432.6833334,2942845.03333333,145455,0,111,0.8239056259422854,26686273,2188668121,189977,189977,415015,604992,255843620.73332995,2938383.449999865,146349,0,112,0.26164808790860156,2265759396,-942,-942,1823811.9500034451,4461.583333464805,-894,0,-1,0.5622575380336838,-2239073123,1363.0673297713831,1346.7083948758532,16.358934895529956,0.7694606818843072,0.7703511477705196,-894
139,2017-05-20,2017,187075,187075,257800160.90000004,2926224.6000000034,144043,0,96,0.8235039422691437,26403204,2193639740,187990,187990,426560,614550,255961109.88333094,2921948.89999991,144934,0,96,0.25512163371572555,2273257025,-915,-915,1839051.0166690946,4275.7000000933185,-891,0,0,0.5683823085534181,-2246853821,1378.05778912201,1361.5676891501193,16.490099971890686,0.7699746091139917,0.7709665407734454,-891
140,2017-05-21,2017,187619,187619,258181087.9999999,2912330.6999999983,144182,0,94,0.8213773658318194,26615693,2200482695,188508,188508,436040,624548,256357667.1333313,2907306.9333332544,145062,0,95,0.2509110588777836,2282317255,-889,-889,1823420.8666686118,5023.766666743904,-880,0,-1,0.5704663069540359,-2255701562,1376.092442663056,1359.9299081913302,16.16253447172585,0.7684829361631818,0.769527022725826,-880
141,2017-05-22,2017,191608,191608,258688380.44999972,2959417.3166666687,146635,0,93,0.818196526241076,27309088,2208168086,192478,192477,446922,639400,256866567.24999702,2954822.6666665906,147487,0,94,0.24927431967469124,2292323847,-870,-869,1821813.2000027,4594.650000078138,-852,0,-1,0.5689222065663847,-2265014759,1350.0917521710978,1334.5312284064955,15.560523764602294,0.7652864181036283,0.7662538056297343,-852
142,2017-05-23,2017,191157,191157,258751752.75000027,2977634.083333332,146790,0,91,0.8263626233933364,27681683,2210640121,192315,192315,453611,645926,256884254.01666406,2973190.2333332067,147896,0,91,0.24990169152503527,2291780321,-1158,-1158,1867498.7333362103,4443.850000125356,-1106,0,0,0.5764609318683012,-2264098638,1353.6085665186222,1335.7473624868785,17.861204031743682,0.7679028233336995,0.7690299768608793,-1106
143,2017-05-24,2017,194096,194096,259283371.25000015,2982014.1499999985,149111,0,98,0.8249680570439367,26922372,2217544843,195180,195180,463820,659000,257418230.28333026,2977137.0499999123,150106,0,98,0.24759787556905258,2297822843,-1084,-1084,1865140.9666698873,4877.1000000862405,-995,0,0,0.5773701814748842,-2270900471,1335.8511831773976,1318.876064572857,16.975118604540512,0.768233245404336,0.7690644533251357,-995
144,2017-05-25,2017,187854,187854,259103615.03333354,2839382.3166666673,147281,0,82,0.8289363015959207,18486374,2210661269,188373,188373,473973,662346,257249722.33332944,2835603.849999952,147769,0,82,0.23734271815637437,2292583583,-519,-519,1853892.7000041008,3778.4666667152196,-488,0,0,0.5915935834395463,-2274097209,1379.2818626876913,1365.6400988110263,13.641763876664982,0.7840184398522256,0.7844489390730094,-488
145,2017-05-26,2017,191486,191486,256194515.13333347,2895557.316666661,149507,0,89,0.83569555998872,22532284,2188148256,192186,192186,488891,681077,254325159.96666598,2891018.1166666658,150097,0,89,0.23839595229320587,2295608089,-700,-700,1869355.1666674912,4539.199999995064,-590,0,0,0.5972996076955142,-2273075805,1337.9281782132034,1323.328233933096,14.599944280107366,0.7807724846725087,0.7809986159241568,-590
146,2017-05-27,2017,196762,196762,256691504.81666636,3028484.2833333365,151358,0,111,0.8274870147691122,27817145,2195709128,197698,197698,488264,685962,254811745.96666515,3023520.7999999155,152290,0,111,0.24220146305480886,2278595712,-936,-936,1879758.850001216,4963.48333342094,-932,0,0,0.5852855517143034,-2250778567,1304.5786524667687,1288.893898606284,15.684753860484761,0.7692440613533101,0.7703163410858987,-932
147,2017-05-28,2017,193679,193679,257226729.59999987,2978617.8499999978,147795,0,120,0.8139550493342078,27090453,2202836219,194442,194442,499458,693900,255256709.31666446,2973116.483333307,148569,0,120,0.23119325551233538,2285977034,-763,-763,1970020.2833354175,5501.366666690912,-774,0,0,0.5827617938218724,-2258886581,1328.1085177019702,1312.765294106543,15.343223595427162,0.7630925397177805,0.7640787484185515,-774
148,2017-05-29,2017,191179,191179,257713673.78333306,2991333.1,146911,0,115,0.8180919452450317,26963903,2209906071,191894,191894,513446,705340,255782204.78332818,2986420.4666665774,147672,0,116,0.2254685683500142,2294758689,-715,-715,1931469.0000048876,4912.633333422709,-761,0,-1,0.5926233768950175,-2267794786,1348.022919794188,1332.9348743750622,15.08804541912582,0.7684473713117026,0.7695498556494731,-761
149,2017-05-30,2017,191638,191638,258378544.46666706,2990653.100000001,145727,0,101,0.8091297133136435,26865573,2218371958,192447,192447,520128,712575,256448506.68332964,2985252.316666602,146515,0,101,0.22196681051117287,2298119985,-809,-809,1930037.7833374143,5400.783333398867,-788,0,0,0.5871629028024706,-2271254412,1348.2636244725318,1332.5669232740943,15.696701198437495,0.7604285162650414,0.761326495086959,-788
150,2017-05-31,2017,194187,194187,259188425.94999996,3009897.5833333298,147946,0,83,0.812654812114097,27323527,2228354968,195118,195118,530075,725193,257247866.8999964,3005236.216666483,148868,0,83,0.22198090715161364,2307511550,-931,-931,1940559.0500035584,4661.366666846909,-922,0,0,0.5906739049624833,-2280188023,1334.7362385226609,1318.4220159083036,16.314222614357277,0.761873863852884,0.762963950019988,-922
151,2017-06-01,2017,193551,193551,259660831.45000002,3009223.0666666664,147965,0,119,0.8220572355606536,27860490,2236354806,194715,194715,237880,432595,257735505.08333218,3004457.7666665846,149116,0,119,0.3757093817542977,2293691384,-1164,-1164,1925326.366667837,4765.30000008177,-1151,0,0,0.4463478538063559,-2265830894,1341.5628513931729,1323.6551117445097,17.90773964866321,0.764475512913909,0.7658167064684283,-1151
152,2017-06-02,2017,195525,195525,260196552.38333338,3019115.533333335,149128,0,96,0.8183301368111494,28269484,2244539849,196611,196611,249859,446470,258287141.3499962,3014394.3499998646,150166,0,97,0.36572894035433784,2303257640,-1086,-1086,1909411.0333371758,4721.183333470486,-1038,0,-1,0.45260119645681157,-2274988156,1330.758482973192,1313.6962903906506,17.062192582541456,0.7627055363764225,0.7637721185488096,-1038
153,2017-06-03,2017,194846,194846,260505477.89999995,3027920.100000001,149083,0,72,0.8232758178253596,28151568,2251703128,195841,195841,262841,458682,258593943.83332968,3023706.0499998955,150148,0,72,0.35778164392760226,2313328672,-995,-995,1911534.0666702688,4214.050000105519,-1065,0,0,0.4654941738977574,-2285177104,1336.981400182708,1320.4280198392046,16.553380343503477,0.7651324635866273,0.766683176658616,-1065
154,2017-06-04,2017,192810,192810,261156195.30000016,3007262.116666667,148044,0,115,0.8244178206524561,27819681,2260724220,193981,193981,273976,467957,259256441.36666536,3002536.8166664653,149201,0,116,0.348230713505727,2325825186,-1171,-1171,1899753.9333347976,4725.300000201911,-1157,0,-1,0.47618710714672907,-2298005505,1354.474328613662,1336.5043038579313,17.97002475573072,0.7678232456822779,0.7691526489707755,-1157
155,2017-06-05,2017,193988,193988,261791308.9666668,3008680.216666661,148813,0,77,0.8201125842835635,27644081,2269405037,195122,195122,286347,481469,259895346.5333319,3004187.4666664954,149904,0,77,0.33722212645051,2338040487,-1134,-1134,1895962.433334887,4492.750000165775,-1091,0,0,0.4828904578330535,-2310396406,1349.5232126042167,1331.9633179924965,17.55989461172021,0.7671247706043672,0.768257807935548,-1091
156,2017-06-06,2017,191557,191557,261873846.23333314,2979206.6000000015,146357,0,87,0.820439869072914,27408534,2273759081,192570,192570,298933,491503,259966335.2166661,2974582.1499998197,147308,0,87,0.3258291404121624,2344769793,-1013,-1013,1907511.0166670382,4624.450000181794,-951,0,0,0.4946107286607516,-2317361259,1367.080535993637,1349.9835655432628,17.09697045037433,0.7640389022588576,0.7649581970192657,-951
157,2017-06-07,2017,193441,193441,262044490.53333312,2999482.3166666664,147105,0,82,0.815452773713949,27141827,2277728228,194505,194505,309102,503607,260145889.03332865,2995043.9166665203,148063,0,82,0.31923106708207105,2350593900,-1064,-1064,1898601.5000044703,4438.4000001461245,-958,0,0,0.4962217066318779,-2323452073,1354.6481383643236,1337.4766151683948,17.171523195928785,0.7604644310151416,0.7612297884373153,-958
158,2017-06-08,2017,195076,195076,262695701.39999995,3028396.383333332,148446,0,73,0.812104000492115,27083240,2285002411,196097,196097,319771,515868,260764878.08332732,3023711.6999998908,149354,0,73,0.3122387897679179,2353560072,-1021,-1021,1930823.3166726232,4684.683333441149,-908,0,0,0.49986521072419704,-2326476832,1346.632601652689,1329.7749485373429,16.85765311534601,0.7609649572474317,0.7616332733290158,-908
159,2017-06-09,2017,198165,198165,263395574.13333338,3035788.116666667,150216,0,93,0.8104357479877885,27477808,2292721532,199195,199195,329539,528734,261475311.3499959,3031209.783333241,151205,0,93,0.3091157368355385,2359986694,-1030,-1030,1920262.7833374739,4578.333333426155,-989,0,0,0.50132001115225,-2332508886,1329.1730332467055,1312.6600133035263,16.513019943179188,0.7580349708576186,0.759080298200256,-989
160,2017-06-10,2017,194787,194787,263700952.78333357,3002340.4999999977,147059,0,88,0.8060137483507621,27266400,2297863126,195835,195835,344047,539882,261798084.08333093,2997429.399999954,148085,0,88,0.2966796448112736,2368425236,-1048,-1048,1902868.7000026405,4911.100000043865,-1026,0,0,0.5093341035394885,-2341158836,1353.7913350651406,1336.8299031497481,16.961431915392495,0.754973381180469,0.7561722878954221,-1026
161,2017-06-11,2017,193647,193647,264111496.78333333,2990452.516666669,147273,0,73,0.8119000036148256,27025241,2302964017,194626,194626,355935,550561,262208298.81666404,2985663.98333323,148210,0,73,0.29062538029392604,2377662187,-979,-979,1903197.9666692913,4788.533333438914,-937,0,0,0.5212746233208996,-2350636946,1363.8811692581519,1347.241883492771,16.63928576538092,0.7605230135246092,0.7615118226752849,-937
162,2017-06-12,2017,191608,191608,264622554.86666664,2991082.749999997,144999,0,92,0.8060884722976074,26669256,2310702494,192614,192614,369356,561970,262758751.23333204,2986161.983333263,146026,0,92,0.2805398864708037,2385686078,-1006,-1006,1863803.633334607,4920.7666667341255,-1027,0,0,0.5255485858268036,-2359016822,1381.062141803404,1364.172652212882,16.88948959052209,0.7567481524779759,0.7581276542722751,-1027
163,2017-06-13,2017,192257,192257,265094598.2333335,3013584.733333333,145023,0,123,0.8013440342874378,26472163,2316404541,193360,193360,377622,570982,263191351.8166641,3008808.3166665807,146084,0,123,0.2755673558886317,2389705887,-1103,-1103,1903246.4166693985,4776.416666752193,-1061,0,0,0.5257766783988062,-2363233724,1378.8553770907354,1361.146833971163,17.70854311957237,0.7543184383403465,0.7555026892842367,-1061
164,2017-06-14,2017,197912,197912,265776911.66666692,3055358.1666666707,149344,0,94,0.8006285621892557,27946429,2324256722,198891,198891,387530,586421,263880697.59999642,3050565.4999999264,150274,0,95,0.2753482566279226,2399156247,-979,-979,1896214.0666705072,4792.666666744277,-930,0,-1,0.5252803055613331,-2371209818,1342.9044811161875,1326.7603742753388,16.144106840848735,0.7545980031529165,0.7555595778592294,-930
165,2017-06-15,2017,199590,199590,266606731.5000003,3071729.683333332,151149,0,125,0.8030963475123996,28132851,2333697148,200703,200703,398158,598861,264729583.89999625,3066559.566666549,152164,0,126,0.2726809727132023,2405742328,-1113,-1113,1877147.6000040472,5170.116666783113,-1015,0,-1,0.5304153747991973,-2377609477,1335.7719900796649,1319.0115937479572,16.760396331707625,0.7572974597925748,0.7581550848766585,-1015
166,2017-06-16,2017,200564,200564,267253920.33333334,3057090.8666666686,150765,0,88,0.797984683193394,28468101,2342626782,201583,201583,411696,613279,265367327.26666448,3052485.6833332013,151684,0,88,0.2652283870799467,2415424979,-1019,-1019,1886593.066668868,4605.1833334672265,-919,0,0,0.5327562961134473,-2386956878,1332.511918057744,1316.4171942409057,16.09472381683827,0.7517051913603637,0.7524642454968921,-919
167,2017-06-17,2017,200395,200395,267648775.29999995,3049302.9833333325,149412,0,99,0.7925846453254821,27806051,2349695690,201452,201452,426268,627720,265737105.19999737,3044201.5499999067,150421,0,100,0.25761326706175114,2423757393,-1057,-1057,1911670.1000025868,5101.433333425783,-1009,0,-1,0.534971378263731,-2395951342,1335.6060545422788,1319.1087961400103,16.49725840226847,0.7455874647571047,0.7466840736254791,-1009
168,2017-06-18,2017,198965,198965,268021166.73333344,3021208.6500000013,148635,0,92,0.7926670519940694,27482389,2354965717,199883,199883,440006,639889,266130170.7833376,3016518.7666665865,149554,0,92,0.2508872632597199,2434092566,-918,-918,1890995.9499958456,4689.883333414793,-919,0,0,0.5417797887343495,-2406610177,1347.0769569187216,1331.429740314772,15.647216603949573,0.7470409368481894,0.7482077015053806,-919
169,2017-06-19,2017,199453,199453,268689360.14999986,3050498.4333333327,149119,0,98,0.7918958351090227,27605436,2363754223,200445,200445,455431,655876,266746566.5166634,3045819.299999918,150051,0,98,0.24488622849441183,2443546693,-992,-992,1942793.6333364546,4679.133333414793,-932,0,0,0.5470096066146108,-2415941257,1347.1312045945654,1330.7718651832843,16.3593394112811,0.7476397948388843,0.748589388610342,-932
170,2017-06-20,2017,193984,193984,268626884.28333306,2975371.0333333327,142860,0,94,0.7746051220719239,22325306,2361361226,194603,194603,467711,662314,266718191.08333087,2970483.4166666204,143487,0,94,0.22920548259587364,2443742305,-619,-619,1908693.2000021935,4887.6166667123325,-627,0,0,0.5453996394760503,-2421416999,1384.7888706456877,1370.5759473560577,14.212923289629998,0.7364524909270868,0.7373319013581496,-627
171,2017-06-21,2017,202288,202288,269037963.48333335,3083073.8,151268,0,59,0.7934677291782015,27851317,2368167989,203297,203297,479139,682436,267068510.90000567,3078929.8999999324,152176,0,60,0.2391770070746554,2451142844,-1009,-1009,1969452.5833276808,4143.900000067428,-908,0,-1,0.5542907221035461,-2423291527,1329.9749045090828,1313.686433641449,16.288470867633805,0.7477853357589179,0.7485403129411649,-908
172,2017-06-22,2017,203207,203207,269842451.95000017,3083257.133333334,151399,0,34,0.7882848523918955,27680653,2377154331,204114,204114,490515,694629,267886849.8333298,3078383.2166665457,152202,0,34,0.23391911365635726,2454788753,-907,-907,1955602.11667037,4873.916666788049,-803,0,0,0.5543657387355383,-2427108100,1327.9190773447774,1312.4374116098347,15.48166573494268,0.7450481528687496,0.745671536494312,-803
173,2017-06-23,2017,201890,201890,270239077.5333334,3055286.2000000007,151198,0,51,0.7933082371588477,27550194,2382673412,202853,202853,505354,708207,268291329.06666243,3050829.2999999356,152084,0,51,0.22972661947707237,2461014147,-963,-963,1947748.46667099,4456.900000065099,-886,0,0,0.5635816176817753,-2433463953,1338.5461267687028,1322.5899004040484,15.956226364654412,0.7489127742830254,0.7497251704436217,-886
174,2017-06-24,2017,195865,195865,270082872.9666666,2998100.28333333,146924,0,42,0.7946085313864149,27101029,2383897855,196654,196654,522793,719447,268147434.10000485,2993545.533333243,147808,0,42,0.21972014616781751,2467743525,-789,-789,1935438.8666617274,4554.750000087079,-884,0,0,0.5748883852185973,-2440642496,1378.923610480007,1363.5493511446746,15.374259335332454,0.7501289153243306,0.7516145107651001,-884
175,2017-06-25,2017,195483,195483,270300975.5000001,2988395.916666669,146718,0,68,0.7976499235227613,27243822,2388781494,196340,196340,536881,733221,268345989.46666843,2983575.433333308,147657,0,68,0.21612174228506503,2477120897,-857,-857,1954986.0333316922,4820.483333360869,-939,0,0,0.5815281812376962,-2449877075,1382.7339231544438,1366.741313367976,15.99260978646771,0.750540967756787,0.7520474686767852,-939
176,2017-06-26,2017,199435,199435,270943415.4166667,3025853.5000000023,148545,0,33,0.7869080151427785,26929029,2396734879,200489,200489,550784,751273,268990505.30000716,3021422.0499995975,149596,0,33,0.21258450656420144,2482985385,-1054,-1054,1952910.116659522,4431.450000404846,-1051,0,0,0.5743235085785771,-2456056356,1358.5549949440503,1341.6721381223267,16.882856821723635,0.744829142327074,0.7461556494371262,-1051
177,2017-06-27,2017,200890,200890,271348975.15000004,3058959.366666666,150291,0,71,0.7922395340733739,27584359,2402143098,201989,201989,560663,762652,269408492.63333064,3054526.4666666086,151302,0,71,0.2125137021865782,2485385443,-1099,-1099,1940482.5166693926,4432.900000057649,-1011,0,0,0.5797258318867957,-2457801084,1350.7341089651054,1333.7780405533501,16.95606841175527,0.7481258400119468,0.7490605924084975,-1011
178,2017-06-28,2017,200503,200503,271858491.39999974,3042653.9833333315,150049,0,60,0.7928160675900104,26837924,2408218447,201631,201631,573290,774921,269919412.2999954,3037967.283333321,151093,0,61,0.2089361367158711,2491404385,-1128,-1128,1939079.1000043154,4686.700000010431,-1044,0,-1,0.5838799308741394,-2464566461,1355.8824127319779,1338.6801250799501,17.202287652027735,0.7483628673885179,0.7493540179833458,-1044
179,2017-06-29,2017,200728,200728,272338059.6666663,3058556.6000000075,150038,0,70,0.7965356103782241,27718469,2414125699,201751,201751,587397,789148,270415017.63333154,3053567.283333333,151065,0,70,0.20579536411420937,2498502213,-1023,-1023,1923042.0333347917,4989.316666674335,-1027,0,0,0.5907402462640147,-2470783744,1356.751722065015,1340.3404078955323,16.411314169482694,0.7474692120680723,0.748769522827644,-1027
180,2017-06-30,2017,196705,196705,272722617.4333334,2980004.0499999993,148052,0,74,0.7933301136219219,25300702,2418982231,197363,197363,601318,798681,270798171.5333301,2975720.9333333327,148717,0,66,0.19736665827783662,2504048990,-658,-658,1924445.900003314,4283.116666666698,-665,0,8,0.5959634553440852,-2478748288,1386.4549321742375,1372.0817556144266,14.373176559810872,0.7526600747311964,0.7535201633538201,-665
181,2017-07-01,2017,201306,201306,272494828.6166668,3050910.899999999,153210,0,97,0.813453150924464,26779966,2419788523,202520,202520,265617,468137,270589601.850008,3047807.7333332226,153849,0,78,0.35343499872900186,2487846558,-1214,-1214,1905226.766658783,3103.1666667764075,-639,0,19,0.46001815219546216,-2461066592,1353.6349071397117,1336.1129856310883,17.521921508623336,0.761080146642425,0.7596731187043255,-639
182,2017-07-02,2017,201751,201751,272824392.30000013,3032724.5666666664,153141,0,105,0.8070245004981379,26715789,2424890410,202385,202385,281176,483561,270908522.1833426,3028986.266666583,153698,0,101,0.3403707081422988,2494412826,-634,-634,1915870.116657555,3738.3000000836328,-557,0,4,0.4666537923558391,-2467697037,1352.2827262318408,1338.5800438932854,13.702682338555405,0.7590594346496424,0.7594337525014205,-557
183,2017-07-03,2017,203968,203968,273472576.6000003,3036186.866666665,153226,0,113,0.7972083856291188,24980080,2431096061,204717,204717,297853,502570,271556274.3833418,3032959.433333217,153630,0,93,0.32615158087430673,2500799914,-749,-749,1916302.2166585326,3227.4333334476687,-404,0,20,0.47105680475481204,-2475819834,1340.7621617116426,1326.4959645918111,14.266197119831531,0.7512256824599938,0.7504506220782837,-404
184,2017-07-04,2017,206415,206415,274015676.5500001,3098506.333333331,156311,0,112,0.8103916866506786,26842663,2436996840,207419,207419,313493,520912,272083515.73334086,3094891.599999926,156957,0,112,0.32529102804312493,2501925879,-1004,-1004,1932160.816659212,3614.7333334051073,-646,0,0,0.4851006586075537,-2475083216,1327.4988569144687,1311.7579186735104,15.740938240958258,0.7572657025894436,0.7567146693408029,-646
185,2017-07-05,2017,210585,210585,274874205.53333336,3117981.4333333373,157637,0,150,0.8013296293658144,27069910,2445139740,211224,211224,328119,539343,272927305.35001206,3113936.16666657,158192,0,143,0.3160066970369571,2509112833,-639,-639,1946900.1833212972,4045.2666667671874,-555,0,7,0.4853229323288573,-2482042923,1305.2886270785352,1292.1226060959552,13.166020982579994,0.7485670869245198,0.7489300458281256,-555
186,2017-07-06,2017,209410,209410,275601871.53333354,3113648.683333334,156046,0,192,0.7949524855546537,26371040,2451674466,210702,210702,346123,556825,273710782.0000093,3111062.7499999152,156799,0,193,0.30233556323799965,2516574169,-1292,-1292,1891089.5333242416,2585.9333334187977,-753,0,-1,0.49261692231665405,-2490203129,1316.0874434522398,1299.0421638143412,17.045279637898602,0.7451697626665393,0.7441742365995576,-753
187,2017-07-07,2017,213326,213326,276106673.93333346,3095293.1666666656,157122,0,62,0.7819253161827435,27007833,2456970158,214165,214165,364438,578603,274202157.30000937,3092483.516666571,157773,0,62,0.29104757493479444,2524483127,-839,-839,1904516.6333240867,2809.650000094436,-651,0,0,0.4908777412479491,-2497475294,1294.2945254368124,1280.3313207107108,13.963204726101594,0.7365346933800849,0.7366890014708286,-651
188,2017-07-08,2017,207094,207094,276097556.35,3057498.416666661,154305,0,148,0.7984731571170581,26555020,2459321437,207902,207902,386959,594861,274152381.0500085,3053996.86666654,155065,0,148,0.2814085979749847,2530905339,-808,-808,1945175.299991548,3501.5500001208857,-760,0,0,0.5170645591420735,-2504350319,1333.1992059161541,1318.6615859876695,14.537619928484673,0.7450964296406463,0.7458562207193774,-760
189,2017-07-09,2017,207156,207156,276441143.26666665,3046471.399999996,155215,0,69,0.7985720905983905,26749126,2464227802,209528,209528,403881,613409,274308718.7166828,3045653.483333245,156261,0,69,0.2733543198746633,2536208065,-2372,-2372,2132424.549983859,817.9166667512618,-1046,0,0,0.5252177707237272,-2509458939,1334.4587811440008,1309.1745194755965,25.28426166840427,0.7492662534515051,0.7457762208392196,-1046
190,2017-07-10,2017,208529,208529,277074286.2333332,3061958.6833333327,155623,0,95,0.7955536160438128,26048493,2470617178,209086,209086,423199,632285,274218501.6500106,3058646.5833332483,156201,0,90,0.26532339055964127,2536381877,-557,-557,2855784.5833225846,3312.100000084378,-578,0,5,0.5302302254841715,-2510333384,1328.7086507552099,1311.5105824876396,17.198068267570306,0.7462894849157671,0.7470658006753202,-578
191,2017-07-11,2017,206921,206921,277548616.81666666,3084480.1666666623,155655,0,76,0.8027169789436545,25972612,2474787366,207837,207837,437047,644884,274698670.3166784,3083106.0999998897,156336,0,76,0.2609973266509934,2534649773,-916,-916,2849946.499988258,1374.066666772589,-681,0,0,0.5417196522926611,-2508677161,1341.3264812013601,1321.702441416487,19.624039784873048,0.7522436098800992,0.7522048528414094,-681
192,2017-07-12,2017,207763,207763,278249106.63333297,3108425.9666666663,156214,0,89,0.8013746432232882,26129971,2480964870,218796,218796,452394,671190,275378563.40001404,3115056.8166665593,161050,0,89,0.2571045456577112,2539737309,-11033,-11033,2870543.233318925,-6630.849999892991,-4836,0,0,0.544270097565577,-2513607338,1339.2620756984302,1258.608765242573,80.65331045585708,0.7518855619142966,0.7360737856267939,-4836
193,2017-07-13,2017,208712,208712,278959646.36666656,3105404.7000000025,157274,0,219,0.8045248955498469,25989807,2486684692,224153,224153,468232,692385,270194575.7833396,3123941.1499997703,162520,0,219,0.2513731522202222,2486043060,-15441,-15441,8765070.583326936,-18536.44999976782,-5246,0,0,0.5531517433296247,-2460053253,1336.576940313286,1205.4024518223696,131.17448849091647,0.7535455555981448,0.7250404857396511,-5246
194,2017-07-14,2017,205993,205993,279475975.53333336,3084077.566666667,157005,0,59,0.8141198972780642,25550993,2491990706,224294,224294,486571,710865,264328056.56666067,3113058.2499998696,164056,0,59,0.2472551046963948,2431954738,-18301,-18301,15147918.966672689,-28980.68333320273,-7051,0,0,0.5668647925816694,-2406403745,1356.7255952063097,1178.4891997407897,178.23639546552,0.7621860937022131,0.7314328515252303,-7051
195,2017-07-15,2017,207194,207194,279510224.16666645,3080135.3333333316,156165,0,73,0.804810950124039,26302894,2493867016,216548,216548,502516,719064,258001199.96667233,3086970.8166663577,160095,0,73,0.23888694191337106,2376799970,-9354,-9354,21509024.199994117,-6835.483333026059,-3930,0,0,0.565924008210668,-2350497076,1349.0266328497275,1191.4273046468788,157.5993282028487,0.7537139106344778,0.7393049116131296,-3930
196,2017-07-16,2017,203503,203503,279633489.0000003,3035279.0166666647,153868,0,152,0.8078799821132854,25938328,2496486700,210233,210233,518918,729151,256282077.23332745,3038789.016666596,156205,0,153,0.23045157998823348,2366548098,-6730,-6730,23351411.76667285,-3509.999999931082,-2337,0,-1,0.5774284021250519,-2340609770,1374.1000820626737,1219.0382919585766,155.0617901040971,0.7560969617155521,0.7430089472157083,-2337
197,2017-07-17,2017,208970,208970,280165821.71666676,3080954.200000004,156507,0,207,0.8030817820739805,26411521,2504118227,214682,214682,537205,751887,256080078.45000833,3080739.966666247,158780,0,207,0.22823376385014896,2365864839,-5712,-5712,24085743.266658425,214.23333375668153,-2273,0,0,0.5748480182238316,-2339453318,1340.69876880254,1192.8344176503308,147.8643511522091,0.7489448246159736,0.7396055561248731,-2273
198,2017-07-18,2017,210257,210257,280639472.33333343,3122261.166666666,159503,0,124,0.8134283281888354,26784945,2509166461,211900,211900,551191,763091,256039368.04999745,3120773.9666666617,160233,0,124,0.2269716193743611,2361656697,-1643,-1643,24600104.283335984,1487.2000000043772,-730,0,0,0.5864567088144743,-2334871752,1334.744966081193,1208.302822321838,126.44214375935508,0.7586097014605935,0.7561727229825389,-730
199,2017-07-19,2017,212377,212377,281513492.66666675,3166060.5000000047,160601,0,111,0.8105632907518238,26647242,2517659951,239695,239694,562867,802562,257029455.61666968,3209436.7166663436,170873,0,111,0.2293280768339345,2366785693,-27318,-27317,24484037.04999706,-43376.216666338965,-10272,0,0,0.5812352139178892,-2340138451,1325.5366290448906,1072.3232772479482,253.21335179694233,0.7562071222401673,0.7128767809090719,-10272
200,2017-07-20,2017,213473,213473,281949252.14999956,3145615.750000001,159561,0,201,0.8017547886617976,26586971,2522134900,244308,244308,584101,828409,250367902.383339,3184963.316666327,170416,0,202,0.2214570339047422,2317725472,-30835,-30835,31581349.76666057,-39347.56666632602,-10855,0,-1,0.5802977547570554,-2291138501,1320.7724262553088,1024.804355090046,295.9680711652627,0.7474528394691601,0.6975457209751625,-10855
201,2017-07-21,2017,213585,213585,281628161.43333346,3145242.3500000006,160071,0,321,0.804962895334411,26846321,2521106673,232765,232765,605191,837956,243864105.050003,3160102.81666632,165943,0,321,0.21402078390751184,2267525150,-19180,-19180,37764056.383330464,-14860.466666319408,-5872,0,0,0.5909421114268991,-2240678829,1318.5764985056696,1047.6837370309238,270.89276147474584,0.7494486972399748,0.7129207569866604,-5872
202,2017-07-22,2017,213108,213108,281943519.8,3141831.75,159251,0,77,0.8004532912889233,26799890,2524165304,232531,232530,622545,855076,241116706.86667368,3161072.7666663122,166045,0,77,0.20940828651488766,2248725978,-19423,-19422,40826812.933326334,-19241.016666312236,-6794,0,0,0.5910450047740357,-2221926088,1323.0076759201906,1036.9273077309322,286.0803681892585,0.7472783752838936,0.7140768327663838,-6794
203,2017-07-23,2017,206554,206554,281935974.03333336,3090459.2666666666,157002,0,82,0.813433775187118,25712773,2525445435,227820,227820,640265,868085,238626019.50000173,3117697.8166662813,162708,0,82,0.2016645835373219,2228342016,-21266,-21266,43309954.53333163,-27238.549999614712,-5706,0,0,0.6117691916497962,-2202629243,1364.9504441130812,1047.4322688965049,317.5181752165763,0.7601014746749034,0.714195417434817,-5706
204,2017-07-24,2017,209656,209656,282524700.81666654,3138025.166666665,159047,0,79,0.8125071545770215,26559815,2532753299,236186,236186,659022,895208,237980683.2999978,3170628.266666631,167581,0,80,0.20169167389031264,2227361288,-26530,-26530,44544017.51666874,-32603.0999999661,-8534,0,-1,0.6108154806867089,-2200801473,1347.563154961778,1007.5986015259067,339.9645534358714,0.7586093410157592,0.7095297773788455,-8534
205,2017-07-25,2017,211153,211153,282977818.4333332,3141341.9666666663,159131,0,83,0.8075281904590509,26290276,2538227093,236155,236155,676731,912886,236413831.89999622,3196954.2166666584,166710,0,83,0.19688657729442652,2213565213,-25002,-25002,46563986.533337,-55612.249999992084,-7579,0,0,0.6106416131646244,-2187274937,1340.155330179222,1001.0960254917161,339.0593046875058,0.7536288852159335,0.7059346615570282,-7579
206,2017-07-26,2017,220346,220346,283874604.6000003,3177436.2833333313,162201,0,147,0.7901164532144896,26578140,2545693432,234812,234812,696006,930818,235571579.2166618,3204981.6666666446,166564,0,149,0.19336003386269376,2205319164,-14466,-14466,48303025.38333851,-27545.38333331328,-4363,0,-2,0.5967564193517959,-2178741024,1288.3129469107691,1003.2348398576811,285.07810705308805,0.7361195574233251,0.7093504590906768,-4363
207,2017-07-27,2017,226494,226494,284721517.63333344,3194933.766666665,163729,0,78,0.7791288069441132,27369883,2553491317,231010,231010,719440,950450,235467721.29999733,3194329.0666666348,165341,0,78,0.1889210374033399,2204107297,-4516,-4516,49253796.333336115,604.7000000304542,-1612,0,0,0.5902077695407734,-2176737414,1257.0819431566993,1019.2966594519602,237.78528370473907,0.7228844914214063,0.715730920739362,-1612
208,2017-07-28,2017,225561,225561,285315161.43333286,3163493.333333332,162795,0,111,0.7762822473743232,27317295,2560003326,234328,234328,740957,975285,236054971.74999565,3164305.0833332897,165729,0,111,0.1840426131848632,2212250227,-8767,-8767,49260189.68333721,-811.7499999576248,-2934,0,0,0.59223963418946,-2184932932,1264.9135330723523,1007.3698907087315,257.54364236362073,0.7217338103661537,0.7072522276467175,-2934
209,2017-07-29,2017,223835,223835,285369154.08333296,3153084.7000000007,159574,0,147,0.7669533361627988,27706916,2564086999,224500,224500,770498,994998,235640998.9666641,3148621.8666666243,160150,0,147,0.17472195924011835,2216495557,-665,-665,49728155.11666885,4462.833333376329,-576,0,0,0.5922313769226805,-2188788641,1274.9085446124732,1049.6258305864772,225.28271402599603,0.7129090624790583,0.7133630289532294,-576
210,2017-07-30,2017,221820,221820,285670081.64999956,3118482.3166666636,157994,0,235,0.7634568569110097,27461741,2569025841,225729,225729,790924,1016653,236253290.29999962,3117271.016666632,158941,0,235,0.1687980067928775,2228179452,-3909,-3909,49416791.349999934,1211.3000000314787,-947,0,0,0.5946588501181322,-2200717711,1287.846369353528,1046.623563210751,241.22280614277702,0.7122621945721757,0.7041230856469484,-947
211,2017-07-31,2017,223718,223718,286107538.63333344,3149215.583333333,160716,0,158,0.7692943795313743,27496271,2575280927,230628,230628,817427,1048055,236708840.51666635,3147762.8666666485,163139,0,158,0.16752842169542456,2236693090,-6910,-6910,49398698.11666709,1452.716666684486,-2423,0,0,0.6017659578359497,-2209196819,1278.875810767723,1026.3664451699983,252.50936559772458,0.7183865401979278,0.7073685762353227,-2423
212,2017-08-01,2017,234944,234944,286397392.95,3233584.4000000013,168626,0,150,0.7737631095069465,28018367,2579505395,235585,235585,333796,569381,236400133.4166626,3229084.916666434,169188,0,150,0.3222095573965378,2210584209,-641,-641,49997259.533337384,4499.483333567157,-562,0,0,0.4515535521104087,-2182565842,1219.002796198243,1003.4600395469262,215.54275665131684,0.7177284799782075,0.7181611732495702,-562
213,2017-08-02,2017,233281,233281,286729452.99999976,3249621.6333333296,167556,0,142,0.7725489859868567,27824618,2583289538,233967,233967,357119,591086,237100911.6499949,3245175.0833331617,168074,0,142,0.3075170110609931,2218789034,-686,-686,49628541.35000485,4446.5500001679175,-518,0,0,0.4650319749258636,-2190964416,1229.1161860588722,1013.3946738215001,215.72151223737217,0.7182582379190762,0.7183662653280164,-518
214,2017-08-03,2017,232844,232844,287148542.5833331,3258153.316666666,167182,0,136,0.7789764821081925,28013149,2587929646,233280,233280,383345,616625,237892492.2833308,3254215.599999713,167652,0,137,0.2974692884654347,2227017143,-436,-436,49256050.30000228,3937.7166669531725,-470,0,-1,0.4815071936427578,-2199003994,1233.2228555742604,1019.7723434642095,213.4505121100509,0.7180000343577674,0.7186728395061729,-470
215,2017-08-04,2017,234858,234858,287848289.1000002,3281689.7833333346,169718,0,138,0.7841759701606933,28316406,2594384918,235775,235775,407466,643241,238868464.33332688,3277230.2499997346,170319,0,138,0.29004525519983665,2235618795,-917,-917,48979824.76667333,4459.533333600033,-601,0,0,0.49413071496085664,-2207302389,1225.6269281863943,1013.1204085816006,212.50651960479365,0.7226409149358336,0.722379387127558,-601
216,2017-08-05,2017,236915,236915,288177093.2166664,3282085.383333337,168498,0,163,0.7684570415549886,28434689,2599323713,237441,237441,431763,669204,239525363.63333,3277409.5166664636,169080,0,163,0.27540630360846297,2246023103,-526,-526,48651729.58333641,4675.866666873451,-582,0,0,0.49305073794652565,-2217588414,1216.3733542269017,1008.7784486812724,207.59490554562933,0.7112171031804656,0.7120926882888802,-582
217,2017-08-06,2017,237348,237348,288458875.5000005,3261798.4666666673,168454,0,199,0.7686645769081688,28593280,2603979403,237981,237981,458486,696467,240081677.6499956,3257252.283333226,169111,0,199,0.26521141705206147,2257721735,-633,-633,48377197.85000488,4546.183333441149,-657,0,0,0.5034531598561074,-2229128455,1215.341504878914,1008.8270813636198,206.5144235152943,0.7097342299071405,0.710607149310239,-657
218,2017-08-07,2017,237054,237054,289210898.3833336,3286086.3833333347,169681,0,133,0.772077248221924,28274219,2612879457,237651,237651,486082,723733,241072302.1666612,3281594.249999944,170248,0,133,0.2563749338499184,2265375244,-597,-597,48138596.21667242,4492.133333390579,-567,0,0,0.5157023143720056,-2237101025,1220.0211697897257,1014.3963297720658,205.62484001765995,0.7157904949927021,0.71637821848004,-567
219,2017-08-08,2017,235279,235279,289676463.8166663,3253996.133333334,167849,0,198,0.7716923312322828,28388651,2618922622,236016,236016,509708,745724,241843579.71666113,3249425.633333267,168571,0,198,0.2472912230262121,2273158435,-737,-737,47832884.10000518,4570.50000006659,-722,0,0,0.5244011082060707,-2244769784,1231.2040760827201,1024.6914603953169,206.51261568740324,0.7134040862125391,0.7142354755609789,-722
220,2017-08-09,2017,233448,233448,289956831.55,3232193.2333333264,166132,0,179,0.770154381275488,28170065,2623279315,234057,234057,537308,771365,242442016.96666324,3227767.93333326,166747,0,179,0.23670117259662668,2283693239,-609,-609,47514814.58333677,4425.300000066403,-615,0,0,0.5334532086788613,-2255523174,1242.061750582571,1035.8246793159924,206.2370712665786,0.7116445632432062,0.7124204787722649,-615
221,2017-08-10,2017,233941,233941,290529325.4333335,3265960.450000003,169256,0,176,0.7848132648830255,28715893,2630114442,234673,234673,562763,797436,243260775.91666365,3261621.1833333196,169887,0,172,0.23371781559899213,2292476226,-732,-732,47268549.51666987,4339.266666683368,-631,0,4,0.5510954492840334,-2263760333,1241.8914402919263,1036.5946483688522,205.29679192307412,0.7234986599185265,0.7239307461872478,-631
222,2017-08-11,2017,236871,236871,291100496.8833335,3270504.383333325,170621,0,221,0.7804585618332343,29530754,2638359334,237588,237588,583837,821425,244087846.84999642,3265496.9999999856,171272,0,221,0.22813160057217466,2303773777,-717,-717,47012650.03333709,5007.383333339356,-651,0,0,0.5523269612610596,-2274243023,1228.9410560319056,1027.357639485144,201.58341654676155,0.7203118997260112,0.7208781588295705,-651
223,2017-08-12,2017,233354,233354,291178441.4666669,3216329.8833333314,165560,0,233,0.7682276712634031,29515873,2642730516,234017,234017,610252,844269,244501609.0333287,3211779.766666649,166228,0,230,0.21501440891469342,2315225525,-663,-663,46676832.433338165,4550.11666668253,-668,0,3,0.5532132623487096,-2285709652,1247.7970871151422,1044.802766608104,202.99432050703808,0.7094800174841657,0.7103244636073448,-668
224,2017-08-13,2017,231519,231519,291552295.8499998,3185590.3666666597,165399,0,224,0.7713017074192615,29735114,2649902500,231996,231996,636669,868665,245097559.6166619,3181224.7499999898,165956,0,224,0.20852112149102245,2328157270,-477,-477,46454736.23333788,4365.616666669957,-557,0,0,0.5627805859282391,-2298422156,1259.3018104345638,1056.4732134030842,202.8285970314796,0.7144078887693882,0.7153399196537872,-557
225,2017-08-14,2017,229172,229172,292088311.30000067,3190216.116666667,163266,0,162,0.7675981358979281,28575738,2658165674,229598,229598,661745,891343,245840689.2833281,3186027.1666666074,163826,0,163,0.20008459145357027,2339416073,-426,-426,46247622.01667258,4188.950000059791,-560,0,-1,0.5675135444443579,-2310840335,1274.5375146178446,1070.7440364608058,203.79347815703886,0.712416874661826,0.7135340900182058,-560
226,2017-08-15,2017,232886,232886,292382099.3500002,3234604.5333333337,166696,0,134,0.7812964282953896,29268348,2662980402,233794,233794,678403,912197,246467171.08332875,3230703.6499999603,167436,0,134,0.20296931474232263,2345914077,-908,-908,45914928.26667145,3900.883333373349,-740,0,0,0.578327113553067,-2316645729,1255.4730612832038,1054.2065710981838,201.26649018502007,0.715783688156437,0.7161689350453818,-740
227,2017-08-16,2017,242621,242621,292955929.40000063,3361690.9833333315,175444,0,124,0.7941563178785025,30125083,2670110726,243329,243329,697454,940783,247305752.2833278,3356794.483333278,176171,0,125,0.20791298312150347,2353674536,-708,-708,45650177.11667284,4896.500000053551,-727,0,-1,0.5862433347569991,-2323549453,1207.4632014541223,1016.3431086443777,191.12009280974462,0.7231195980562276,0.7240033041684304,-727
228,2017-08-17,2017,241002,241002,293598421.91666687,3351647.3000000007,173233,0,311,0.7853793744450245,29972637,2678087591,241843,241843,718730,960573,248218672.949997,3347161.59999997,174023,0,313,0.20040434199170268,2362709912,-841,-841,45379748.96666986,4485.70000003092,-790,0,-2,0.5849750324533218,-2332737275,1218.2406034666387,1026.3628591689526,191.87774429768615,0.7188031634592245,0.719570134343355,-790
229,2017-08-18,2017,241237,241237,294205437.8500004,3363666.2666666675,173918,0,368,0.787474558214535,29992225,2684533835,242342,242342,742051,984393,249118563.11666185,3359584.9499999746,174711,0,368,0.19609444601901999,2373100029,-1105,-1105,45086874.733338535,4081.316666692961,-793,0,0,0.5913801121955151,-2343107804,1219.570123364162,1027.9628092392645,191.60731412489758,0.7209424756567193,0.7209274496372895,-793
230,2017-08-19,2017,233095,233095,294349639.8666666,3216283.9166666693,170497,0,299,0.7962161350522311,28341072,2687849290,235016,235016,764989,1000005,249415247.73333204,3214394.2833333523,171221,0,301,0.18834905825470794,2381049516,-1921,-1921,44934392.13333458,1889.6333333170041,-724,0,-2,0.6078670767975232,-2352708444,1262.7883046254385,1061.2692230883515,201.519081537087,0.7314485510199704,0.7285503965687442,-724
231,2017-08-20,2017,234903,234903,294661531.9666665,3307142.500000004,172229,0,311,0.8024674014380393,29592146,2691363530,235769,235769,788821,1024590,250001204.3166638,3302036.916666615,173004,0,311,0.187346157975382,2393849392,-866,-866,44660327.65000272,5105.583333389368,-775,0,0,0.6151212434626573,-2364257246,1254.3966316593085,1060.3650366106817,194.03159504862674,0.7331919983993394,0.7337860363321725,-775
232,2017-08-21,2017,238981,238981,295369178.59999996,3319494.716666665,174138,0,293,0.7964315154761268,29378341,2701056170,239776,239776,807462,1047238,250860817.01666293,3313870.183333258,175024,0,294,0.1849331288589576,2403094413,-795,-795,44508361.58333704,5624.533333406784,-886,0,-1,0.6114983866171692,-2373716072,1235.9525594084885,1046.2298854625271,189.72267394596133,0.7286688063067776,0.7299479514213266,-886
233,2017-08-22,2017,235050,235050,295402161.3666669,3263236.249999999,172735,0,289,0.8069134226760263,29077024,2705544516,235756,235756,829033,1064789,251150003.64999828,3258627.033333269,173446,0,289,0.18087151538943508,2408175986,-706,-706,44252157.716668636,4609.216666730121,-711,0,0,0.6260419072865913,-2379098962,1256.763077501242,1065.2963387994293,191.46673870181257,0.7348861944267178,0.7357013183121532,-711
234,2017-08-23,2017,222722,222722,295314176.3500001,3253951.3833333314,171236,0,295,0.8400472337712486,29230091,2709617864,223399,223399,855742,1079141,251290742.63333118,3248687.08333333,171916,0,298,0.17590194423156896,2417139969,-677,-677,44023433.716668904,5264.300000001211,-680,0,-3,0.6641452895396796,-2387909878,1325.9317730174841,1124.8516897270408,201.08008329044333,0.7688328948195509,0.7695468645786239,-680
235,2017-08-24,2017,234114,234114,295754110.1333332,3374405.6166666616,177966,0,243,0.8320348206429357,30068077,2715314880,235066,235066,865635,1100701,251919036.09999794,3369671.5666666804,178753,0,243,0.17991080229781256,2423499905,-952,-952,43835074.03333527,4734.049999981187,-787,0,0,0.6521240183451231,-2393431828,1263.2910040977183,1071.694911641828,191.59609245589036,0.76016812322202,0.760437494150579,-787
236,2017-08-25,2017,231500,231500,296236957.4666662,3351911.2499999963,175521,0,157,0.8284276457883372,26441713,2718651972,232127,232127,878590,1110717,252632360.11666626,3347904.8,176147,0,157,0.17530027900896325,2425986832,-627,-627,43604597.349999964,4006.449999996461,-626,0,0,0.6531273667793739,-2399545119,1279.6412849532019,1088.3368161250792,191.3044688281227,0.7581900647948164,0.7588389114579519,-626
237,2017-08-26,2017,231209,231209,296196593.9833335,3341431.666666668,175821,0,158,0.8388903546142223,30099802,2721780420,246552,246552,893746,1140298,252841338.70000276,3344213.5999991694,182223,0,158,0.1787471345209734,2435984491,-15343,-15343,43355255.28333077,-2781.933332501445,-6402,0,0,0.6601432200932489,-2405884689,1281.077267681334,1025.5091773743582,255.56809030697582,0.7604418513120164,0.7390854667575197,-6402
238,2017-08-27,2017,227817,227817,296496840.2666662,3270818.349999999,172779,0,159,0.8320976924461297,29537121,2726886648,230328,230328,918119,1148447,248974454.08333367,3266877.3499991666,174429,0,159,0.16861378888184936,2401234210,-2511,-2511,47522386.1833325,3941.0000008326024,-1650,0,0,0.6634839035642803,-2371697089,1301.4693384017266,1080.9560890700811,220.5132493316455,0.7584113564834933,0.7573069709284151,-1650
239,2017-08-28,2017,231120,231120,297025904.81666726,3328402.049999999,174204,0,160,0.8246884735202484,28651764,2732876975,231948,231948,932371,1164319,248938908.8499987,3323440.8333333544,175044,0,163,0.1667120436924923,2400885391,-828,-828,48086995.966668546,4961.216666644439,-840,0,-3,0.6579764298277562,-2372233627,1285.1588128100868,1073.2530948747078,211.90571793537902,0.7537383177570094,0.7546691499818925,-840
240,2017-08-29,2017,224878,224878,297013652.1666668,3272502.933333334,168564,0,75,0.811884666352422,26557748,2732737058,225692,225692,946522,1172214,249129480.53333658,3268156.2499992703,169284,0,66,0.15819807646044684,2403689942,-814,-814,47884171.633330226,4346.683334063739,-720,0,9,0.6536865898919751,-2377132194,1320.776830844577,1103.847192338836,216.92963850574097,0.7495797721431176,0.7500664622582989,-720
241,2017-08-30,2017,223503,223503,297156608.15000033,3276832.633333339,169931,0,74,0.8235146731811217,26800364,2733867683,224371,224371,964114,1188485,249555940.06666592,3272295.183333339,170770,0,66,0.15758381468844918,2409595358,-868,-868,47600668.083334416,4537.449999999721,-839,0,8,0.6659308584926725,-2382794994,1329.5419218086572,1112.2468592940527,217.29506251460452,0.7603074679087082,0.7611054904599971,-839
242,2017-08-31,2017,225826,225826,297403489.39999974,3280678.4833333334,172292,0,75,0.8287973926828622,26961820,2736440085,227129,227129,977640,1204769,250057861.20000947,3276643.916666125,173150,0,58,0.1580452352276703,2411587791,-1303,-1303,47345628.19999027,4034.566667208448,-858,0,17,0.6707521574551919,-2384625971,1316.958584928218,1100.9508305853037,216.00775434291427,0.7629413796462763,0.7623421051472952,-858
243,2017-09-01,2017,228146,228146,297368547.9166666,3320961.616666665,175002,0,141,0.8397079063406765,26925273,2736305809,229445,229445,341585,571030,250330619.48332906,3317582.7833332475,176022,0,141,0.3416352906152082,2393459866,-1299,-1299,47037928.43333757,3378.8333334173076,-1020,0,0,0.4980726157254683,-2366534593,1303.4133752801567,1091.0266925987887,212.38668268136803,0.7670614431109903,0.7671642441543725,-1020
244,2017-09-02,2017,226053,226053,297590441.0500001,3337760.4666666696,172143,0,155,0.8339106315775515,27125317,2738264527,227225,227225,359262,586487,250829259.69999582,3334035.3999998625,173033,0,155,0.32816072649521527,2397206119,-1172,-1172,46761181.350004256,3725.066666807048,-890,0,0,0.5057499050823362,-2370080802,1316.4631349727722,1103.880557597077,212.5825773756951,0.76151610463033,0.7615051160743757,-890
245,2017-09-03,2017,224681,224681,298033282.16666675,3288734.66666666,171034,0,166,0.8346989732109076,26903169,2742266503,225610,225610,377534,603144,251542802.04999608,3284089.0499998583,171960,0,105,0.31796552730358657,2406463111,-929,-929,46490480.11667067,4645.6166668017395,-926,0,61,0.516733445907321,-2379559942,1326.4730091403667,1114.9452686050977,211.527740535269,0.7612303666086585,0.7622002570808032,-926
246,2017-09-04,2017,231913,231913,298659963.8833334,3366213.050000002,175885,0,163,0.8305700844713321,27557142,2748893881,232718,232718,395630,628348,252403843.43332735,3361221.5499999356,176682,0,163,0.31211526097003356,2415193262,-805,-805,46256120.45000604,4991.50000006659,-797,0,0,0.5184548235012985,-2387636120,1287.8103594163906,1084.590978924395,203.2193804919957,0.7584094035263224,0.7592107185520673,-797
247,2017-09-05,2017,234606,234606,299375587.8333336,3398526.916666666,176803,0,154,0.825311373110662,27666319,2754169399,235526,235526,407620,643146,253354963.53333047,3393546.1499998756,177720,0,156,0.3077559372210996,2418701513,-920,-920,46020624.30000314,4980.7666667904705,-917,0,-2,0.5175554358895624,-2391035194,1276.0781388086136,1075.698494150669,200.3796446579447,0.753616702045131,0.7545663748375976,-917
248,2017-09-06,2017,233671,233671,299647993.5166667,3416252.6333333324,177261,0,158,0.8412939560321994,27684273,2756170123,234782,234782,422708,657490,253976215.2166634,3411182.9166665636,178351,0,159,0.3075073385146541,2426359794,-1111,-1111,45671778.30000332,5069.716666768771,-1090,0,-1,0.5337866175175452,-2398675521,1282.3499429397175,1081.7533508389204,200.59659210079712,0.7585922087036903,0.759645117598453,-1090
249,2017-09-07,2017,236402,236402,300020215.6333329,3411392.1500000027,179750,0,138,0.8411054051996176,29540582,2760558541,237427,237426,439160,676587,254646737.8833295,3405796.649999861,180708,0,138,0.2997944092925225,2436054859,-1025,-1024,45373477.7500034,5595.500000141561,-958,0,0,0.5413109959070952,-2406514277,1269.1103105444663,1072.5309691580935,196.5793413863728,0.7603573573827632,0.7611097305698172,-958
250,2017-09-08,2017,239149,239149,300444306.84999996,3416881.8166666613,178878,0,143,0.8194431086895614,30759559,2767486227,240837,240837,457154,697991,255382314.16667318,3413690.7499996885,179844,0,143,0.28515124120510305,2446362968,-1688,-1688,45061992.68332678,3191.0666669728234,-966,0,0,0.5342918674844583,-2415603409,1256.305929985072,1060.3948486597706,195.91108132530144,0.7479772024971879,0.7467457242865506,-966
251,2017-09-09,2017,234741,234741,300628037.2833331,3399106.3833333384,176807,0,170,0.8265577807029884,30317059,2772593502,235649,235649,477409,713058,255720892.08333606,3394052.0666663027,177652,0,172,0.2764136998673331,2455894206,-908,-908,44907145.19999707,5054.316667035688,-845,0,-2,0.5501440808356552,-2425577147,1280.6797162972516,1085.177073033775,195.50264326347656,0.7532003356891211,0.7538839545255868,-845
252,2017-09-10,2017,229461,229461,300954995.5666665,3307494.783333332,172971,0,177,0.8306378861767354,29773453,2778330855,230087,230087,495001,725088,256304939.6166679,3302754.1499995934,173700,0,178,0.26645041705282546,2467736713,-626,-626,44650055.94999859,4740.633333738428,-729,0,-1,0.5641874691239099,-2437963260,1311.57362500236,1113.947939764819,197.6256852375409,0.753814373684417,0.7549318301338189,-729
253,2017-09-11,2017,232078,232078,300652347.91666657,3335641.8499999945,175485,0,230,0.8331897034617671,29692753,2780125126,232952,232952,515960,748912,256259116.74999368,3330968.816666659,176258,0,230,0.26242869656247597,2479853833,-874,-874,44393231.166672885,4673.0333333355375,-773,0,0,0.5707610068992912,-2450161080,1295.4797435201378,1100.0511553882075,195.42858813193038,0.7561466403536742,0.7566279748617741,-773
254,2017-09-12,2017,238027,238027,301081245.266667,3407644.800000002,181922,0,265,0.8420011175202821,30187110,2787086422,238907,238907,525788,764695,256863631.26666138,3402374.933333317,182749,0,265,0.2662839432715014,2481349413,-880,-880,44217614.00000563,5269.866666685324,-827,0,0,0.5757171742487807,-2451162303,1264.9037515351915,1075.1615953767005,189.74215615849107,0.764291445928403,0.7649378209931061,-827
255,2017-09-13,2017,235474,235474,301337827.6499998,3421570.416666666,179413,0,183,0.8393538140091895,30798420,2793598354,236113,236113,539812,775925,257316654.13332778,3416327.983333311,180066,0,183,0.2585958694461473,2488231112,-639,-639,44021173.516672015,5242.433333355002,-653,0,0,0.5807579445630422,-2457432692,1279.707431181361,1089.8029931995602,189.9044379818008,0.7619227600499419,0.7626263695772787,-653
256,2017-09-14,2017,232920,232920,301601258.70000064,3405494.266666669,176439,0,180,0.8315988322170705,29678202,2798614988,233687,233687,559406,793093,257800202.26666045,3400925.499999992,177080,0,180,0.24778809042570915,2498713964,-767,-767,43801056.43334019,4568.766666676849,-641,0,0,0.5838107417913614,-2469035762,1294.8705937661027,1103.1858950932676,191.6846986728351,0.757509015971149,0.7577657293730503,-641
257,2017-09-15,2017,237624,237624,301993583.4500003,3441857.666666668,178500,0,429,0.8265831734168262,30609626,2803868894,238538,238538,573395,811933,258489217.73333764,3436500.733332811,179353,0,429,0.24681100534157702,2506636630,-914,-914,43504365.716662645,5356.933333856985,-853,0,0,0.5797721680752492,-2476027004,1270.888392797025,1083.639578320174,187.24881447685107,0.7511867488132512,0.7518843957776119,-853
258,2017-09-16,2017,248798,248798,302368261.8500004,3509700.7333333353,189406,0,140,0.8386281240202893,30793470,2809765976,249487,249487,588874,838361,259019658.9166625,3504483.166666657,190090,0,143,0.2524270570792227,2517387160,-689,-689,43348602.93333787,5217.56666667806,-684,0,-3,0.5862010669410667,-2486593690,1215.31628811325,1038.2090406179982,177.10724749525184,0.7612842546965811,0.76192346695419,-684
259,2017-09-17,2017,243766,243766,302791306.2500001,3435653.816666666,183886,0,148,0.8315023424103437,29793898,2815277449,244628,244628,603672,848300,259625062.16667274,3430704.4499996407,184747,0,148,0.2433360839325735,2526790242,-862,-862,43166244.08332738,4949.366667025257,-861,0,0,0.5881662584777703,-2496996344,1242.1392082981224,1061.3055830349458,180.8336252631766,0.7543545859553834,0.7552160831957094,-861
260,2017-09-18,2017,243308,243308,303627938.39999974,3458472.6333333342,180242,0,142,0.8099815871241394,29687875,2824078065,244276,244276,620875,865151,260638581.89999485,3452819.983333306,181139,0,142,0.23173873693724956,2535561394,-968,-968,42989356.50000489,5652.650000028312,-897,0,0,0.5782428501868898,-2505873519,1247.915968237788,1066.9839931061376,180.93197513165046,0.740797672086409,0.7415341662709394,-897
261,2017-09-19,2017,244627,244627,304185287.2666668,3475946.1999999983,181547,0,118,0.8139207855224478,29548736,2829877210,245542,245542,634280,879822,261449659.68332547,3470211.6333333016,182394,0,118,0.22995105828224074,2541966446,-915,-915,42735627.58334136,5734.566666696686,-847,0,0,0.5839697272402071,-2512417710,1243.4657141961713,1064.7859009184801,178.6798132776912,0.7421380305526373,0.7428220019385685,-847
262,2017-09-20,2017,205880,205880,294588380.4999998,2885416.6833333317,112186,0,77,0.5837138138721584,25181267,2789978437,206046,206046,671746,877792,252059831.3833349,2882430.5333329663,113444,0,56,0.13956837155043278,2543348427,-166,-166,42528549.11666492,2986.150000365451,-1258,0,21,0.4441454423217256,-2518167160,1430.8742009908676,1223.3182463301152,207.55595466075238,0.5449096561103556,0.5505760849519039,-1258
263,2017-09-21,2017,233045,233045,294751454.5499999,3366841.516666671,177251,0,112,0.8296809629041588,28651760,2791327653,234080,234080,685703,919783,252118825.73332906,3362197.3833332933,178146,0,110,0.21337641595897888,2546570674,-1035,-1035,42632628.816670835,4644.13333337754,-895,0,2,0.61630454694518,-2517918914,1264.7834304533455,1077.062652654345,187.72077779900064,0.7605870110922783,0.7610475051264525,-895
264,2017-09-22,2017,236998,236998,294778758.0833333,3377657.4,179529,0,81,0.825395151013932,28730453,2791212414,237952,237952,688468,926420,252482050.31666094,3372629.5333333453,180399,0,75,0.21429912998424586,2510980747,-954,-954,42296707.76667237,5027.8666666545905,-870,0,6,0.6110960210296862,-2482250294,1243.8027244252412,1061.06294679877,182.7397776264711,0.7575127216263429,0.7581318921463153,-870
265,2017-09-23,2017,238385,238385,295005917.5833333,3416219.7333333297,179931,0,78,0.8234746313736182,28937718,2793455128,239220,239220,698289,937509,253073743.71666348,3410818.1833333,180781,0,71,0.21200756472738458,2514721135,-835,-835,41932173.86666983,5401.550000029616,-850,0,7,0.6114670666462336,-2485783417,1237.5187934783369,1057.9121466293097,179.60664684902713,0.7547916186001636,0.7557102248975838,-850
266,2017-09-24,2017,239842,239842,295373397.066667,3405957.633333333,181610,0,123,0.8260855062916426,29651447,2797712401,240835,240835,713613,954448,253717355.21666348,3401243.7333333096,182553,0,122,0.210727038036645,2524270850,-993,-993,41656041.85000354,4713.90000002319,-943,0,1,0.6153584682549975,-2494619403,1231.5332471654965,1053.4903781288579,178.04286903663865,0.7572068278283203,0.758000290655428,-943
267,2017-09-25,2017,237887,237887,295977040.48333335,3443856.5500000007,179847,0,79,0.8258711068700685,29650537,2804806556,238732,238732,730493,969225,254531223.29999596,3438731.766666621,180670,0,54,0.2056199540870274,2534037052,-845,-845,41445817.18333739,5124.783333379775,-823,0,25,0.6202511527830411,-2504386515,1244.1917401259143,1066.1797467452875,178.0119933806268,0.7560186138796992,0.7567900407151115,-823
268,2017-09-26,2017,237261,237261,296234725.58333355,3413252.166666667,178520,0,84,0.8201263587357387,29035889,2808272021,238175,238175,743464,981639,255068512.8999948,3407959.3333333153,179307,0,42,0.2016382804676662,2538477721,-914,-914,41166212.68333876,5292.833333351649,-787,0,42,0.6184880782680725,-2509441832,1248.5605539188216,1070.9289929673341,177.63156095148747,0.7524203303534925,0.7528371995381548,-787
269,2017-09-27,2017,237146,237146,296260066.733333,3381981.849999999,177152,0,99,0.813250065360579,29812998,2811168127,238115,238115,761523,999638,255318654.09999478,3376944.3333333335,177978,0,49,0.19575386289836932,2547816131,-969,-969,40941412.63333821,5037.516666665673,-826,0,50,0.6174962024622097,-2518003133,1249.2728814035784,1072.2493505238847,177.02353087969368,0.7470166058040195,0.7474455620183524,-826
270,2017-09-28,2017,231459,231459,296246403.9166664,3316308.199999996,174013,0,69,0.8167623639607878,29538475,2814626836,232456,232456,779319,1011775,255607158.0333316,3311365.36666656,174856,0,37,0.18916063354006218,2552994246,-997,-997,40639245.883334786,4942.833333435934,-843,0,32,0.6276017304207256,-2523455771,1279.9087696597082,1099.5937211056355,180.31504855407275,0.7518091757071447,0.7522111711463675,-843
271,2017-09-29,2017,231275,231275,296152812.59999985,3311339.133333332,173939,0,67,0.8194703275321588,29493748,2817474410,232030,232030,796014,1028044,255760046.21666622,3306582.1666665864,174648,0,50,0.1867410344304272,2559501591,-755,-755,40392766.38333362,4756.966666745488,-709,0,17,0.6327292931017315,-2530007843,1280.5223763917409,1102.271457210991,178.25091918074986,0.7520873419089829,0.7526957720984355,-709
272,2017-09-30,2017,234043,234043,296606728.89999986,3335100.3833333356,175049,0,74,0.8165935319578022,29191267,2823678502,234813,234813,810129,1044942,256363119.76666695,3329318.4499998596,175804,0,60,0.18571939878002627,2564502333,-770,-770,40243609.13333291,5781.933333476074,-755,0,14,0.6308741331777759,-2535311066,1267.3172404216314,1091.7756673040544,175.54157311757695,0.7479352084873293,0.7486979000310886,-755
273,2017-10-01,2017,223123,223123,296186600.9,3245974.000000004,169018,0,96,0.8274359882217429,28391233,2822643833,231649,231648,328965,560614,256166983.71666062,3248135.5166665902,171723,0,54,0.3381845619267447,2546450514,-8526,-8525,40019617.18333936,-2161.516666586045,-2705,0,42,0.48925142629499824,-2518059281,1327.4588496031336,1105.8458683721017,221.61298123103188,0.7575104314660523,0.7413068910291001,-2705
274,2017-10-02,2017,222572,222572,296103928.93333334,3232456.2166666724,167016,0,73,0.8160819869525362,29229505,2825878143,223421,223421,354479,577900,255020393.1666646,3227410.3833331987,167757,0,39,0.31889081155909155,2540380100,-849,-849,41083535.76666874,5045.833333473653,-741,0,34,0.49719117539344465,-2511150595,1330.3736720402087,1141.434301908346,188.9393701318627,0.7503908847474076,0.7508560072687885,-741
275,2017-10-03,2017,216926,216926,295553273.033333,3156708.600000003,163425,0,104,0.8151166757327388,28460938,2824499206,217828,217828,367174,585002,254640615.58332705,3152850.649999885,164101,0,69,0.30678185715604056,2541938234,-902,-902,40912657.45000595,3857.9500001179986,-676,0,35,0.5083348185766983,-2513477296,1362.4612680514692,1168.9985474012847,193.46272065018456,0.7533675078137245,0.7533512679728961,-676
276,2017-10-04,2017,211250,211250,295058562.7999996,3149794.2666666624,160745,0,74,0.8243550295857994,28108545,2824269050,212029,212029,385862,597891,254446313.34999543,3144709.3333331426,161437,0,62,0.2960456002849985,2547143027,-779,-779,40612249.45000416,5084.933333519846,-692,0,12,0.5283094293008009,-2519034482,1396.7269244970396,1200.054300826752,196.67262367028752,0.7609230769230769,0.7613911304585693,-692
277,2017-10-05,2017,218686,218686,294903251.91666627,3208666.6500000013,166016,0,73,0.8274375131467034,29018299,2823613970,219574,219574,398557,618131,254513841.39999473,3203815.783333189,166758,0,86,0.2967299811852174,2552225337,-888,-888,40389410.51667154,4850.86666681245,-742,0,-13,0.530707531961486,-2523207038,1348.5236911218196,1159.1255859072328,189.39810521458685,0.7591523920141207,0.7594615027280097,-742
278,2017-10-06,2017,221584,221584,294869720.3000003,3225611.5166666666,168622,0,128,0.8272573832045629,28373509,2824013956,222900,222900,410963,633863,254734256.93333066,3222464.516666536,169403,0,92,0.2930112658413519,2553387895,-1316,-1316,40135463.366669655,3147.000000130385,-781,0,36,0.5342461173632109,-2525014386,1330.7356140335057,1142.8185595932287,187.91705444027707,0.7609845476207668,0.759995513683266,-781
279,2017-10-07,2017,216699,216699,295038857.9833333,3217491.7499999963,164499,0,93,0.8262613117734741,28168611,2827324451,217320,217320,427179,644499,255048879.26666236,3214142.24999986,165177,0,70,0.2817987304867909,2554909709,-621,-621,39989978.71667093,3349.5000001364388,-678,0,23,0.5444625812866832,-2526741098,1361.514626201936,1173.60978863732,187.90483756461595,0.7591128708485041,0.7600635008282717,-678
280,2017-10-08,2017,218101,218101,295349644.0666668,3222399.1333333324,165999,0,71,0.824934319420819,28499629,2830563589,218998,218998,441478,660476,255570606.9999969,3219640.83333321,166656,0,50,0.2757420405889055,2564202859,-897,-897,39779037.06666988,2758.3000001222827,-657,0,21,0.5491922788319135,-2535703230,1354.187482252107,1166.999730591133,187.18775166097407,0.7611106780803389,0.7609932510799186,-657
281,2017-10-09,2017,220363,220363,296005141.2666663,3215992.1666666656,167488,0,60,0.8259598934485372,28512204,2838574368,221297,221297,456331,677628,256362210.5999965,3212143.149999893,168225,0,50,0.27278388732460335,2571199475,-934,-934,39642930.666669786,3849.0166667727754,-737,0,10,0.5531760061239338,-2542687271,1343.2615333185076,1158.4531674627153,184.80836585579232,0.7600550001588289,0.7601774990171579,-737
282,2017-10-10,2017,217960,217960,295782544.6833334,3190855.783333327,165421,0,61,0.8204349421912278,28083794,2838692824,218716,218716,470511,689227,256368173.31666285,3186399.1833332116,166038,0,50,0.26259418159764913,2575718494,-756,-756,39414371.36667055,4456.600000115577,-617,0,11,0.5578407605935787,-2547634700,1357.0496636232951,1172.1509780567624,184.89868556653278,0.7589511837034318,0.759148850564202,-617
283,2017-10-11,2017,223378,223378,295838953.0833332,3217159.5499999956,171276,0,99,0.8320112096983588,28775688,2841070137,223906,223906,484157,708063,256719332.89999792,3212722.4666662733,171815,0,69,0.2647024346703505,2583619225,-528,-528,39119620.183335274,4437.083333722316,-539,0,30,0.5673087750280084,-2554843537,1324.3871513010824,1146.5495917929752,177.83755950810723,0.7667541118641943,0.7673532643162756,-539
284,2017-10-12,2017,218834,218834,295621600.36666673,3192049.733333338,166940,0,201,0.822111737664165,28780759,2842474742,219438,219438,498703,718141,256657198.28332996,3187213.316666592,167363,0,201,0.2521914220187955,2588784747,-604,-604,38964402.08333677,4836.4166667461395,-423,0,0,0.5699203156453695,-2560003988,1350.8942868414722,1169.611454184462,181.2828326570102,0.7628613469570542,0.7626892334053355,-423
285,2017-10-13,2017,215852,215852,295623084.51666677,3180678.350000002,165628,0,216,0.8215304931156531,28607716,2844535867,216686,216686,514589,731275,256862583.06666276,3176832.5500000003,166160,0,216,0.2443362620081347,2594045834,-834,-834,38760501.45000401,3845.8000000016764,-532,0,0,0.5771942311075183,-2565438118,1369.5637961041211,1185.4138387651383,184.14995733898286,0.7673220539999629,0.7668238834073268,-532
286,2017-10-14,2017,212439,212439,295393451.29999995,3150875.616666664,163020,0,103,0.8243589924637196,28486939,2844007203,218714,218714,530204,748918,256891243.16666022,3151177.049999999,164951,0,103,0.23754937122622188,2599354525,-6275,-6275,38502208.13333973,-301.43333333497867,-1931,0,0,0.5868096212374977,-2570867586,1390.4859809168747,1174.5532666709046,215.93271424597015,0.7673732224309096,0.7541858317254497,-1931
287,2017-10-15,2017,207845,207845,295126705.04999983,3116013.2333333273,159573,0,65,0.8258702398421901,28422347,2843896779,208429,208429,551364,759793,256408218.99999756,3111462.7999999896,160159,0,66,0.22827270059081686,2601289011,-584,-584,38718486.05000228,4550.433333337773,-586,0,-1,0.5975975392513733,-2572866664,1419.9365154321722,1230.1945458645273,189.7419695676449,0.767750006014097,0.7684103459691309,-586
288,2017-10-16,2017,211573,211573,295367617.99999994,3144965.4333333327,162429,0,57,0.8224206302316464,28206603,2847312060,212182,212182,561336,773518,256848506.59999645,3140421.749999999,162932,0,57,0.22672516993786426,2606956621,-609,-609,38519111.40000349,4543.683333333582,-503,0,0,0.5956954602937821,-2578750018,1396.0553473269272,1210.5103477203365,185.54499960659064,0.7677208339438397,0.7678879452545456,-503
289,2017-10-17,2017,219884,219884,295707635.7833332,3223280.833333334,170258,0,59,0.8346628222153493,27997532,2850359652,220394,220394,570504,790898,257367096.7166626,3219411.2999999914,170638,0,55,0.23337901979775116,2607757313,-510,-510,38340539.0666706,3869.5333333425224,-380,0,4,0.6012838024175982,-2579759781,1344.8347118632241,1167.75908925226,177.07562261096405,0.7743082716341344,0.7742406780583864,-380
290,2017-10-18,2017,219925,219925,296007671.96666646,3261340.4500000007,168452,0,65,0.8244265090371721,28601600,2853991989,220865,220865,579101,799966,257793356.583328,3258608.866666627,168996,0,65,0.2282984526842404,2610619279,-940,-940,38214315.38333845,2731.5833333735354,-544,0,0,0.5961280563529316,-2582017679,1345.948264029403,1167.1987711195889,178.74949290981408,0.7659520291008298,0.7651551852941842,-544
291,2017-10-19,2017,221414,221414,296290020.13333315,3276205.4166666707,169012,0,62,0.8215876141526733,29447619,2857619933,222062,222062,592394,814456,258274659.94999576,3271368.4166666474,169548,0,62,0.22498575736442528,2617035367,-648,-648,38015360.18333739,4837.000000023283,-536,0,0,0.5966018567882481,-2587587748,1338.172022244904,1163.074546523024,175.09747572187985,0.7633302320539803,0.7635164953931785,-536
292,2017-10-20,2017,220499,220499,296688570.14999956,3234224.466666662,168599,0,53,0.822956113179651,28269120,2861464863,221031,221031,607768,828799,258902428.6833303,3229407.5333333006,169085,0,50,0.22049133746541277,2622781434,-532,-532,37786141.46666926,4816.933333361521,-486,0,3,0.6024647757142383,-2594512314,1345.53249742629,1171.3398965906606,174.1926008356295,0.764624782878834,0.7649831924028756,-486
293,2017-10-21,2017,210447,210447,296139182.53333384,3141180.2333333353,161742,0,76,0.8287312244888259,26917357,2858427505,210853,210853,625315,836168,258565839.38334548,3136662.666666116,162159,0,87,0.20967795945312007,2628339735,-406,-406,37573343.14998835,4517.566667219158,-417,0,-11,0.6190532650357058,-2601422378,1407.1912763466994,1226.2848495555932,180.90642679110624,0.7685640565082895,0.7690618582614428,-417
294,2017-10-22,2017,207798,207798,295537704.0499996,3121155.7833333313,158226,0,71,0.8198105852799356,27442017,2855877999,208573,208573,642829,851402,258264143.43333054,3118339.0499999933,158636,0,67,0.20128681868259699,2638547481,-775,-775,37273560.61666906,2816.733333338052,-410,0,4,0.6185237665973385,-2611105464,1422.2355559245016,1238.2434132573753,183.99214266712625,0.76144139982098,0.7605778312629151,-410
295,2017-10-23,2017,228943,228943,295998686.83333325,3211528.066666667,176128,0,58,0.8307002179581819,28952753,2862027274,229352,229352,653965,883317,258868465.48332763,3207126.4833333483,176538,0,58,0.21653607934637054,2644623739,-409,-409,37130221.35000563,4401.583333318587,-410,0,0,0.6141641386118114,-2615670986,1292.8924965311596,1128.6950429179935,164.1974536131661,0.769309391420572,0.7697251386515052,-410
296,2017-10-24,2017,219990,219990,296159937.7833337,3246839.9833333315,167254,0,86,0.8203372880585477,29058779,2865442617,220485,220485,663224,883709,259197188.63332745,3242555.116666639,167749,0,81,0.20549298468161353,2642203028,-495,-495,36962749.150006264,4284.866666692309,-495,0,5,0.6148443033769342,-2613144249,1346.2427282300728,1175.5774253728257,170.66530285724707,0.7602800127278513,0.7608181962491779,-495
297,2017-10-25,2017,224360,224360,296611401.56666654,3300280.3833333356,170696,0,54,0.8239258334819037,29357326,2869895540,225179,225179,674937,900116,259834367.36666262,3296551.89999998,171252,0,48,0.2067611285656509,2646244465,-819,-819,36777034.20000392,3728.483333355747,-556,0,6,0.6171647049162529,-2616887139,1322.0333462589879,1153.9014178349785,168.1319284240094,0.7608129791406668,0.7605149680920512,-556
298,2017-10-26,2017,226781,226781,297274133.8500004,3336512.3500000034,173040,0,61,0.826444896177369,29685781,2875844865,227748,227748,686516,914264,260767053.68332928,3333063.7999999803,173596,0,59,0.20663834516069907,2652600382,-967,-967,36507080.1666711,3448.550000023097,-556,0,2,0.6198065510166699,-2622914601,1310.8423273995634,1144.9806526657942,165.86167473376918,0.7630268849683175,0.7622284279115513,-556
299,2017-10-27,2017,230346,230346,297698797.1666665,3325978.566666667,177043,0,80,0.8322089378587004,29135965,2880684273,230769,230769,700557,931326,261378170.44999367,3321702.0166666396,177464,0,93,0.2073044240147916,2661464641,-423,-423,36320626.71667284,4276.550000027288,-421,0,-13,0.6249045138439089,-2632328676,1292.3983796838952,1132.6398712565106,159.75850842738464,0.7685959382841464,0.7690114356781024,-421
300,2017-10-28,2017,219231,219231,297288541.1833332,3220304.45,168714,0,167,0.8340152624400755,28967543,2881044727,219701,219701,717345,937046,261146409.6166612,3215557.433333298,169179,0,167,0.19671819739906488,2668825504,-470,-470,36142131.56667203,4747.016666701995,-465,0,0,0.6372970650410106,-2639857961,1356.051567448642,1188.6446107057373,167.40695674290464,0.7695718215033458,0.7700420116430967,-465
301,2017-10-29,2017,208798,208798,296428959.04999983,3081489.3833333296,159103,0,261,0.8256831961991977,28242161,2879486795,209307,209307,739898,949205,260543485.516661,3077560.716666668,159562,0,261,0.1828698753167132,2678782092,-509,-509,35885473.533338845,3928.666666661389,-459,0,0,0.6428133208824846,-2650539931,1419.692521240624,1244.7910749122627,174.90144632836132,0.7619948466939338,0.762334752301643,-459
302,2017-10-30,2017,226038,226038,296678785.05000037,3185655.883333334,173091,0,73,0.828281085481202,28178547,2883258566,227049,227049,751127,978176,260986977.46666127,3181965.066666684,173655,0,70,0.19282726216959067,2685736122,-1011,-1011,35691807.583339095,3690.8166666496545,-564,0,3,0.6354538233116114,-2657557575,1312.5172981976498,1149.4742432984126,163.04305489923718,0.7657606243198046,0.7648349034789848,-564
303,2017-10-31,2017,218184,218184,296615451.2166662,3196866.81666667,166548,0,66,0.8263392366076342,27531450,2883468031,218676,218676,760292,978968,261111473.71666232,3191891.766666677,167047,0,52,0.1854258770460357,2682123850,-492,-492,35503977.500003904,4975.0499999932945,-499,0,14,0.6409133595615986,-2654592400,1359.4738900041534,1194.056383492758,165.41750651139546,0.7633373666263338,0.7639018456529294,-499
304,2017-11-01,2017,221561,221561,297076849.8333331,3272567.783333337,167679,0,63,0.8201894737792296,29071374,2888386516,222120,222120,303669,525789,261672942.99999613,3268029.5833332,168309,0,43,0.3490088229308702,2651415040,-559,-559,35403906.83333695,4538.200000137091,-630,0,20,0.47118065084835936,-2622343666,1340.8354802213976,1178.0701557716375,162.7653244497601,0.756807380360262,0.7577390599675851,-630
305,2017-11-02,2017,225720,225720,297592198.19999987,3248506.8833333314,172093,0,61,0.8253234095339356,28970868,2893541562,226434,226434,317779,544213,262346990.06666154,3244089.916666551,172672,0,61,0.34523798586215276,2657051491,-714,-714,35245208.13333833,4416.966666780412,-579,0,0,0.4800854236717828,-2628080623,1318.413070175438,1158.6024628221094,159.81060735332858,0.762418040049619,0.7625709919888356,-579
306,2017-11-03,2017,216415,216415,297455440.65000063,3119694.0333333337,164651,0,54,0.8198461289651827,27767777,2895481680,217449,217447,338803,556252,262414231.0666626,3117461.6666665548,165212,0,50,0.3213040132889399,2662534258,-1034,-1032,35041209.58333802,2232.366666778922,-561,0,4,0.4985421156762428,-2634766481,1374.4677617078328,1206.7962816992767,167.67148000855605,0.7608114040154333,0.7597735560982115,-561
307,2017-11-04,2017,209252,209252,296947181.3000002,3098007.8666666658,158360,0,61,0.812675625561524,27288078,2894184994,209795,209795,358763,568558,262094130.6999944,3093945.016666591,158867,0,58,0.30169129622660057,2669415730,-543,-543,34853050.600005805,4062.850000074599,-507,0,3,0.5109843293349234,-2642127652,1419.088856020493,1249.2868309539997,169.80202506649334,0.756790855045591,0.7572487428203722,-507
308,2017-11-05,2017,209736,209736,297022608.6666663,3094565.2666666647,158684,0,79,0.8148243506121994,27900219,2896528273,210156,210156,374359,584515,262297544.6333298,3090464.583333203,159183,0,54,0.2948837925459532,2678421726,-420,-420,34725064.03333652,4100.6833334616385,-499,0,25,0.5199405580662462,-2650521507,1416.1737072637331,1248.1087603177155,168.0649469460177,0.7565892359919136,0.7574516073773768,-499
309,2017-11-06,2017,220404,220404,297534976.7166662,3214747.300000003,167243,0,55,0.8172537703489949,27947201,2900193144,221188,221188,386606,607794,263043586.26666033,3211760.2833332503,167775,0,48,0.2982243983981345,2683989414,-784,-784,34491390.45000589,2987.016666752752,-532,0,7,0.5190293719508604,-2656042213,1349.9527082841792,1189.2308184289398,160.7218898552394,0.7588020181121939,0.7585176411016873,-532
310,2017-11-07,2017,219272,219272,297825871.0166667,3208801.900000003,167533,0,50,0.8263435367944835,27505835,2900499280,220310,220310,394184,614494,263559857.23332965,3206357.133333238,168072,0,46,0.2969158364442956,2682325910,-1038,-1038,34266013.78333706,2444.7666667653248,-539,0,4,0.5294277003501879,-2654820075,1358.248527019714,1196.3136363911292,161.93489062858475,0.7640419205370499,0.7628886568925605,-539
311,2017-11-08,2017,216556,216556,297882710.4666665,3159806.18333333,164641,0,78,0.8171419863684217,27208508,2901305415,217863,217863,411867,629730,263771031.13332844,3157506.0333332205,165173,0,78,0.28270369841043624,2687201119,-1307,-1307,34111679.33333808,2300.1500001093373,-532,0,0,0.5344382879579854,-2659992611,1375.5458655805728,1210.7197235571366,164.8261420234362,0.7602698609135743,0.7581507644712503,-532
312,2017-11-09,2017,217980,217980,298212008.0833337,3178854.433333336,166722,0,79,0.8265345444536196,27564426,2904868400,218845,218845,425653,644498,264240838.5333253,3177046.683333261,167135,0,79,0.28120956155023397,2693818651,-865,-865,33971169.55000836,1807.7500000749715,-413,0,0,0.5453249829033857,-2666254225,1368.0705022632062,1207.433747781879,160.63675448132722,0.7648499862372695,0.7637140441865247,-413
313,2017-11-10,2017,217948,217948,298327297.63333344,3154945.4666666696,166059,0,129,0.8256464844825365,27865907,2907856814,218504,218504,440734,659238,264451268.23332638,3150890.6999999136,166354,0,129,0.2741923250783486,2700231537,-556,-556,33876029.40000707,4054.7666667560115,-295,0,0,0.551454159404188,-2672365630,1368.8003451893728,1210.2811309327353,158.5192142566375,0.7619202745609044,0.7613316003368359,-295
314,2017-11-11,2017,215506,215506,297907585.1000001,3140599.5000000014,164398,0,137,0.8297216782827387,27874519,2906514909,215876,215876,457822,673698,264167959.13333774,3136232.5666662115,164801,0,140,0.2671419538131426,2704952910,-370,-370,33739625.96666235,4366.93333378993,-403,0,-3,0.562579724469596,-2677078391,1382.3632989336727,1223.7023065710766,158.66099236259606,0.7628465100739654,0.7634058440956846,-403
315,2017-11-12,2017,211392,211392,297886987.36666644,3108052.300000001,160202,0,82,0.8174386920980922,27907103,2908090097,212173,212173,472977,685150,264312154.64999473,3104291.76666656,160672,0,82,0.25414288841859906,2711159132,-781,-781,33574832.716671705,3760.5333334412426,-470,0,0,0.5632958036794931,-2683252029,1409.16868834519,1245.7388765299766,163.4298118152135,0.7578432485619134,0.7572688325093202,-470
316,2017-11-13,2017,219034,219034,298343076.0333334,3157860.400000004,165662,0,50,0.8163024918505805,28366888,2913910087,219459,219459,486484,705943,264895056.1166618,3153301.8333332557,166036,0,51,0.25462678998163013,2717656921,-425,-425,33448019.916671634,4558.566666748375,-374,0,-1,0.5616757018689503,-2689290033,1362.085685479576,1207.0366497462478,155.04903573332808,0.7563300674781084,0.7565695642466247,-374
317,2017-11-14,2017,214225,214225,298562810.2999998,3154136.183333333,163527,0,46,0.8211506593534827,27558782,2915228744,214699,214699,499831,714530,265319340.5833271,3151003.799999885,163856,0,46,0.24723804458875157,2717493192,-474,-474,33243469.71667266,3132.3833334483206,-329,0,0,0.5739126147647312,-2689934410,1393.687992998015,1235.7735275121315,157.9144654858835,0.7633422803127553,0.7631893953860986,-329
318,2017-11-15,2017,214121,214121,298729100.9,3168592.100000003,163773,0,48,0.8225069003040333,28367102,2916811772,214536,214536,511577,726113,265643173.8833296,3164814.1833333382,164131,0,48,0.24369072031487946,2722460424,-415,-415,33085927.016670376,3777.916666664649,-358,0,0,0.5788161799891538,-2694093322,1395.1415363275903,1238.2219016077936,156.9196347197967,0.7648619238654779,0.7650510869970542,-358
319,2017-11-16,2017,221291,221291,298856342.033333,3201053.5499999984,169536,0,54,0.8309330248405948,28473900,2917613909,222684,222684,523287,745971,265967892.0333284,3198841.3666666825,169973,0,50,0.24821474293236323,2727544000,-1393,-1393,32888450.00000459,2212.1833333158866,-437,0,4,0.5827182819082316,-2699070100,1350.5128633036725,1194.3736057971314,156.13925750654107,0.7661224360683444,0.7632923784376067,-437
320,2017-11-17,2017,210581,210581,298077904.833333,3161261.03333333,164780,0,66,0.8458645366865951,28896677,2913289435,210842,210842,537424,748266,265302657.53333658,3157590.6333328946,165077,0,66,0.23908743682059538,2732189836,-261,-261,32775247.299996436,3670.4000004353,-297,0,0,0.6067770998659997,-2703293159,1415.5023712174082,1258.3008012319015,157.2015699855067,0.7825017451716917,0.7829417288775481,-297
321,2017-11-18,2017,199637,199637,297287053.70000005,3031435.166666663,156271,0,128,0.8448734453032258,28073729,2911651482,199866,199866,555441,755307,264628855.53332672,3027961.1500000237,156537,0,125,0.2242545084316689,2737775640,-229,-229,32658198.166673332,3474.0166666391306,-266,0,3,0.6206189368715569,-2709701911,1489.138054068134,1324.0313786903562,165.10667537777772,0.7827757379644054,0.783209750532857,-266
322,2017-11-19,2017,204190,204190,297368788.20000017,3068421.7666666657,160570,0,89,0.8467750624418435,28033951,2914511374,204585,204585,563427,768012,264844201.26666307,3064280.98333338,160977,0,88,0.2262868288516319,2744734611,-395,-395,32524586.933337092,4140.783333285712,-407,0,1,0.6204882335902117,-2716700660,1456.3337489593034,1294.543594430985,161.79015452831845,0.7863754346442039,0.7868465430016863,-407
323,2017-11-20,2017,205049,205049,297679754.5000002,3095808.100000001,158063,0,50,0.8323132519544113,27315009,2918691329,206169,206169,572247,778416,265286838.1499957,3092462.466666694,158437,0,50,0.220407853898168,2748497156,-1120,-1120,32392916.350004464,3345.6333333072253,-374,0,0,0.6119053980562433,-2721182147,1451.7493599090958,1286.7445549524696,165.00480495662623,0.7708547712985676,0.7684811974642163,-374
324,2017-11-21,2017,212589,212589,297927027.58333284,3110700.866666667,160604,0,79,0.8138520807755811,27306518,2921338877,214127,214127,580593,794720,265698602.01666233,3107902.2166667227,161129,0,79,0.21931372055566703,2748387585,-1538,-1538,32228425.566670507,2798.649999944493,-525,0,0,0.5945383602199141,-2721081067,1401.4225928121061,1240.8458625799751,160.576730232131,0.7554671220053719,0.7524926795780075,-525
325,2017-11-22,2017,211386,211386,297892889.13333315,3094025.600000003,158159,0,96,0.807475424105665,27814931,2921593087,212158,212158,595443,807601,265559779.03332773,3090510.9500000253,158484,0,96,0.21238829570542916,2748531574,-772,-772,32333110.100005418,3514.649999977555,-325,0,0,0.5950871284002358,-2720716643,1409.2366057039403,1251.7075907263818,157.52901497755852,0.7481999754004522,0.7470093043863536,-325
326,2017-11-23,2017,208671,208671,297977761.43333334,3072814.9999999977,156321,0,302,0.8126524529043333,27467229,2923801001,209172,209172,612023,821195,265796361.48333874,3068586.2833329495,156674,0,302,0.20757189218151478,2751666176,-501,-501,32181399.949994594,4228.716667048167,-353,0,0,0.6050805607228185,-2724198947,1427.9787868622536,1270.7071763110682,157.2716105511854,0.7491266155814655,0.7490199453081674,-353
327,2017-11-24,2017,209249,209249,298213189.6833336,3072612.8666666625,156473,0,217,0.8051460222032132,26574336,2926128785,209588,209588,626813,836401,266168748.50001416,3070821.916666249,156807,0,217,0.2026575769278168,2756831730,-339,-339,32044441.18331942,1790.9500004136935,-334,0,0,0.6024884452753964,-2730257394,1425.1594496668256,1269.9617750062703,155.19767466055532,0.7477837409019876,0.7481678340362998,-334
328,2017-11-25,2017,209584,209584,298194674.0333336,3058553.183333336,157189,0,246,0.8117842965111844,26821687,2927263437,210438,210438,640848,851286,266305868.98333132,3056139.1499999957,157685,0,246,0.20139647545008754,2759686929,-854,-854,31888805.050002277,2414.033333340194,-496,0,0,0.6103878210610969,-2732865242,1422.7931236799259,1265.483748103153,157.30937557677294,0.7500047713565922,0.7493180889383096,-496
329,2017-11-26,2017,208668,208668,298205336.2666669,3045780.700000001,156289,0,262,0.8131769126075876,26230949,2928112919,209881,209881,656326,866207,266485418.9999951,3043556.816666671,156792,0,262,0.19733620254742587,2765636239,-1213,-1213,31719917.266671777,2223.8833333300427,-503,0,0,0.6158407100601617,-2739405290,1429.0899240260455,1269.697681066867,159.39224295917847,0.7489840320509135,0.7470519008390469,-503
330,2017-11-27,2017,215372,215372,298629365.11666656,3106931.149999997,161190,0,247,0.8073797893876646,27265029,2932148609,215899,215899,669085,884984,266986085.91666144,3102325.4166666805,161585,0,247,0.1976691104019986,2771666748,-527,-527,31643279.200005114,4605.733333316632,-395,0,0,0.609710678985666,-2744401719,1386.5746945594904,1236.624930716036,149.94976384345432,0.7484259792359267,0.7484286634027948,-395
331,2017-11-28,2017,215520,215520,298662831.8166667,3119381.35,162104,0,196,0.8150890868596886,27563160,2932521379,216079,216079,679701,895780,267214259.91666156,3115242.733333389,162502,0,196,0.19775168010002542,2770161342,-559,-559,31448571.90000516,4138.616666611284,-398,0,0,0.6173374067596632,-2742598182,1385.7778016734721,1236.6507616041426,149.1270400693295,0.7521529324424647,0.7520490191087519,-398
332,2017-11-29,2017,214832,214832,298785653.84999985,3090191.050000002,162179,0,140,0.8111454531913317,26865568,2934588733,215430,215430,695191,910621,267482408.14999437,3086622.5000000033,162587,0,140,0.1926586362493295,2773452406,-598,-598,31303245.70000547,3568.5499999988824,-408,0,0,0.6184868169420021,-2746586838,1390.7874704420192,1241.6209819894832,149.166488452536,0.7549108140314292,0.7547091862786056,-408
333,2017-11-30,2017,211011,211011,298797392.6833331,3066045.4000000022,159478,0,115,0.8110240698352236,26577368,2936644414,211505,211505,710581,922086,267624376.53332698,3062689.2666666843,159732,0,115,0.1862624527430199,2776822716,-494,-494,31173016.150006115,3356.1333333179355,-254,0,0,0.6247616170922037,-2750245348,1416.0275657825093,1265.3335691039313,150.69399667857806,0.7557805043338973,0.7552161887425829,-254
334,2017-12-01,2017,207967,207967,298708883.10000026,3046942.066666669,157215,0,124,0.8106093755259253,26633130,2937972744,208247,208247,298587,506834,267692803.59999618,3043006.033333217,157557,0,124,0.3343126151757767,2741771605,-280,-280,31016079.500004083,3936.0333334524184,-342,0,0,0.47629676035014856,-2715138475,1436.3282785249596,1285.4581511378133,150.87012738714634,0.7559612823188294,0.7565871297065504,-342
335,2017-12-02,2017,204332,204332,298469699.81666696,3028844.8333333363,155258,0,109,0.8207867588042986,26314033,2936298834,204774,204774,316877,521651,267646721.61666793,3025537.6833332377,155556,0,109,0.323258270376167,2746054958,-442,-442,30822978.199999034,3307.150000098627,-298,0,0,0.49752848842813163,-2719740925,1460.7095306494673,1307.0346900322693,153.67484061719802,0.7598320380557132,0.759647220838583,-298
336,2017-12-03,2017,201739,201739,298592947.50000006,3000580.9999999967,152985,0,98,0.8170408299832949,26680210,2939798317,202034,202034,331548,533582,267892692.4333349,2997418.083333287,153259,0,98,0.3101622618454182,2752215274,-295,-295,30700255.066665173,3162.916666709818,-274,0,0,0.5068785681378767,-2725535064,1480.0953087900707,1325.9782632296292,154.1170455604415,0.7583313092659327,0.7585802389696784,-274
337,2017-12-04,2017,202727,202727,298912203.0666666,3024846.1333333384,153682,0,106,0.8131526634340759,27022926,2944586535,202949,202949,346241,549190,268303323.8666702,3021384.9666665792,153844,0,104,0.30095777417651265,2757815356,-222,-222,30608879.19999641,3461.166666759178,-162,0,2,0.5121948892575632,-2730792430,1474.4567969074992,1322.0233845284786,152.43341237902064,0.7580736655699537,0.7580426609640846,-162
338,2017-12-05,2017,209250,209250,298964723.1333334,3027467.0999999987,158025,0,84,0.8097443249701317,26606450,2945294234,209700,209700,358567,568267,268479025.2166677,3024014.6999998926,158302,0,84,0.299537013410948,2758999284,-450,-450,30485697.916665673,3452.4000001060776,-277,0,0,0.5102073115591836,-2732392834,1428.74419657507,1280.3005494357067,148.4436471393633,0.7551971326164875,0.754897472579876,-277
339,2017-12-06,2017,208300,208300,299071922.21666676,3055120.066666669,157771,0,100,0.8148679788766204,26371341,2946190259,208786,208786,371849,580635,268637594.8166709,3051586.1499999156,158159,0,100,0.29425887175248444,2761303275,-486,-486,30434327.399995863,3533.91666675359,-388,0,0,0.520609107124136,-2734931934,1435.7749506321015,1286.6647898646024,149.1101607674991,0.7574219875180028,0.7575172664833849,-388
340,2017-12-07,2017,208373,208373,299118736.3166665,3028320.733333329,159529,0,114,0.8262346849159916,26153130,2947242423,209226,209226,385775,595001,268887208.51667064,3026007.0666666436,159872,0,114,0.29076925921133295,2765262316,-853,-853,30231527.79999584,2313.6666666856036,-343,0,0,0.5354654257046587,-2739109186,1435.4966157643576,1285.151981668964,150.34463409539353,0.7655934310107355,0.7641115348952807,-343
341,2017-12-08,2017,203883,203883,299033793.3166666,2993459.166666669,153537,0,113,0.8129123075489385,26153849,2949531121,204398,204398,402323,606721,268913468.4333414,2990072.6999998707,153884,0,113,0.27491219193005295,2769852208,-515,-515,30120324.88332522,3386.4666667981073,-347,0,0,0.5380001156188856,-2743698359,1466.6931196650364,1315.6364956278505,151.05662403718588,0.7530642574417681,0.7528645094374701,-347
342,2017-12-09,2017,209095,209095,298998091.28333324,3029929.9999999986,157864,0,149,0.8172170544489342,26579688,2951500555,209266,209266,417586,626852,269014052.2000114,3026212.966666544,158128,0,149,0.27382221002724655,2774460915,-171,-171,29984039.08332187,3717.0333334547468,-264,0,0,0.5433948444216876,-2747881227,1429.962893820193,1285.512468341782,144.4504254784108,0.7549869676462851,0.7556315885045827,-264
343,2017-12-10,2017,200926,200926,299075196.4,2988255.8833333277,152223,0,128,0.818818868638206,26230899,2954006826,201171,201171,431505,632676,269152048.7000023,2984613.0666665863,152510,0,127,0.2613391372519307,2780408595,-245,-245,29923147.699997663,3642.81666674139,-287,0,1,0.5574797313862753,-2754177696,1488.484299692424,1337.9266827723793,150.55761692004467,0.7576072783014642,0.7581112585810083,-287
344,2017-12-11,2017,200697,200697,299177555.0499999,2977017.6833333373,154099,0,154,0.8281339531731908,26076684,2956390199,201088,201088,447235,648323,269394919.5333382,2974264.4333332703,154371,0,151,0.25738405085120364,2787482247,-391,-391,29782635.516661704,2753.250000067055,-272,0,3,0.5707499023219872,-2761405563,1490.692711151636,1339.6867020077686,151.00600914386746,0.7678191502613392,0.76767882718014,-272
345,2017-12-12,2017,205013,205013,299217333.8833335,3016092.2833333337,155697,0,103,0.8166213849853412,25774524,2958484917,205571,205571,457102,662673,269496119.5166698,3013588.183333025,155971,0,103,0.2537812767382934,2786558383,-558,-558,29721214.366663694,2504.1000003088266,-274,0,0,0.5628401082470478,-2760783859,1459.5041967257368,1310.9637036190406,148.5404931066962,0.7594494007697072,0.7587208312456524,-274
346,2017-12-13,2017,202494,202494,299520316.98333347,2994164.433333336,152847,0,127,0.8091103933943723,26041469,2961721366,203266,203266,469963,673229,269972669.95001006,2990625.949999933,153146,0,127,0.2447889202633874,2789582260,-772,-772,29547647.033323407,3538.483333402779,-299,0,0,0.5643214731309849,-2763540791,1479.1565033202637,1328.1742640186262,150.9822393016375,0.7548223651071143,0.7534265445278601,-299
347,2017-12-14,2017,203293,203293,299558465.1833335,3000025.9166666656,154120,0,137,0.8132055702852526,26336465,2962180836,204068,204068,486111,690179,270121887.683346,2997568.0666666236,154480,0,137,0.24088243774441143,2795958737,-775,-775,29436577.499987543,2457.8500000420026,-360,0,0,0.5723231325408412,-2769622272,1473.5306438654234,1323.685671851275,149.84497201414842,0.7581175938177901,0.7570025677715272,-360
348,2017-12-15,2017,207118,207118,299678528.03333294,3003423.066666662,158698,0,87,0.82622949236667,26720990,2964438944,208298,208298,499170,707468,270347105.2166785,3000625.4166666074,159166,0,87,0.24353044943375723,2801719422,-1180,-1180,29331422.816654444,2797.650000054855,-468,0,0,0.5826990429329127,-2774998432,1446.897556143517,1297.8862265440787,149.01132959943834,0.7662202222887436,0.7641263958367339,-468
349,2017-12-16,2017,193909,193909,299313431.3833333,2916707.150000005,146405,0,80,0.8098283215322649,26429075,2964701038,194330,194330,516984,711314,270122620.9000019,2913145.0166666247,146661,0,80,0.22156178565303036,2803561711,-421,-421,29190810.483331442,3562.133333380334,-256,0,0,0.5882665358792345,-2777132636,1543.576787995056,1390.0201765038948,153.55661149116122,0.7550191069006595,0.7547007667369938,-256
350,2017-12-17,2017,192904,192904,299280190.86666703,2902500.2333333343,145874,0,92,0.8089256832414046,26267062,2966556916,193160,193160,533017,726177,270203902.9833403,2899516.6833332554,146148,0,92,0.2159225643334933,2810226830,-256,-256,29076287.88332671,2983.550000078976,-274,0,0,0.5930031189079112,-2783959768,1551.446267919105,1398.8605455753795,152.58572234372537,0.7561999751171568,0.7566162766618347,-274
351,2017-12-18,2017,196647,196647,299697086.63333315,2969556.4500000016,149697,0,103,0.8161121196865438,26311104,2972048519,196923,196923,543741,740664,270712790.03333014,2965861.6500000227,149915,0,103,0.2174521780456479,2815279381,-276,-276,28984296.600003004,3694.799999978859,-218,0,0,0.598659941640896,-2788968277,1524.0358949454258,1374.7139238856312,149.32197105979458,0.7612473111717951,0.7612874067528933,-218
352,2017-12-19,2017,197637,197637,299930263.7000003,2975822.5333333313,150129,0,122,0.8119380480375641,25704276,2974570544,197886,197886,552758,750644,271071729.6833351,2972258.966666264,150353,0,122,0.21446517923276912,2815415846,-249,-249,28858534.01666516,3563.5666670673527,-224,0,0,0.597472868804795,-2789711570,1517.5815444476505,1369.837834325496,147.74371012215443,0.7596199092275232,0.7597960441870572,-224
353,2017-12-20,2017,202952,202952,300158798.81666684,3016008.8000000007,154848,0,114,0.8171735188616029,25563572,2975586678,203577,203577,564291,767868,271436963.5333268,3013493.233333363,155131,0,114,0.21695265332061817,2817415901,-625,-625,28721835.283340037,2515.5666666375473,-283,0,0,0.6002208655409847,-2791852329,1478.9644783824099,1333.338066349965,145.62641203244493,0.7629784382514092,0.7620261620910024,-283
354,2017-12-21,2017,206915,206915,300665074.2666667,3078000.250000002,158407,0,105,0.8227146412778191,26033366,2979344231,207544,207544,575415,782959,272015700.48332715,3075557.4000000264,158711,0,105,0.218344766456481,2820623598,-629,-629,28649373.78333956,2442.849999975413,-304,0,0,0.6043698748213382,-2794590232,1453.0849588800556,1310.641119393127,142.4438394869287,0.7655655704033058,0.76471013375477,-304
355,2017-12-22,2017,206626,206626,301154775.3999998,3086921.4499999983,157873,0,102,0.8229070881689624,25637126,2982464923,206951,206951,587910,794861,272598796.2999954,3082766.016666682,158192,0,102,0.21511308266476803,2824818059,-325,-325,28555979.100004375,4155.433333316352,-319,0,0,0.6077940055041944,-2799180933,1457.487322021429,1317.2142019125079,140.27312010892115,0.7640519586112106,0.7643935037762563,-319
356,2017-12-23,2017,208068,208068,301228539.7000001,3068562.166666668,157696,0,129,0.8196695311148275,25488737,2982334687,208432,208432,600341,808773,272799585.8166623,3066386.5999999996,158069,0,129,0.2119655329740233,2832413509,-364,-364,28428953.883337796,2175.566666668281,-373,0,0,0.6077039981408042,-2806924772,1447.7408332852726,1308.8181556414672,138.9226776438054,0.7579060691696945,0.758372035004222,-373
357,2017-12-24,2017,197011,197011,300904876.93333334,2974997.9833333334,149135,0,65,0.8178274309556322,25164083,2979737793,197160,197160,617282,814442,272606823.29999536,2971287.6166666565,149380,0,65,0.19875694033460892,2839195557,-149,-149,28298053.633337975,3710.3666666769423,-245,0,0,0.6190704906210233,-2814031474,1527.3506399811854,1382.6680021302261,144.68263785095928,0.7569881884767855,0.7576587543112193,-245
358,2017-12-25,2017,193273,193273,300656500.51666605,2941361.716666671,146791,0,113,0.8185313002850886,25482237,2978191927,193517,193517,635741,829258,272437929.69999814,2938062.0166666927,147090,0,113,0.19183052801420317,2846164172,-244,-244,28218570.816667914,3299.6999999783,-299,0,0,0.6267007722708854,-2820681935,1555.6052863910948,1407.8242722861462,147.78101410494855,0.759500809735452,0.7600882609796555,-299
359,2017-12-26,2017,197750,197750,300975893.8500003,2967346.8499999978,150909,0,309,0.8233072060682673,26379612,2981661476,198156,198156,646038,844194,272832648.4499953,2963819.3666667314,151268,0,309,0.19397792450550677,2851238332,-406,-406,28143245.400005043,3527.48333326634,-359,0,0,0.6293292815627606,-2824858720,1522.0019916561332,1376.8578718282326,145.14411982790057,0.7631302149178255,0.7633783483719897,-359
360,2017-12-27,2017,200142,200142,301423864.91666627,3002434.283333335,152792,0,328,0.8231905347203488,26975447,2986660795,201117,201117,654976,856093,273386289.08332855,2998779.36666663,153237,0,328,0.19392869699904478,2850741762,-975,-975,28037575.833337724,3654.9166667051613,-445,0,0,0.629261837721304,-2823766315,1506.050029062697,1359.3395341185903,146.71049494410659,0.7634179732390003,0.7619296230552365,-445
361,2017-12-28,2017,202940,202940,302039007.6833332,3047146.0833333344,154156,0,93,0.8162757465260666,27071043,2993308046,203422,203422,664429,867851,274100680.54999995,3042650.266666326,154526,0,87,0.19200185285262225,2853751388,-482,-482,27938327.133333266,4495.816667008214,-370,0,6,0.6242738936734443,-2826680345,1488.316781725304,1347.4485579239215,140.86822380138256,0.7596136789198777,0.7596326847636932,-370
362,2017-12-29,2017,205599,205599,302677757.9500003,3029951.416666665,156010,0,113,0.812776326733106,27189957,2999414209,205895,205895,676168,882063,274786909.51666915,3026377.883332888,156326,0,113,0.1905158701816085,2858949964,-296,-296,27890848.433331132,3573.5333337769844,-316,0,0,0.6222604565514974,-2831760007,1472.1752437998252,1334.5972923901463,137.57795140967892,0.7588071926419876,0.7592510745768474,-316
363,2017-12-30,2017,198551,198551,303128376.6833332,2973024.483333334,150856,0,89,0.8125116468816578,26904707,3005282451,198811,198811,691649,890460,275292414.2166674,2969630.149999553,151115,0,89,0.18205871122791026,2866956000,-260,-260,27835962.466665804,3394.333333780989,-259,0,0,0.6304529356537475,-2840051293,1526.7028455325494,1384.6940773733215,142.00876815922788,0.7597846397147332,0.7600937573876697,-259
364,2017-12-31,2017,193155,193155,303220611.8666668,2933067.7666666666,146647,0,104,0.8124200771401205,27639579,3008951319,193936,193935,708165,902101,275503645.9166643,2930144.850000024,147008,0,103,0.17500811993335422,2878053353,-781,-780,27716965.95000249,2922.9166666427627,-361,0,1,0.6374119572067664,-2850413774,1569.8305084862768,1420.5978596780587,149.23264880821807,0.7592192798529678,0.7580232654071446,-361
365,2018-01-01,2018,194471,194471,303474488.7333334,2939072.783333333,146530,0,129,0.801919052198015,27761805,3014635440,194517,194517,287849,482366,275832610.6833452,2935570.2166666053,146786,0,125,0.32459999253678073,2857334440,-46,-46,27641878.04998821,3502.5666667278856,-256,0,4,0.4773190596612342,-2829572635,1560.512820591931,1418.0385811180781,142.47423947385278,0.7534799533092338,0.7546178483114586,-256
366,2018-01-02,2018,202124,202124,303942653.9999997,2990570.683333332,153192,0,150,0.8112891096554605,28648183,3022277227,202347,202347,301717,504064,276356295.6166748,2986621.7666665916,153521,0,150,0.3266053517013701,2865392274,-223,-223,27586358.38332492,3948.9166667405516,-329,0,0,0.4846837579540904,-2836744091,1503.7435138825656,1365.7543507770058,137.98916310555978,0.7579109853357345,0.7587016362980424,-329
367,2018-01-03,2018,199100,199100,304297732.95,2979455.1166666728,150009,0,109,0.810080361627322,27772287,3027857744,199270,199270,312689,511959,276761456.2999978,2975609.116666466,150253,0,109,0.3165155803492015,2865459169,-170,-170,27536276.65000218,3846.0000002067536,-244,0,0,0.4935647812781205,-2837686882,1528.3663131592164,1388.8766813870518,139.48963177216456,0.7534354595680562,0.7540171626436494,-244
368,2018-01-04,2018,196538,196538,304531621.0499997,2958989.116666668,136316,0,120,0.7384373505378101,27778058,3032756854,196482,196482,329358,525840,277067244.86666495,2955165.449999841,136500,0,121,0.27696827932450746,2871891393,56,56,27464376.183334768,3823.6666668271646,-184,0,-1,0.46146907121330266,-2844113335,1549.4795970753732,1410.1405974423353,139.33899963303793,0.6935859731960231,0.6947201270345376,-184
369,2018-01-05,2018,199260,199260,305048122.54999995,2958627.7666666647,149959,0,118,0.8035531466425774,27913476,3040136686,199667,199667,344700,544367,277648865.2000098,2955654.233333172,150250,0,118,0.2953173135035782,2877793962,-407,-407,27399257.34999013,2973.533333492931,-291,0,0,0.5082358331389991,-2849880486,1530.9049611060923,1390.5596077469477,140.3453533591446,0.7525795443139617,0.7525029173574,-291
370,2018-01-06,2018,194946,194946,305355360.8499998,2945711.3666666625,147378,0,116,0.8071055574364184,28569039,3047118261,195528,195528,361957,557485,278023647.6500063,2942723.7166666016,147771,0,116,0.2843574266572195,2886347566,-582,-582,27331713.19999349,2987.6500000609085,-393,0,0,0.5227481307791989,-2857778527,1566.3586883034266,1421.9121949286357,144.44649337479086,0.7559939675602475,0.7557536516509145,-393
371,2018-01-07,2018,198763,198763,305659019.8666667,2969948.0500000003,150348,0,65,0.8133606355307569,27918778,3051799657,199131,199131,376375,575506,278476897.38334227,2966420.2333332626,150732,0,64,0.2827546541652117,2895398293,-368,-368,27182122.48332441,3527.8166667376645,-384,0,1,0.5306059813655452,-2867479515,1537.8064321159707,1398.4607990887519,139.3456330272188,0.7564184481015078,0.7569489431580216,-384
372,2018-01-08,2018,195876,195876,306112143.8833332,2946329.949999997,146585,0,152,0.8002818109416158,27822588,3058450858,196192,196192,390804,586996,278995025.8500079,2942447.733333232,146874,0,152,0.268483941968938,2903439641,-316,-316,27117118.033325315,3882.2166667650454,-289,0,0,0.5317978689726778,-2875617053,1562.7853534038534,1422.0509799074778,140.7343734963756,0.7483561028405726,0.7486237970967216,-289
373,2018-01-09,2018,190534,190534,306059807.64999986,2912508.350000003,142493,0,92,0.7988600459760469,25932442,3060353341,190859,190859,407635,598494,279064359.4833397,2909597.2999999225,142686,0,90,0.2554110818153536,2906797474,-325,-325,26995448.16666013,2911.050000080373,-193,0,2,0.5434489641606932,-2880865032,1606.3264700788304,1462.1493326662076,144.17713741262287,0.7478612741033096,0.7475990128838567,-193
374,2018-01-10,2018,194922,194922,306403243.3833332,2944602.0666666725,145852,0,91,0.7977190876350548,26494173,3064515576,195106,195106,421100,616206,279465281.9000105,2941458.9333332605,146032,0,91,0.25313612655507933,2910979673,-184,-184,26937961.48332268,3143.133333411999,-180,0,0,0.5445829610799755,-2884485500,1571.927454999093,1432.3766665300427,139.5507884690503,0.7482582776700424,0.7484751878466065,-180
375,2018-01-11,2018,200604,200604,306770002.26666635,2956767.0500000035,151340,0,112,0.8069878965524119,27315488,3069793168,200951,200951,434605,635556,279915899.31667644,2953131.383333262,151643,0,112,0.2559664293941048,2917053458,-347,-347,26854102.949989915,3635.666666741483,-303,0,0,0.5510214671583071,-2889737970,1529.2317315041892,1392.9559908469053,136.2757406572839,0.7544216466271859,0.7546267498046787,-303
376,2018-01-12,2018,201395,201395,306914621.79999983,2936437.8833333305,151238,0,87,0.8020705578589336,27299248,3073097434,201859,201859,447977,649836,280254461.1833444,2932737.2166665304,151590,0,87,0.24984611501979131,2922746988,-464,-464,26660160.61665541,3700.6666668001562,-352,0,0,0.5522244428391423,-2895447740,1523.9436023734445,1388.367430648841,135.57617172460346,0.7509521090394499,0.7509697363010814,-352
377,2018-01-13,2018,195502,195502,306840379.8333336,2922769.783333331,146010,0,96,0.7944829208908354,25311592,3072436207,195665,195665,466423,662088,280292594.0666764,2919395.1166665563,146229,0,93,0.2354369811867916,2927038128,-163,-163,26547785.766657233,3374.666666774545,-219,0,3,0.5590459397040438,-2901726536,1569.4999531121605,1432.5126827315892,136.98727038057132,0.7468465795746335,0.7473436741369177,-219
378,2018-01-14,2018,192016,192016,306676741.3499997,2733454.633333331,144288,0,117,0.7958972168985926,23011270,3069905244,192848,192848,481507,674355,280212068.966676,2731387.666666628,144597,0,114,0.2274855232036521,2929163709,-832,-832,26464672.38332373,2066.9666667031124,-309,0,3,0.5684116936949405,-2906152439,1597.1415993979654,1453.0203526439268,144.12124675403857,0.7514373802183152,0.749797768190492,-309
379,2018-01-15,2018,202802,202802,307478480.3,3021094.099999999,153047,0,107,0.8063184781215188,26956043,3076376568,203080,203080,496003,699083,281045185.0833421,3017693.7666666303,153286,0,107,0.23485766353923218,2935979022,-278,-278,26433295.216657937,3400.333333368879,-239,0,0,0.5714608145822866,-2909022979,1516.151124249268,1383.9136551277431,132.23746912152478,0.7546621828187099,0.7548059877880638,-239
380,2018-01-16,2018,205053,205053,307867249.3166665,3039122.0666666646,153531,0,98,0.8018365983428659,27048223,3078738703,205385,205385,501287,706672,281480794.0833438,3035294.466666515,153830,0,98,0.2337166323273014,2933396868,-332,-332,26386455.23332268,3827.6000001495704,-299,0,0,0.5681199660155645,-2906348645,1501.4032924008256,1370.5031724972312,130.9001199035945,0.7487381311173209,0.7489836161355503,-299
381,2018-01-17,2018,201667,201667,308185729.6166667,2978274.2833333323,151641,0,114,0.8044895793560676,28066622,3083524724,202083,202083,517008,719091,281876070.2500084,2974386.4166665655,151975,0,114,0.22665837842499134,2939552402,-416,-416,26309659.36665827,3887.866666766815,-334,0,0,0.5778312009310762,-2911485780,1528.1911746426865,1394.8529576956419,133.33821694704466,0.7519376001031404,0.7520424775958393,-334
382,2018-01-18,2018,199011,199011,308608178.03333306,2965974.0499999975,149400,0,144,0.8012923908728663,26706874,3088580680,199283,199283,533733,733016,282397575.566677,2962312.266666538,149681,0,144,0.21850000545691226,2944319233,-272,-272,26210602.46665609,3661.7833334594034,-281,0,0,0.582792385415954,-2917612359,1550.7091468980764,1417.068066853053,133.64108004502327,0.7507122721859596,0.7510976852014472,-281
383,2018-01-19,2018,200488,200488,308709170.0499999,2972965.7166666673,151726,0,171,0.8103876541239368,27455938,3091470645,200845,200845,548177,749022,282624280.5000079,2969547.2333329413,152066,0,171,0.21823257527815806,2952599342,-357,-357,26084889.549991965,3418.483333725948,-340,0,0,0.5921550788457787,-2925143404,1539.7887656617847,1407.1760835470534,132.61268211473134,0.7567834483859384,0.757131121013717,-340
384,2018-01-20,2018,198007,198007,308779114.15,2964995.3000000026,150114,0,208,0.813597499078315,26788997,3093064097,198310,198310,562743,761053,282863117.58333063,2961291.316666688,150448,0,208,0.212818292549931,2958029476,-303,-303,25915996.566669345,3703.983333314769,-334,0,0,0.600779206528384,-2931240479,1559.4353439524864,1426.3684009042945,133.0669430481919,0.7581247127626801,0.7586505975492915,-334
385,2018-01-21,2018,198690,198690,308852474.1499998,2979423.3333333316,150184,0,171,0.8124817554985159,28073974,3097141556,198900,198900,576135,775035,282991002.3999986,2975831.1333332965,150411,0,171,0.20916861819143673,2966705032,-210,-210,25861471.750001192,3592.200000035111,-227,0,0,0.6033131373070791,-2938631058,1554.4439788112124,1422.780303670179,131.66367514103354,0.7558709547536363,0.7562141779788839,-227
386,2018-01-22,2018,200114,200114,309309557.10000014,3003089.8500000024,153259,0,187,0.8178338347142119,28249378,3104956286,200460,200460,588613,789073,283545099.4166627,2999124.8000000287,153526,0,187,0.20836855398676613,2974165250,-346,-346,25764457.68333745,3965.0499999737367,-267,0,0,0.6094652807274458,-2945915872,1545.6667554493945,1414.472210998018,131.1945444513765,0.7658584606774139,0.765868502444378,-267
387,2018-01-23,2018,186878,186878,309122049.9500001,2831827.0333333365,145910,0,167,0.8295251447468406,24200537,3103759507,187298,187298,603627,790925,283416133.5999969,2828114.633333371,146082,0,167,0.19659891898726264,2970553071,-420,-420,25705916.350003183,3712.399999965448,-172,0,0,0.6329262257595779,-2946352534,1654.138261058017,1513.1829149269984,140.9553461310186,0.7807767634499513,0.7799442599493854,-172
388,2018-01-24,2018,192644,192644,309771968.8333335,2969015.3833333333,147735,0,207,0.8173418326031447,28916408,3113147326,192862,192862,610552,803414,284100679.89999616,2965340.883333323,147956,0,207,0.19665701618343917,2978799627,-218,-218,25671288.93333733,3674.5000000102445,-221,0,0,0.6206848164197056,-2949883219,1608.0021637493692,1473.0775367879426,134.9246269614266,0.7668808787192957,0.7671599381941492,-221
389,2018-01-25,2018,188302,188302,310048037.1666667,2935978.9333333317,144664,0,203,0.8174050195961811,27575964,3117933875,188618,188618,624896,813514,284500583.09999996,2932065.2999996967,144879,0,203,0.1898307834899006,2986624313,-316,-316,25547454.066666722,3913.633333635051,-215,0,0,0.6275742361062805,-2959048349,1646.5467024602324,1508.342698469923,138.20400399030927,0.7682552495459422,0.7681080278658452,-215
390,2018-01-26,2018,190252,190252,310187094.2333332,2924842.9166666702,145691,0,179,0.8146984000168194,28107686,3121888185,190873,190873,638161,829034,284690021.299997,2921057.2666666936,146038,0,179,0.1878306559200222,2996103143,-621,-621,25497072.9333362,3785.649999976624,-347,0,0,0.6268677440967971,-2967995457,1630.4012269691418,1491.5154123422221,138.88581462691968,0.765779071967706,0.7651055937717749,-347
391,2018-01-27,2018,186121,186121,310241540.2833331,2913894.8499999973,142982,0,179,0.8156790475013566,28799135,3125646046,186686,186686,651467,838153,284852740.36666757,2910995.5166663732,143270,0,179,0.18180690160388294,3003259221,-565,-565,25388799.916665554,2899.333333624061,-288,0,0,0.6338721458974736,-2974460086,1666.8809015819447,1525.8387900896028,141.04211149234197,0.7682206736477882,0.7674383724542815,-288
392,2018-01-28,2018,182216,182216,310388258.6166661,2861467.500000003,139012,0,133,0.8112295297888226,28258099,3131075871,182557,182557,664263,846820,285081029.31666285,2858335.5666666934,139281,0,133,0.17523912992135499,3010641585,-341,-341,25307229.30000323,3131.9333333093673,-269,0,0,0.6359903998674676,-2982383486,1703.4083648892856,1561.6000992383904,141.80826565089524,0.7628967818413311,0.7629452718876844,-269
393,2018-01-29,2018,184836,184836,311017520.3166672,2898478.216666664,142278,0,161,0.8192559890930343,27597407,3139927030,185100,185100,677276,862376,285754868.91666555,2894976.4166666605,142487,0,161,0.17618185107192277,3020243917,-264,-264,25262651.400001645,3501.800000003539,-209,0,0,0.6430741380211116,-2992646510,1682.6674474489125,1543.7864339095925,138.88101353932007,0.7697526455885217,0.7697839005942734,-209
394,2018-01-30,2018,188285,188285,311535790.6833335,2928242.1,143616,0,160,0.81257667897071,28720726,3147236848,188628,188628,683101,871729,286367810.3666742,2924439.149999596,143878,0,160,0.17632199915340097,3022805036,-343,-343,25167980.31665933,3802.9500004039146,-262,0,0,0.636254679817309,-2994084310,1654.5969709925566,1518.161727668608,136.43524332394873,0.7627585840613963,0.762760565769663,-262
395,2018-01-31,2018,188447,188447,312102330.61666656,2919269.533333332,143014,0,68,0.8087950458219022,28258286,3155179036,188915,188915,694785,883700,286939215.9333369,2915991.149999613,143302,0,68,0.17313341631775891,3028996304,-468,-468,25163114.68332964,3278.38333371887,-288,0,0,0.6356616295041433,-3000738018,1656.1809453940182,1518.8800038818354,137.30094151218282,0.7589083402760458,0.7585527882910303,-288
396,2018-02-01,2018,187941,187941,312537117.24999976,2909633.2166666663,144284,0,156,0.8165807354435702,27694657,3161098483,189195,189195,249092,438287,287440813.4500001,2907654.566666468,144681,0,156,0.3517740658518227,3007406598,-1254,-1254,25096303.799999654,1978.6500001982786,-397,0,0,0.46480666959174755,-2979711941,1662.9533590328867,1519.2833502471,143.67000878578665,0.767709015063238,0.7647189407753905,-397
397,2018-02-02,2018,188095,188095,312723607.5166664,2881031.1833333294,142817,0,181,0.8084797575693146,27839877,3166136977,188324,188324,263110,451434,287690904.7166716,2877055.31666663,143048,0,181,0.3379541638423367,3015544427,-229,-229,25032702.799994826,3975.866666699294,-231,0,0,0.4705255937269779,-2987704550,1662.5833090548203,1527.638031884792,134.94527717002825,0.759281214280018,0.7595845457827999,-231
398,2018-02-03,2018,173167,173167,311832183.5666672,2689807.3333333363,134276,0,146,0.8195037160659944,23666921,3160794434,173310,173310,283795,457105,286887670.5000073,2686665.149999993,134389,0,146,0.3109810656194919,3019442853,-143,-143,24944513.066659927,3142.1833333433606,-113,0,0,0.5085226504465025,-2995775932,1800.75986513982,1655.3440107322558,145.4158544075642,0.7754133293294911,0.7754255380531995,-113
399,2018-02-04,2018,172624,172624,311744775.1500002,2678918.933333335,134030,0,160,0.8224117156362949,23481388,3160299850,172999,172999,295046,468045,286856349.9500018,2675161.0999999754,134217,0,160,0.304075462829427,3023618065,-375,-375,24888425.19999844,3757.8333333595656,-187,0,0,0.5183362528068679,-3000136677,1805.9179207410339,1658.138775079635,147.77914566139884,0.7764273797386226,0.7758252937878254,-187
400,2018-02-05,2018,186188,186188,312551860.81666666,2886538.5333333337,143877,0,191,0.824687949814166,27997790,3169520572,186807,186807,301599,488406,287727365.94999945,2883896.6999997604,144143,0,191,0.3154834297694954,3031209311,-619,-619,24824494.86666721,2641.833333573304,-266,0,0,0.5092045200446706,-3003211521,1678.689608442363,1540.2386738719613,138.4509345704016,0.7727511977141384,0.7716145540584668,-266
401,2018-02-06,2018,188802,188802,312326936.1666668,2903059.516666666,144465,0,178,0.8145146767513056,28369038,3169649996,189578,189578,310563,500141,287626653.9333336,2900475.983333136,144664,0,178,0.3082870630482186,3035066493,-776,-776,24700282.23333323,2583.533333530184,-199,0,0,0.506227613703087,-3006697455,1654.2565024028709,1517.194262695743,137.0622397071279,0.7651666825563288,0.763084324130437,-199
402,2018-02-07,2018,188204,188204,312626702.4166663,2915972.250000001,145005,0,123,0.823845401798049,28508446,3174351304,188563,188563,323217,511780,287960523.1833352,2912430.4166664397,145250,0,123,0.3040701082496447,3040341290,-359,-359,24666179.233331144,3541.833333561197,-245,0,0,0.5197752935484043,-3011832844,1661.1055153804718,1527.1316386742637,133.9738767062081,0.7704671526641305,0.7702995815722067,-245
403,2018-02-08,2018,186143,186143,312777484.58333266,2881874.4999999967,142879,0,148,0.823877341613705,27789508,3177593595,186476,186476,337046,523522,288159976.2500073,2879019.3666664464,143116,0,148,0.29387685713302986,3046285490,-333,-333,24617508.333325386,2855.1333335503004,-237,0,0,0.5300004844806752,-3018495982,1680.307530142593,1545.292564458736,135.01496568385687,0.7675765406166227,0.7674767798537078,-237
404,2018-02-09,2018,185114,185114,312794282.05000013,2836980.1333333305,141749,0,63,0.8173395853366044,28588976,3181613913,185569,185569,351302,536871,288310751.1166743,2834751.816666537,142029,0,63,0.2829785926228116,3057851640,-455,-455,24483530.933325827,2228.316666793544,-280,0,0,0.5343609927137929,-3029262664,1689.7386586103705,1553.657944574117,136.08071403625354,0.7657389500524001,0.7653702935296305,-280
405,2018-02-10,2018,171676,171676,311511492.2833333,2713823.1333333305,132411,0,54,0.8197593140567112,27508205,3171686908,172009,172009,370344,542353,287349160.2333381,2711880.5499998988,132698,0,54,0.26046320385431887,3056028389,-333,-333,24162332.049995184,1942.583333431743,-287,0,0,0.5592961102023923,-3028520184,1814.531398001662,1670.5472401638176,143.98415783784435,0.771284279689648,0.7714596329261841,-287
406,2018-02-11,2018,165775,165775,311137575.7666669,2643789.0666666655,125596,0,62,0.8036977831397972,27714188,3173888109,166331,166331,386061,552392,287013799.0666749,2642360.266666596,125856,0,62,0.24195317817781958,3065513238,-556,-556,24123776.699992,1428.800000069663,-260,0,0,0.5617446049619776,-3037799050,1876.866691398986,1725.5580683497055,151.3086230492804,0.7576293168451214,0.7566599130649128,-260
407,2018-02-12,2018,169808,169808,311116988.04999995,2710526.150000001,129906,0,69,0.8136895788184302,28045849,3177343381,170255,170255,397936,568191,286797819.86667454,2707244.083333286,130134,0,69,0.24383173967908767,3070345590,-447,-447,24319168.18332541,3282.066666714847,-228,0,0,0.5698578391393425,-3042299741,1832.1692031588616,1684.5192203851548,147.64998277370682,0.7650169603316687,0.7643475962526798,-228
408,2018-02-13,2018,169455,169455,310937383.05,2692274.2833333327,128081,0,66,0.803871234250981,28635701,3179810915,170245,170245,406607,576852,286728653.2666722,2689570.1999999313,128438,0,66,0.2372653644262316,3076307617,-790,-790,24208729.783327818,2704.083333401475,-357,0,0,0.5666058698247494,-3047671916,1834.9259865451006,1684.2118903149708,150.71409623012983,0.755840783688885,0.7544303797468355,-357
409,2018-02-14,2018,163656,163656,310411759.5999998,2623014.1999999993,121657,0,67,0.7807779733098696,26810946,3177577233,164281,164281,421700,585981,286280950.91667193,2621921.899999934,122147,0,67,0.2194849321053069,3083676731,-625,-625,24130808.683327854,1092.300000065472,-490,0,0,0.5612930412045627,-3056865785,1896.7331451336938,1742.6297071278598,154.10343800583405,0.7433702400156426,0.7435248141903202,-490
410,2018-02-15,2018,158353,158353,309860522.6666667,2550243.8166666687,117186,0,57,0.7761583298074559,26401609,3176279184,166163,166163,437588,603751,285881893.1000005,2557660.83333316,118401,0,58,0.20593589078941504,3091273129,-7810,-7810,23978629.566666186,-7417.01666649105,-1215,0,-1,0.5702224390180408,-3064871520,1956.7707758404747,1720.4906814393125,236.28009440116216,0.7400301857242995,0.7125593543689028,-1215
411,2018-02-16,2018,155742,155742,309726313.86666644,2546412.800000003,117587,0,84,0.7914884873701383,26232432,3179008824,157030,157030,459270,616300,285620330.5666734,2545141.999999985,117985,0,84,0.2010968684082411,3095199504,-1288,-1288,24105983.29999304,1270.8000000179745,-398,0,0,0.5903916189618972,-3068967072,1988.7141160808674,1818.8902156700847,169.8239004107827,0.7550114933672356,0.7513532446029421,-398
412,2018-02-17,2018,156015,156015,309870208.81666654,2552152.066666666,117022,0,51,0.7857577797006703,25916952,3183264383,156639,156639,464832,621471,285785232.7500014,2549796.399999868,117321,0,51,0.19817497517985505,3101053822,-624,-624,24084976.066665173,2355.666666797828,-299,0,0,0.5875828045208152,-3075136870,1986.1565158264689,1824.483256085658,161.67325974081086,0.7500689036310612,0.7489897152050256,-299
413,2018-02-18,2018,162004,162004,310137617.0499994,2603401.083333335,123081,0,91,0.8090787881780709,29092352,3190745226,162603,162603,472335,634938,286128131.1000073,2605240.7666665902,123441,0,91,0.20750214981620044,3112152717,-599,-599,24009485.94999212,-1839.6833332553506,-360,0,0,0.6015766383618705,-3083060365,1914.3824661736712,1759.673137027037,154.70932914663422,0.7597405002345621,0.7591557351340381,-360
414,2018-02-19,2018,168325,168325,310744866.5500001,2673334.2833333355,128821,0,86,0.8187019159364329,28689739,3200337779,173937,173937,480621,654558,286803911.9333395,2675595.633333271,130616,0,86,0.21371215385038883,3122561121,-5612,-5612,23940954.616660595,-2261.349999935366,-1795,0,0,0.604989762086044,-3093871382,1846.1004993316506,1648.8953582810989,197.20514105055167,0.7653111540175256,0.7509385582136061,-1795
415,2018-02-20,2018,167236,167236,311033303.0000001,2666213.85,128610,0,59,0.8188787103255294,28352024,3206293787,167855,167855,490499,658354,283824872.0666735,2664780.1999999434,128889,0,59,0.20889065760973533,3074754672,-619,-619,27208430.933326602,1433.6500000567175,-279,0,0,0.609988052715794,-3046402648,1859.8465820756303,1690.8931641397248,168.95341793590546,0.7690329833289483,0.7678591641595425,-279
416,2018-02-21,2018,170908,170908,311342281.15000045,2701552.7833333313,131903,0,88,0.8187679921361212,29425589,3213412054,171462,171462,499138,670600,284258735.86667484,2699532.799999899,132167,0,88,0.2095586042350185,3080107010,-554,-554,27083545.283325613,2019.9833334321156,-264,0,0,0.6092093879011027,-3050681421,1821.6951877618394,1657.8526779500696,163.8425098117698,0.771777798581693,0.7708238560147438,-264
417,2018-02-22,2018,174924,174924,311879587.2000002,2756436.2333333325,135078,0,69,0.8228144794310676,29447265,3221618952,175614,175614,508516,684130,284891935.6833431,2754206.0333332242,135348,0,69,0.2112727113267937,3085241500,-690,-690,26987651.516657114,2230.2000001082197,-270,0,0,0.6115417681042739,-3055794235,1782.943376552104,1622.262095751723,160.68128080038082,0.7722096453316869,0.7707130411015067,-270
418,2018-02-23,2018,185289,185289,312503013.4000001,2827504.3833333305,141860,0,103,0.8197680380378755,29981331,3230171846,185923,185923,516851,702774,285576742.10000646,2825424.9166665934,142176,0,103,0.21702567254907157,3087564394,-634,-634,26926271.299993634,2079.4666667371057,-316,0,0,0.6027423654888039,-3057583063,1686.570780780295,1535.994697267183,150.57608351311205,0.7656147963451689,0.7647036676473594,-316
419,2018-02-24,2018,180234,180234,312759928.28333354,2822614.666666666,139367,0,91,0.8281456328994531,29285001,3236682351,180875,180875,528271,709146,285858095.46667403,2821889.5999999773,139791,0,91,0.21176598330950247,3087324348,-641,-641,26901832.81665951,725.06666668877,-424,0,0,0.6163796495899506,-3058039347,1735.2992680811253,1580.417943146781,154.88132493434432,0.7732558784691013,0.7728597097442985,-424
420,2018-02-25,2018,180344,180344,312868761.4499999,2810515.3666666644,138747,0,99,0.8249456594064676,29459043,3241925660,180868,180868,539873,720741,286043338.3000084,2809489.8499999065,139091,0,99,0.20758080919498034,3097186462,-524,-524,26825423.149991512,1025.5166667578742,-344,0,0,0.6173648502114872,-3067727419,1734.8443056048436,1581.5032968795388,153.34100872530485,0.769346360289225,0.7690193953601522,-344
421,2018-02-26,2018,187308,187308,313483024.66666657,2875681.666666667,143922,0,82,0.8283575714865353,29341429,3249876230,187825,187825,550104,737929,286750555.9500071,2874280.0499999104,144309,0,82,0.21142819973195423,3105831751,-517,-517,26732468.716659486,1401.6166667565703,-387,0,0,0.6169293717545811,-3076490322,1673.623255102113,1526.6900356715405,146.93321943057254,0.7683708117111923,0.7683162518301611,-387
422,2018-02-27,2018,191821,191821,313977251.3166664,2930586.9000000013,147968,0,117,0.8322029391985251,30182636,3257264074,192624,192624,556735,749359,287406935.6833306,2929889.2333333446,148417,0,117,0.2143698814586848,3107958509,-803,-803,26570315.63333583,697.6666666567326,-449,0,0,0.6178330577398403,-3077775873,1636.824181485168,1492.0619221038428,144.7622593813253,0.7713858232414594,0.7705010798239056,-449
423,2018-02-28,2018,188603,188603,314195236.5666666,2913841.0166666647,145848,0,108,0.8316251597270464,29769931,3262728690,189549,189549,568828,758377,287858470.7333341,2915730.266666328,146244,0,109,0.2080363724110756,3115276749,-946,-946,26336765.83333248,-1889.249999663327,-396,0,-1,0.6235887873159709,-3085506818,1665.9079472047983,1518.6493768541861,147.25857035061222,0.7733068933155889,0.7715366475159458,-396
424,2018-03-01,2018,189396,189396,314481731.15,2908749.833333335,145815,0,95,0.826585566749034,30161105,3268705440,190944,190944,250677,441621,288302969.36666775,2909046.099999844,146413,0,95,0.35724523969648414,3097990425,-1548,-1548,26178761.78333223,-296.26666650921106,-598,0,0,0.4693403270525499,-3067829320,1660.4454748252338,1509.8823182015028,150.56315662373095,0.7698948235443198,0.7667850259762025,-598
425,2018-03-02,2018,189800,189800,314889892.46666676,2902991.949999998,144180,0,122,0.8176712328767121,30370191,3275785034,190398,190398,267227,457625,288784053.54999924,2901863.399999712,144543,0,123,0.3409975416552851,3106949600,-598,-598,26105838.91666752,1128.5500002857298,-363,0,-1,0.47667369122142694,-3076579409,1659.0616041447142,1516.7389024569545,142.32270168775972,0.7596417281348788,0.7591623861595185,-363
426,2018-03-03,2018,190926,190926,315279437.36666685,2925299.900000004,146439,0,146,0.8247436179462202,30679646,3284265310,191554,191554,284030,475584,289182562.21666706,2926107.949999743,146831,0,146,0.33299059682411103,3117454341,-628,-628,26096875.149999797,-808.0499997390434,-392,0,0,0.49175302112210917,-3086774695,1651.317459993227,1509.6660065394983,141.65145345372866,0.7669934948618836,0.7665253662152709,-392
427,2018-03-04,2018,191582,191582,315866548.81666684,2916323.9499999974,146853,0,184,0.8175350502656806,30464300,3293604680,192552,192552,299070,491622,289898747.016677,2917606.9333332255,147333,0,186,0.32048809857980887,3126376528,-970,-970,25967801.79998982,-1282.983333228156,-480,0,-2,0.49704695168587176,-3095912228,1648.7276926677184,1505.5608200209658,143.1668726467526,0.7665281707049723,0.7651595413187087,-480
428,2018-03-05,2018,193498,193498,316396930.53333306,2938609.8333333335,148412,0,158,0.819827595117262,30739316,3304167701,193967,193967,315218,509185,290328707.2999969,2936527.3999998113,148795,0,160,0.3133006667517708,3135324360,-469,-469,26068223.23333615,2082.4333335221745,-383,0,-2,0.5065269283654912,-3104585044,1635.1431566906792,1496.7943376966025,138.34881899407674,0.766995007700338,0.7671150247206999,-383
429,2018-03-06,2018,192303,192303,316754802.89999944,2968580.9333333294,149080,0,131,0.8328263209622316,30306487,3310871656,192823,192823,328276,521099,290809573.7500006,2964556.58333314,149505,0,132,0.3095764912233554,3139796025,-520,-520,25945229.149998844,4024.3500001896173,-425,0,-1,0.5232498297388762,-3109489538,1647.1651659100453,1508.1684952002645,138.9966707097808,0.7752349157319438,0.7753483764903565,-425
430,2018-03-07,2018,193748,193748,317311191.3833333,3006345.700000005,152026,0,145,0.8452422734686289,30886806,3319344059,194511,194511,339760,534271,291454930.06666684,3003254.633333074,152487,0,145,0.3086804262256478,3146645791,-763,-763,25856261.316666484,3091.066666930914,-461,0,0,0.5365618472429812,-3115758985,1637.7520871613299,1498.3981886200104,139.3538985413195,0.7846584222804881,0.7839505220784428,-461
431,2018-03-08,2018,191643,191643,317562474.8666666,2986247.7000000025,148440,0,165,0.8347604660749411,30122458,3324702655,192155,192155,354879,547034,291799949.46666634,2982626.0999997263,148747,0,168,0.29386656039661047,3155695014,-512,-512,25762525.400000274,3621.6000002762303,-307,0,-3,0.5408939056783306,-3125572556,1657.0523048932996,1518.5654782163688,138.48682667693083,0.7745652071821042,0.774099034633499,-307
432,2018-03-09,2018,206785,206785,317972844.4499999,3110408.616666671,159956,0,136,0.8368256885170581,31443114,3330543999,207222,207222,366791,574013,292416919.2333335,3105179.6666663885,160280,0,137,0.3030088168734891,3166847953,-437,-437,25555925.2166664,5228.950000282377,-324,0,-1,0.533816871643569,-3135404839,1537.6978235848826,1411.128737457092,126.56908612779057,0.7735377324274004,0.7734699983592476,-324
433,2018-03-10,2018,206666,206666,318389820.46666706,3108808.8166666664,158230,0,172,0.8269913773915405,31060268,3336828970,207113,207113,378874,585987,292954538.90000963,3103947.4666665737,158633,0,173,0.2930252718916968,3175032264,-447,-447,25435281.566657424,4861.35000009276,-403,0,-1,0.5339661054998437,-3143971996,1540.6008751641152,1414.46716961277,126.1337055513452,0.7656315020371034,0.7659248815863804,-403
434,2018-03-11,2018,204548,204548,318920563.21666634,3084303.9166666614,156348,0,136,0.8260603868040756,30223894,3344408228,210728,210728,394683,605411,293552702.10001695,3088623.0499999393,157143,0,136,0.2813625784797506,3186765589,-6180,-6180,25367861.11664939,-4319.133333277889,-795,0,0,0.544697808324325,-3156541695,1559.1477952200282,1393.040801886873,166.1069933331553,0.7643584879832607,0.7457148551687484,-795
435,2018-03-12,2018,209229,209229,319643477.76666623,3144257.266666667,159409,0,106,0.8215209172724621,29187800,3352657795,210077,210077,413172,623249,293692165.30000705,3141334.099999901,159938,0,106,0.27770441669381624,3192859604,-848,-848,25951312.46665919,2923.166666766163,-529,0,0,0.543816500578646,-3163671804,1527.7207163761536,1398.021512588275,129.69920378787856,0.7618876924326934,0.7613303693407655,-529
436,2018-03-13,2018,210013,210013,320221775.883334,3178643.683333332,160824,0,146,0.8295105541085553,30576308,3357587175,210931,210931,418521,629452,294058204.0000123,3174850.616666556,161464,0,147,0.2794954976709893,3189552986,-918,-918,26163571.883321702,3793.0666667763144,-640,0,-1,0.5500150564375661,-3158976678,1524.7712088458047,1394.096666682528,130.67454216327678,0.7657811659278235,0.7654825511660212,-640
437,2018-03-14,2018,213923,213923,320723779.1999997,3170875.9999999967,164112,0,112,0.8314300005142035,30196293,3364162870,214963,214963,432046,647009,294644641.3333417,3166617.7833332187,164782,0,112,0.2773500832291331,3197840875,-1040,-1040,26079137.866657972,4258.216666778084,-670,0,0,0.5540799172850703,-3167644582,1499.2486978959705,1370.676076037931,128.5726218580396,0.7671545369128144,0.7665598265748059,-670
438,2018-03-15,2018,207155,207155,320744072.76666635,3090273.566666664,158870,0,97,0.8312760976080713,30429910,3368114309,207649,207649,451212,658861,294721672.0500072,3085112.349999867,159231,0,98,0.26268514906785173,3207567355,-494,-494,26022400.71665913,5161.216666797176,-361,0,-1,0.5685909485402196,-3177137445,1548.3288975243966,1419.3262286358577,129.0026688885389,0.7669136636817842,0.7668276755486422,-361
439,2018-03-16,2018,207062,207062,320666661.4333334,3103223.3666666644,159323,0,189,0.8333542610425865,30392413,3371515252,207560,207560,468345,675905,294767744.8166728,3099193.133333224,159690,0,190,0.2565819160976811,3214720739,-498,-498,25898916.616660595,4030.2333334404975,-367,0,-1,0.5767723449449054,-3184328326,1548.6504594437097,1420.1567971510542,128.49366229265547,0.7694458664554578,0.7693678936211216,-367
440,2018-03-17,2018,205632,205632,320426051.2333335,3098914.9666666645,157591,0,55,0.8292580921257398,31804492,3373740912,206114,206114,481759,687873,294552016.40000755,3095500.8999999873,157973,0,55,0.24939487376303374,3219785217,-482,-482,25874034.833325982,3414.0666666771285,-382,0,0,0.579863218362706,-3187980725,1558.2499379149817,1429.0733108862453,129.17662702873645,0.7663739106753813,0.7664350796161348,-382
441,2018-03-18,2018,203769,203769,320567175.1833335,3082330.3499999973,157166,0,105,0.8396763001241614,31509953,3378306588,204244,204244,495708,699952,294856042.816674,3079104.7666665297,157619,0,105,0.24636403639106605,3230346039,-475,-475,25711132.366659522,3225.583333467599,-453,0,0,0.5933122637330953,-3198836086,1573.1891268217123,1443.6460450082939,129.54308181341844,0.771294946728894,0.7717191202679149,-453
442,2018-03-19,2018,209530,209530,321197868.3666663,3101878.2333333264,162270,0,62,0.8416074070538829,30988771,3388004458,210109,210109,509199,719308,295593638.75000614,3099248.766666567,162700,0,62,0.24667041100613163,3239804974,-579,-579,25604229.616660178,2629.4666667594574,-430,0,0,0.5949369960477513,-3208816203,1532.9445347523806,1406.8585293823974,126.08600536998324,0.7744475731398845,0.7743599750605638,-430
443,2018-03-20,2018,203877,203877,321390667.2500001,3098380.183333333,158408,0,116,0.8418458188025136,32454633,3393478858,204294,204294,522285,726579,295905295.51667655,3094177.1499999217,158773,0,116,0.23774014938499902,3242960939,-417,-417,25485371.733323574,4203.03333341144,-365,0,0,0.6041056694175146,-3210506306,1576.3949207119986,1448.42871311285,127.96620759914867,0.776978276117463,0.7771789675663504,-365
444,2018-03-21,2018,207958,207958,321930646.11666715,3171883.666666667,161866,0,127,0.8409919310630026,33786889,3402017532,208381,208381,534942,743323,296596856.7666704,3167746.933332811,162196,0,129,0.2366669671192787,3252877507,-423,-423,25333789.349996746,4136.733333855867,-330,0,-2,0.6043249639437239,-3219090618,1548.056079192275,1423.3392524590554,124.7168267332197,0.7783590917396782,0.7783627106118121,-330
445,2018-03-22,2018,183765,183765,316806530.81666696,2758481.2333333353,146929,0,47,0.8480341740810277,13641672,3352478403,184149,184149,556853,741002,291687259.9166799,2755118.2499999395,147996,0,47,0.2121681183046749,3242810544,-384,-384,25119270.899987042,3362.983333395794,-1067,0,0,0.6358660557763527,-3229168872,1723.9764417417189,1583.974172635637,140.00226910608194,0.799548336190243,0.8036752846879429,-1067
446,2018-03-23,2018,219655,219655,317097910.75,3279838.1333333305,168626,0,159,0.8321003391682407,33015389,3355979219,220264,220264,560325,780589,292112863.2833318,3275349.6999999443,168990,0,159,0.23542222603700783,3254481807,-609,-609,24985047.46666819,4488.433333386201,-364,0,0,0.5966781131312329,-3221466418,1443.6179952653024,1326.1943090261314,117.42368623917105,0.7676856889212629,0.7672157047906148,-364
447,2018-03-24,2018,220797,220797,317967540.5166664,3291619.999999998,168364,0,155,0.827370842900945,33553245,3366350820,221236,221236,561594,782830,293026879.64999825,3286698.6333332905,168810,0,157,0.23490029763805834,3221073620,-439,-439,24940660.866668165,4921.366666707676,-446,0,-2,0.5924705452628867,-3187520375,1440.0899492142846,1324.4990853658458,115.59086384843886,0.7625284763832842,0.7630313330561029,-446
448,2018-03-25,2018,179067,179067,315116485.6166669,2736659.4333333387,141479,0,63,0.8343525049283225,12956853,3333706202,179360,179360,593523,772883,290306771.41667336,2732671.466666611,142494,0,63,0.19503987020027871,3214221675,-293,-293,24809714.19999355,3987.9666667277925,-1015,0,0,0.6393126347280438,-3201264822,1759.7686096079508,1618.5703134292671,141.19829617868368,0.790089742945378,0.7944580731489741,-1015
449,2018-03-26,2018,216887,216887,316173151.2333334,3283619.9666666645,168589,0,173,0.8424386892713712,33253133,3346871529,217379,217379,600129,817508,291444931.4500002,3280786.866666228,168898,0,173,0.22466079842643466,3231602044,-492,-492,24728219.783333182,2833.1000004364178,-309,0,0,0.6177778908449365,-3198348911,1457.7782496568877,1340.7225695674385,117.0556800894492,0.777312609792196,0.7769747767723653,-309
450,2018-03-27,2018,217323,217323,317237031.3999997,3294506.0166666647,168394,0,330,0.8452349728284624,34109494,3359824077,217800,217800,595891,813691,292644409.81666493,3289996.499999958,168792,0,334,0.22720664232491292,3218100325,-477,-477,24592621.583334744,4509.516666706651,-398,0,-4,0.6180283305035494,-3183990831,1459.7489975750366,1343.638245255578,116.11075231945847,0.7748558597111213,0.7749862258953168,-398
451,2018-03-28,2018,217385,217385,318119982.2999999,3282695.0666666706,167516,0,116,0.8423902293166503,33772969,3370953764,217999,217999,610086,828085,293577806.4166674,3278466.666666162,167967,0,116,0.22249648284898252,3232060896,-614,-614,24542175.88333249,4228.400000508409,-451,0,0,0.6198937464676678,-3198287927,1463.394357016353,1346.6933628900472,116.70099412630589,0.7705959472824712,0.7704943600658719,-451
452,2018-03-29,2018,217780,217780,318964613.4833337,3271930.166666667,167784,0,178,0.8443520984479754,33914965,3382302822,218274,218274,624605,842879,294412888.7833313,3267647.666666641,168178,0,178,0.21922838272160083,3242910696,-494,-494,24551724.700002432,4282.500000026077,-394,0,0,0.6251237157263746,-3208995731,1464.6184841736326,1348.822529404928,115.79595476870463,0.7704288731747635,0.7704903011810843,-394
453,2018-03-30,2018,217929,217929,319801841.0833334,3286445.4833333353,168123,0,113,0.8460599553065443,33839805,3395085972,218600,218600,638629,857229,295289332.81666577,3281446.9666666193,168605,0,113,0.21666439189528244,3257116727,-671,-671,24512508.266667604,4998.516666715965,-482,0,0,0.6293955634112619,-3223276922,1467.458856248289,1350.8203697011243,116.6384865471648,0.7714576765827402,0.7712946020128087,-482
454,2018-03-31,2018,216678,216678,320416902.2000005,3249453.5666666687,166229,0,394,0.8438420144177065,33370067,3405824197,217116,217116,653028,870144,295988892.5333422,3245455.3999995287,166664,0,394,0.21160750404531783,3274228922,-438,-438,24428009.666658342,3998.166667140089,-435,0,0,0.6322345103723886,-3240858855,1478.7698898826854,1363.275357566196,115.49453231648954,0.7671706403049686,0.7676265222277492,-435
455,2018-04-01,2018,177469,177469,317420253.45000064,2726179.9500000034,142461,0,156,0.8631253909133426,13279323,3373535280,177863,177863,306561,484424,293025305.5333326,2721867.6333333147,142935,0,158,0.3186856968275733,3240864439,-394,-394,24394947.916668057,4312.31666668877,-474,0,-2,0.5444396940857693,-3227585116,1788.5954924522066,1647.4775840581378,141.11790839406876,0.8027373794859948,0.8036241376790001,-474
456,2018-04-02,2018,218365,218365,318364366.98333335,3261128.4333333327,168455,0,327,0.8487807111945587,33150519,3386104348,225879,225879,311336,537215,294058379.60000825,3270163.7499998417,170513,0,327,0.3509674897387376,3258370565,-7514,-7514,24305987.3833251,-9035.316666509025,-2058,0,0,0.4978132214558211,-3225220046,1457.9459482212503,1301.8402755457932,156.10567267545707,0.7714377304055137,0.7548864657626428,-2058
457,2018-04-03,2018,213763,213763,319004641.5333332,3201159.2500000014,164171,0,182,0.8380168691494789,31920348,3394404968,214363,214363,317454,531817,291502942.7000126,3197383.916666588,164706,0,182,0.33989887498895144,3195139259,-600,-600,27501698.833320558,3775.3333334135823,-535,0,0,0.4981179941605275,-3163218911,1492.3286140881874,1359.8566109823646,132.47200310582275,0.7680047529273073,0.7683508814487575,-535
458,2018-04-04,2018,211377,211377,319138204.3666664,3164698.949999997,162558,0,215,0.8397413152802815,32011038,3400241904,212139,212139,332428,544567,291768718.6666775,3161402.716666543,163164,0,217,0.33134214889995395,3205089427,-762,-762,27369485.6999889,3296.2333334540017,-606,0,-2,0.5083991663803276,-3173078389,1509.8057232653807,1375.3657680420738,134.43995522330692,0.7690429895400162,0.7691372166362621,-606
459,2018-04-05,2018,208353,208353,319353827.2999999,3174012.2833333355,161438,0,307,0.845248208569111,32925200,3406437382,209566,209566,348128,557694,292164745.96667546,3169542.7499998324,162276,0,307,0.319497789110159,3213222926,-1213,-1213,27189081.333324432,4469.5333335031755,-838,0,0,0.525750419458952,-3180297726,1532.7536790926931,1394.1419217176233,138.61175737506983,0.7748292561182224,0.7743431663533207,-838
460,2018-04-06,2018,225694,225694,319403661.083333,3145791.86666667,160864,0,95,0.7760950667718224,33269607,3411998866,226273,226273,364376,590649,291865227.45000696,3141829.9666664214,161229,0,99,0.29800270549852853,3216365990,-579,-579,27538433.633326054,3961.90000024857,-365,0,-4,0.47809236127329385,-3183096383,1415.2067005916551,1289.8809290105623,125.3257715810928,0.7127526651129406,0.7125419294392172,-365
461,2018-04-07,2018,230751,230751,319425648.4666668,3181926.3500000043,166212,0,86,0.7947094487131147,34134274,3417378359,231258,231257,398274,629532,292094964.6333444,3177101.5166665656,166804,0,86,0.295667257581821,3226344341,-507,-506,27330683.833322406,4824.833333438728,-592,0,0,0.49904219113129367,-3192210067,1384.2871687085508,1263.07512695116,121.21204175739081,0.7203089044034479,0.7212896418718487,-592
462,2018-04-08,2018,181811,181811,316289057.91666675,2725579.3166666715,145911,0,49,0.8664162234408256,13592669,3381129791,182272,182272,436911,619183,289117480.15001297,2721394.8666666127,147233,0,49,0.2614267510574429,3215918450,-461,-461,27171577.766653776,4184.45000005886,-1322,0,0,0.6049894723833826,-3202325781,1739.6585350538016,1586.1870180280732,153.47151702572842,0.8025422004169165,0.8077653177668539,-1322
463,2018-04-09,2018,224207,224207,316904222.6666666,3342106.616666666,171628,0,155,0.8362361567658461,32534490,3387930924,226743,226743,436212,662955,289981187.95000863,3339207.9833327294,172352,0,155,0.28517169340301085,3228756563,-2536,-2536,26923034.716657996,2898.6333339367993,-724,0,0,0.5510644633628352,-3196222073,1413.4448195937978,1278.8980826310344,134.54673696276336,0.7654890346866958,0.7601204888353775,-724
464,2018-04-10,2018,220203,220203,317877143.4666663,3308558.1999999983,170292,0,324,0.8517322652279947,32589257,3398763845,221252,221252,435564,656816,290600022.2666783,3306665.983333202,170862,0,324,0.28880995590849917,3203763406,-1049,-1049,27277121.199988008,1892.2166667962447,-570,0,0,0.5629223093194955,-3171174149,1443.5640907102368,1313.4345554692309,130.1295352410059,0.7733409626571845,0.7722506463218411,-570
465,2018-04-11,2018,224450,224450,318992461.91666603,3373456.8666666667,172423,0,262,0.8564268211182895,33213666,3411351486,225401,225401,445612,671013,291827999.8666788,3369163.7499998966,173031,0,262,0.2908572561187327,3216400192,-951,-951,27164462.049987257,4293.1166667700745,-608,0,0,0.5655695649995568,-3183186526,1421.2183645206774,1294.7058791517286,126.51248536894877,0.7682022722209846,0.7676585285779566,-608
466,2018-04-12,2018,189614,189614,317001760.81666726,2854111.183333333,150539,0,85,0.8526374634784337,14198320,3384491588,190252,190252,474605,664857,290021826.00001156,2850226.083333293,151710,0,85,0.2474080892582903,3208556672,-638,-638,26979934.816655695,3885.10000004014,-1171,0,0,0.6052293742201434,-3194358352,1671.8267681535501,1524.4088156761115,147.41795247743858,0.7939234444713998,0.7974160587010912,-1171
467,2018-04-13,2018,221463,221463,317536550.7333333,3309861.6666666674,171193,0,352,0.8546393754261432,32870293,3390575381,231439,231439,483006,714445,290767954.08335453,3317835.266666577,173569,0,352,0.2698710187628054,3221723519,-9976,-9976,26768596.649978757,-7973.599999909755,-2376,0,0,0.5847683566633378,-3188853226,1433.813100758742,1256.348126648294,177.46497411044788,0.773009486912035,0.7499557118722427,-2376
468,2018-04-14,2018,215923,215923,317774116.76666677,3225635.200000002,166959,0,112,0.8519286968039527,32585881,3396593569,219000,219000,492860,711860,287107169.433344,3221243.7166665522,168055,0,112,0.262183575422137,3147626435,-3077,-3077,30666947.333322763,4391.483333449811,-1096,0,0,0.5897451213818157,-3115040554,1471.701100701022,1310.9916412481462,160.70945945287576,0.77323397692696,0.7673744292237443,-1096
469,2018-04-15,2018,210352,210352,318157776.0833335,3220973.9666666677,164049,0,102,0.88857724195634,31963519,3404269683,211066,211066,505873,716939,286709048.46667665,3215656.0333332345,164741,0,102,0.2732310559196847,3139419334,-714,-714,31448727.61665684,5317.933333433233,-692,0,0,0.6153461860366554,-3107455815,1512.5017878761955,1358.3857583252473,154.11602955094827,0.7798784893892142,0.7805188898259312,-692
470,2018-04-16,2018,217697,217697,318969084.7499999,3302426.2499999977,169842,0,160,0.9466138715737942,33450835,3413618228,223649,223649,516415,740064,287702653.966661,3297975.616666629,173648,0,160,0.34217716305617046,3153004313,-5952,-5952,31266430.783338904,4450.633333368693,-3806,0,0,0.6044367085176237,-3119553478,1465.1974292250231,1286.4025949888485,178.79483423617467,0.7801761163451953,0.7764309252444679,-3806
471,2018-04-17,2018,225864,225864,319822600.89999974,3374146.5499999956,174316,0,223,0.9424033931923628,33912821,3424304952,227518,227518,525103,752621,286301633.9166639,3368766.5999999316,175796,0,225,0.3398921900930186,3117426046,-1654,-1654,33520966.983335853,5379.950000063982,-1480,0,-2,0.6025112030993443,-3083513225,1415.9963557716137,1258.3691572388288,157.62719853278486,0.7717741649842383,0.7726685361158238,-1480
472,2018-04-18,2018,194097,194097,318135308.5666663,2923131.9500000053,153877,0,111,0.9757956073509625,14497129,3400765979,195570,195570,550332,745902,284826706.06667453,2917409.683333307,155928,0,93,0.318083340706961,3110941198,-1473,-1473,33308602.499991775,5722.26666669827,-2051,0,18,0.6577122666440015,-3096444069,1639.0531979714592,1456.3926270219079,182.66057094955136,0.7927840203609535,0.7973001994170885,-2051
473,2018-04-19,2018,232694,232694,319174872.08333343,3468150.033333331,179865,0,243,0.9386662311877408,33092886,3410859799,234999,234999,553939,788938,286048842.5333338,3463016.6999999294,181647,0,243,0.354176120303498,3126550061,-2305,-2305,33126029.549999654,5133.333333401475,-1782,0,0,0.5844901108842429,-3093457175,1371.6506316593184,1217.2342968835346,154.41633477578375,0.7729679321340472,0.7729692466776454,-1782
474,2018-04-20,2018,232471,232471,320177715.5000006,3423329.2000000034,179106,0,124,0.9199470041424521,32500441,3420849467,234325,234325,553753,788078,287177236.6499984,3418526.8333332953,180585,0,103,0.32035026989713805,3121937992,-1854,-1854,33000478.85000217,4802.366666708142,-1479,0,21,0.5995967342453141,-3089437551,1377.2802435572635,1225.550993918696,151.72924963856758,0.7704444855487351,0.7706604075536114,-1479
475,2018-04-21,2018,228395,228395,320659614.33333325,3392882.216666663,176205,0,129,0.9704546947174851,33664602,3430145938,230620,230620,572843,803463,287778696.0833409,3386342.83333285,178192,0,106,0.3684749639996005,3133459859,-2225,-2225,32880918.24999237,6539.383333812933,-1987,0,23,0.6019797307178847,-3099795257,1403.9695016674325,1247.8479580406768,156.12154362675574,0.7714923706736136,0.772664990026884,-1987
476,2018-04-22,2018,228740,228740,321432259.56666696,3369396.4000000013,177367,0,214,1.0301127918160355,33691062,3441348855,231228,231228,587631,818859,288670306.41667587,3364396.3833327927,179637,0,214,0.40114964847427437,3149509631,-2488,-2488,32761953.149991095,5000.016667208634,-2270,0,0,0.6289631433417612,-3115818569,1405.2297786424192,1248.4227966192498,156.80698202316944,0.7754087610387339,0.7768825574757382,-2270
477,2018-04-23,2018,224994,224994,321789932.71666616,3343001.649999999,175280,0,136,0.9770838333466667,33592371,3450942596,226813,226813,605739,832552,289194525.44999605,3340282.433333301,176891,0,136,0.3234692848014372,3165947667,-1819,-1819,32595407.266670108,2719.21666669799,-1611,0,0,0.6536145485452295,-3132355296,1430.2156178238804,1275.0350528849583,155.1805649389221,0.7790429967021343,0.7798979776291483,-1611
478,2018-04-24,2018,221541,221541,321886441.5999998,3323636.6333333366,173163,0,172,1.0023742783502825,32993211,3455648609,223850,223850,620448,844298,289470796.93334186,3320998.2166661667,175156,0,173,0.3451565679416414,3174349446,-2309,-2309,32415644.666657925,2638.4166671698913,-1993,0,-1,0.6572177104086411,-3141356235,1452.9429839171971,1293.1462896285095,159.7966942886876,0.7816295854943329,0.782470404288586,-1993
479,2018-04-25,2018,231737,231737,322543445.3833332,3410615.1833333303,178617,0,185,0.9980667739722179,34080834,3464384797,234494,234494,631486,865980,290265330.983329,3409922.599999938,180781,0,185,0.3385886510081023,3183715300,-2757,-2757,32278114.400004208,692.5833333921619,-2164,0,0,0.6594781229641156,-3149634466,1391.8513029137912,1237.836921129449,154.01438178434228,0.77077462813448,0.7709408343070612,-2164
480,2018-04-26,2018,236195,236195,323332803.83333325,3463209.650000003,180862,0,130,0.9532970638667202,30964370,3468741045,246444,246444,642573,889017,291324322.14999145,3470329.0666666385,186082,0,85,0.31066560032035406,3187835240,-10249,-10249,32008481.6833418,-7119.416666635312,-5220,0,45,0.6426314635463661,-3156870870,1368.9231517743103,1182.111644633229,186.8115071410814,0.765731704735494,0.7550680884906916,-5220
481,2018-04-27,2018,237482,237482,324185245.4833328,3485217.099999997,183174,0,164,0.9699514068434664,35217217,3478094044,239717,239717,662039,901756,290622616.24999505,3483558.6666665995,184970,0,164,0.29518628098954225,3164431182,-2235,-2235,33562629.23333776,1658.4333333973773,-1796,0,0,0.6747651258539241,-3129213965,1365.0939670515359,1212.3571388345217,152.73682821701414,0.7713174051085977,0.7716181997939237,-1796
482,2018-04-28,2018,239424,239424,325039469.55000013,3526707.450000005,183585,0,181,0.9886811681368621,36259807,3491000357,241622,241621,669582,911204,291536195.6833304,3522519.1499999883,185506,0,181,0.3183644935711444,3175513186,-2198,-2197,33503273.866669714,4188.3000000165775,-1921,0,0,0.6703166745657178,-3139253379,1357.5893375350847,1206.5846746902398,151.00466284484492,0.7667777666399358,0.7677529364047976,-1921
483,2018-04-29,2018,236607,236607,325754633.6166668,3464796.8833333384,181633,0,192,0.9880392380614266,35736059,3501398814,238847,238847,683977,922824,292385644.64999646,3461134.5833333135,183664,0,193,0.3068515773321896,3189937444,-2240,-2240,33368988.966670334,3662.3000000249594,-2031,0,-1,0.681187660729237,-3154201385,1376.775131829011,1224.154561916191,152.62056991281997,0.7676569163211571,0.7689608829083053,-2031
484,2018-04-30,2018,239100,239100,326219796.1333331,3434541.4833333283,183508,0,163,0.9900125470514419,36383663,3510646015,241296,241295,701214,942510,292957334.2499976,3429804.733333299,185489,0,164,0.31183117420504713,3207154083,-2196,-2195,33262461.88333547,4736.750000029337,-1981,0,-1,0.6781813728463948,-3170770420,1364.3655212602805,1214.104454091455,150.26106716882555,0.7674947720618988,0.7687197467011472,-1981
485,2018-05-01,2018,220490,220490,325610235.7333331,3235980.33333333,168811,0,142,0.9922626876502338,35136140,3514019540,224036,224036,296477,520513,292529788.6166809,3232809.333333214,171000,0,144,0.5411411434488629,3186919444,-3546,-3546,33080447.11665219,3171.0000001164153,-2189,0,-2,0.45112154420137096,-3151783304,1476.7573846130579,1305.7267073893522,171.03067722370565,0.7656174883214658,0.76327018871967,-2189
486,2018-05-02,2018,212669,212669,325340257.1499997,3217324.266666669,163007,0,135,0.9716178662616556,35150516,3519524347,217725,217725,320477,538202,292284156.5333361,3217859.216666514,165624,0,104,0.505295409530261,3197078405,-5056,-5056,33056100.616663575,-534.949999845121,-2617,0,31,0.4663224567313946,-3161927889,1529.7963367956763,1342.4464647299856,187.34987206569076,0.7664821859321292,0.7607027213227695,-2617
487,2018-05-03,2018,213193,213193,325685534.9166663,3222610.35,163154,0,138,0.961865539675318,34716552,3529307722,215282,215282,334820,550102,292400333.266672,3218274.1999998465,165063,0,93,0.4980839916960863,3199623219,-2089,-2089,33285201.649994314,4336.150000153575,-1909,0,45,0.46378154797923166,-3164906667,1527.6558560396745,1358.2200707289603,169.4357853107142,0.7652877908749349,0.7667292202785184,-1909
488,2018-05-04,2018,220968,220968,326249980.94999963,3249312.0333333337,166789,0,134,0.9390635748162621,35934571,3539675024,230303,230303,345584,575887,293100403.4500016,3280717.5499997186,170585,0,88,0.44251215950351397,3213421783,-9335,-9335,33149577.499998033,-31405.51666638488,-3796,0,46,0.49655141531274816,-3177487212,1476.4580434723564,1272.6729719109244,203.785071561432,0.7548106513160276,0.7406981237760689,-3796
489,2018-05-05,2018,219625,219625,326610162.0499998,3243632.0666666664,166370,0,127,0.9331724530449635,35309562,3548933387,221525,221525,369242,590767,291804085.1000094,3238249.716666375,168105,0,96,0.44006351065648536,3208249165,-1900,-1900,34806076.94999039,5382.350000291597,-1735,0,31,0.4931089423884782,-3172939603,1487.1265204325546,1317.251258774447,169.87526165810755,0.7575184974388162,0.7588534025505022,-1735
490,2018-05-06,2018,219672,219672,326930499.0833333,3209469.06666667,166882,0,132,0.929763465530428,35016073,3555879631,221207,221206,381126,602333,292004029.93334466,3205833.2166664824,168314,0,94,0.4223394700273761,3216304315,-1535,-1534,34926469.14998865,3635.8500001877546,-1432,0,38,0.507423995503052,-3181288242,1488.2665932997074,1320.0547450491608,168.2118482505466,0.7596871699624895,0.7608891219536452,-1432
491,2018-05-07,2018,217021,217021,325430285.0833335,3153712.433333334,167124,0,139,0.9342045239861587,33570648,3540205628,218838,218838,399607,618445,290728543.4166788,3150069.4833332403,168726,0,99,0.40353790555345026,3206121560,-1817,-1817,34701741.666654706,3642.950000093784,-1602,0,40,0.5306666184327085,-3172550912,1499.5336169464406,1328.510329178108,171.0232877683327,0.7700821579478484,0.7710086913607326,-1602
492,2018-05-08,2018,214017,214017,324045106.51666677,3221531.0333333304,164057,0,135,0.9424718597120789,33143360,3523197125,216426,216426,411621,628047,289700545.83334255,3217941.1499998383,165471,0,96,0.3999732504096007,3190752622,-2409,-2409,34344560.68332422,3589.883333492093,-1414,0,39,0.5424986093024782,-3157609262,1514.1091900020408,1338.56628054551,175.54290945653088,0.7665606003261423,0.7645615591472374,-1414
493,2018-05-09,2018,215426,215426,324306441.9166667,3230575.683333337,165877,0,136,0.9568668591534913,31784805,3527537012,217311,217311,423015,640326,290194307.56667864,3228658.8333332087,167346,0,101,0.401668837435927,3199392230,-1885,-1885,34112134.34998804,1916.85000012815,-1469,0,35,0.5551980217175643,-3167607425,1505.4192247763347,1335.3871068039753,170.0321179723594,0.7699952651954731,0.770076066098817,-1469
494,2018-05-10,2018,216502,216502,324714769.0999995,3250668.950000001,166661,0,132,1.0177042244413437,31933631,3532183832,218782,218782,436749,655531,290795977.2166785,3246269.7333331774,168676,0,106,0.456802195472071,3207080388,-2280,-2280,33918791.88332099,4399.216666823719,-2015,0,26,0.5609020289692727,-3175146757,1499.8234154880763,1329.1586017893542,170.66481369872213,0.7697896555228128,0.7709775027196022,-2015
495,2018-05-11,2018,220648,220648,325226630.95000005,3280165.0000000005,169694,0,135,0.9732107247743014,33766808,3540964562,222761,222761,448108,670869,291516369.4333472,3276868.916666478,171634,0,88,0.43008396572206975,3216582885,-2113,-2113,33710261.51665282,3296.083333522547,-1940,0,47,0.5431267590522316,-3182816077,1473.9613817029842,1308.6508384921383,165.31054321084594,0.7690710996700627,0.7704849592163799,-1940
496,2018-05-12,2018,217271,217271,325287492.0000004,3246148.0999999996,167495,0,142,1.0121000961932345,33183086,3543265981,219540,219540,462332,681872,291729236.0000101,3241754.683333177,169491,0,92,0.4389445526433132,3225470489,-2269,-2269,33558255.999990344,4393.416666822508,-1996,0,50,0.5731555435499213,-3192287403,1497.150986555962,1328.8204245240506,168.3305620319113,0.7709036180622356,0.7720278764689806,-1996
497,2018-05-13,2018,218663,218663,325829276.18333256,3230648.3666666653,166109,0,145,0.9890699386727533,34504694,3552833629,220823,220823,475346,696169,292422238.40001214,3227067.8833331587,168109,0,104,0.41577260693882445,3237368167,-2160,-2160,33407037.783320427,3580.4833335066214,-2000,0,41,0.5732973317339288,-3202863473,1490.097895772639,1324.2381382374667,165.85975753517232,0.7596575552333957,0.7612839242289073,-2000
498,2018-05-14,2018,220607,220607,326479240.9333334,3270234.3666666644,167354,0,139,0.9791575063347951,34602245,3563782509,235536,235536,492063,727599,293203537.3999918,3308972.1166666015,173797,0,99,0.4135464727136743,3248702371,-14929,-14929,33275703.533341587,-38737.749999937136,-6443,0,40,0.5656110336211209,-3214100126,1479.9133342701427,1244.835343217138,235.07799105300478,0.7586069345034382,0.7378787106854154,-6443
499,2018-05-15,2018,218310,218310,326840010.7333337,3265505.833333331,166842,0,138,0.9722916952956808,34280718,3569179276,220405,220405,512916,733321,290810807.8166792,3261603.549999522,168606,0,95,0.370843055087737,3207716555,-2095,-2095,36029202.91665453,3902.283333809115,-1764,0,43,0.6014486402079438,-3173435837,1497.137147786788,1319.4383422185485,177.69880556823955,0.7642435069396729,0.7649826455842653,-1764
500,2018-05-16,2018,219263,219263,327260211.2333336,3260236.749999996,166190,0,139,0.9644354040581401,34336731,3576262378,221681,221681,517746,739427,291083748.1166628,3255561.46666667,168298,0,105,0.40591430932330486,3211352010,-2418,-2418,36176463.11667079,4675.283333325759,-2108,0,34,0.5585210947348352,-3177015279,1492.546445288688,1313.0748603473585,179.4715849413294,0.7579482174375065,0.7591900072626883,-2108
501,2018-05-17,2018,220038,220038,327635904.8999999,3263707.683333331,167417,0,141,0.9875248820658252,34423109,3580870296,222513,222513,533246,755759,291513863.5666647,3259499.5333333067,169715,0,102,0.4120665450229487,3218138712,-2475,-2475,36122041.33333522,4208.150000024121,-2298,0,39,0.5754583370428765,-3183715603,1488.9969228042426,1310.0981226564952,178.89880014774735,0.7608549432370773,0.7627194815583809,-2298
502,2018-05-18,2018,219014,219014,328017718.45000035,3262345.683333336,168282,0,155,0.9878500917749549,33542556,3586882309,221567,221566,545999,767566,292030345.6166618,3258717.8333333377,170569,0,155,0.39494063051255845,3226675452,-2553,-2552,35987372.83333856,3627.8499999982305,-2287,0,0,0.5929094612623964,-3193132896,1497.7020576310206,1318.0286940083847,179.67336362263586,0.7683618398823819,0.769830344771559,-2287
503,2018-05-19,2018,222060,222060,328140344.98333365,3277253.166666667,168174,0,142,0.9816085742592077,35739762,3594674034,224377,224377,558377,782754,292317507.74999654,3274752.8333332953,170229,0,114,0.3880235680686442,3238246674,-2317,-2317,35822837.233337104,2500.333333371673,-2055,0,28,0.5935850061905634,-3202506912,1477.7102809300804,1302.7962213150035,174.9140596150769,0.7573358551742773,0.7586740173903742,-2055
504,2018-05-20,2018,218306,218306,328448257.5499999,3259781.98333333,167426,0,146,1.0334530429763733,34343998,3600097022,221042,221042,573461,794503,292843618.116663,3256626.0833333326,169895,0,105,0.4079959421172758,3250173379,-2736,-2736,35604639.43333691,3155.8999999975786,-2469,0,41,0.6254571008590974,-3215829381,1504.5315179152194,1324.832466755924,179.69905115929532,0.7669326541643381,0.7686095855086363,-2469
505,2018-05-21,2018,222216,222216,329048691.5500006,3285049.083333337,169493,0,149,1.0270907585412394,34724283,3608636315,224776,224776,585558,810334,293540012.66666824,3279686.899999477,171756,0,108,0.3935118111790809,3262233062,-2560,-2560,35508678.88333237,5362.183333860245,-2263,0,41,0.6335789473621585,-3227508779,1480.7605732710542,1305.9223968157999,174.83817645525437,0.7627398567159881,0.764120724632523,-2263
506,2018-05-22,2018,218979,218979,328640382.1333334,3258661.366666664,166793,0,141,0.9856744254015227,33739529,3608729343,221098,221098,599387,820485,293332997.866665,3253669.6166666513,168693,0,114,0.34652918700525104,3267857069,-2119,-2119,35307384.26666838,4991.750000012573,-1900,0,27,0.6391452383962717,-3234117540,1500.7849251906957,1326.7103178982397,174.074607292456,0.7616849104252006,0.7629784077648826,-1900
507,2018-05-23,2018,219828,219828,329022646.8500004,3299691.150000003,168071,0,142,0.9934357770620669,33967766,3614812822,222305,222305,611639,833944,293991254.23333985,3295990.366666157,170188,0,101,0.35761633874695486,3273570776,-2477,-2477,35031392.616660535,3700.783333846368,-2117,0,41,0.635819438315112,-3239603010,1496.727654575397,1322.4680247108245,174.25962986457262,0.7645568353439962,0.7655608285913498,-2117
508,2018-05-24,2018,225467,225467,329871704.8833339,3352093.000000002,170824,0,281,0.996074813609086,33341141,3624376068,227759,227758,621496,849255,294931291.133344,3347420.833332795,172799,0,281,0.3544082754885227,3282160557,-2292,-2291,34940413.74998993,4672.1666672066785,-1975,0,0,0.6416665381205633,-3248819416,1463.0598042433435,1294.9327405989866,168.1270636443569,0.7576452429845609,0.7586923019507462,-1975
509,2018-05-25,2018,222138,222138,330368437.2833327,3320532.400000003,170420,0,243,1.0443823208996217,33293410,3632514429,224953,224953,636575,861528,295539732.1833393,3315988.599999454,173005,0,243,0.38838435895292495,3292160101,-2815,-2815,34828705.09999341,4543.800000549294,-2585,0,0,0.6559979619466967,-3258866691,1487.2216247707854,1313.7843557691576,173.43726900162778,0.7671807615086118,0.7690717616568794,-2585
510,2018-05-26,2018,219280,219280,330512650.65000015,3311731.083333327,168803,0,212,1.0976924480116743,32636739,3636601874,222750,222750,651740,874490,295825279.5666636,3306855.4833333213,172076,0,212,0.4766526775606332,3302426112,-3470,-3470,34687371.08333653,4875.600000005681,-3273,0,0,0.6210397704510411,-3269789373,1507.263091253193,1328.0596164608917,179.20347479230122,0.769805727836556,0.7725072951739619,-3273
511,2018-05-27,2018,218463,218463,330804295.2333334,3264605.3166666664,166524,0,147,1.0520271167199935,32046394,3639956507,221692,221692,662781,884473,296364197.79999757,3259774.683333294,168922,0,123,0.3694606844980021,3311409836,-3229,-3229,34440097.43333584,4830.633333372418,-2398,0,24,0.6825664322219913,-3279363442,1514.2348829473797,1336.8285630514297,177.40631989595,0.7622526469013059,0.7619670533893871,-2398
512,2018-05-28,2018,217617,217617,331388063.4166668,3315893.3,167909,0,139,1.0318357481262939,32371445,3648216539,219855,219855,678396,898251,297032167.18332815,3311519.5833333237,170015,0,139,0.35070820962069504,3322223211,-2238,-2238,34355896.233338654,4373.716666676104,-2106,0,0,0.6811275385055988,-3289851766,1522.8041164829347,1351.0366704570201,171.76744602591452,0.7715803452855245,0.7733051329285211,-2106
513,2018-05-29,2018,217918,217918,331808803.5499997,3316592.4166666702,168048,0,135,1.0163914867060084,32309917,3652995925,219863,219862,686396,906259,297619034.166663,3312037.566666688,169794,0,137,0.3170120241564507,3327212352,-1945,-1944,34189769.38333672,4554.849999982398,-1746,0,-2,0.6993794625495577,-3294902435,1522.63146481704,1353.6629074904395,168.9685573266006,0.7711524518396828,0.7722718238175591,-1746
514,2018-05-30,2018,215944,215944,332405616.0333336,3272988.883333337,167371,0,133,0.9779155707035163,29021111,3656636634,218030,218030,697825,915855,298328290.1333285,3270286.533333333,169264,0,95,0.2993858198077238,3332799028,-2086,-2086,34077325.9000051,2702.3500000038184,-1893,0,38,0.6785297508957926,-3303777917,1539.3139704429557,1368.2900983044924,171.02387213846328,0.7750666839550995,0.7763335320827409,-1893
515,2018-05-31,2018,211653,211653,332426272.19999963,3147196.0,164388,0,156,1.016649893930159,27914492,3656025188,214021,214021,712447,926468,298508174.8333297,3142688.1166666737,166436,0,104,0.3045383110911525,3335768389,-2368,-2368,33918097.36666995,4507.883333326317,-2048,0,52,0.7121115828390064,-3307853897,1570.6192314779362,1394.7611441556187,175.8580873223175,0.7766863687261697,0.7776620051303377,-2048
516,2018-06-01,2018,215080,215080,332767802.51666677,3163112.166666665,167028,0,151,1.0103589362097822,30073144,3659094550,217390,217389,284161,501551,298907687.81666636,3158892.783333093,169291,0,103,0.5933913001868002,3308872000,-2310,-2309,33860114.700000405,4219.3833335721865,-2263,0,48,0.41696763602298204,-3278798856,1547.1815255563827,1374.989938850017,172.19158670636557,0.7765854565742979,0.7787432724596347,-2263
517,2018-06-02,2018,217609,217609,333023213.5333336,3302188.583333332,168314,0,138,0.9798721560229597,29250069,3660842162,219551,219551,299477,519028,299261703.60000914,3297190.316666605,170198,0,94,0.5455890626324604,3312207440,-1942,-1942,33761509.933324456,4998.266666727141,-1884,0,44,0.4342830933904993,-3282957371,1530.374265463899,1363.0623572655518,167.31190819834728,0.7734698472949189,0.7752094046485782,-1884
518,2018-06-03,2018,218767,218767,333596335.4499999,3304268.6833333313,169159,0,145,0.9555280275361462,31274079,3667394540,220655,220655,308739,529394,299960226.28333247,3299647.033333116,170864,0,101,0.5090764156752734,3321013692,-1888,-1888,33636109.16666746,4621.650000215042,-1705,0,44,0.4464516118608728,-3289739613,1524.8933132053735,1359.4082449223106,165.4850682830629,0.7732381940603473,0.7743490970066393,-1705
519,2018-06-04,2018,214829,214829,334302276.13333356,3300688.7499999977,167044,0,130,0.9492619711491453,31828851,3675757779,216934,216934,324995,541929,300833553.6500023,3298047.8499997584,168694,0,101,0.48203177907069733,3331979786,-2105,-2105,33468722.483331263,2640.9000002392568,-1650,0,29,0.467230192078448,-3300150935,1556.1319753540424,1386.7515172817646,169.38045807227786,0.7775672744368777,0.7776282187209013,-1650
520,2018-06-05,2018,215863,215863,334827622.83333296,3311204.3833333342,167242,0,122,0.9599190227134804,32524701,3680217580,217770,217770,335484,553254,301479293.1500132,3309286.1166665126,168769,0,95,0.46447020717427984,3337495957,-1907,-1907,33348329.683319747,1918.2666668216698,-1527,0,27,0.49544881553920056,-3304971256,1551.1116904394592,1384.3931356477624,166.71855479169676,0.7747599171696863,0.7749873719979795,-1527
521,2018-06-06,2018,218041,218041,335370338.88333315,3322134.566666668,168612,0,124,0.9504450997748124,32346801,3686846291,219692,219692,349439,569131,302107880.58334506,3317954.8666665335,170055,0,105,0.45981856549722405,3346604961,-1651,-1651,33262458.29998809,4179.700000134297,-1443,0,19,0.49062653427758834,-3314258160,1538.1067729616593,1375.1428389897906,162.96393397186876,0.7733041033567082,0.7740609580685687,-1443
522,2018-06-07,2018,217183,217183,335805459.8333331,3317974.9166666674,168545,0,112,0.9057062477265714,32510147,3690647258,226529,226529,361692,588221,302686979.6666686,3320328.2833330566,171671,0,75,0.3732984711528586,3356445946,-9346,-9346,33118480.16666448,-2353.3666663891636,-3126,0,37,0.5324077765737127,-3323935799,1546.1866713017735,1336.195275954375,209.99139534739857,0.7760506116961272,0.7578323305183884,-3126
523,2018-06-08,2018,221595,221595,336285228.2333329,3329771.7666666685,169855,0,134,0.9315417766646359,31796725,3696566880,223152,223152,377829,600981,299930524.55000854,3325377.399999911,171204,0,100,0.4199350728225968,3312452943,-1557,-1557,36354703.68332434,4394.366666757502,-1349,0,34,0.5116067038420391,-3280656218,1517.5668595109676,1344.0637975461054,173.50306196486213,0.7665109772332408,0.7672080017208002,-1349
524,2018-06-09,2018,217311,217311,336529965.2499994,3295321.1666666646,167801,0,128,0.9581705482005056,32651401,3702336476,218966,218966,391623,610589,300320237.5333456,3290943.9666665075,169445,0,89,0.4464083041129132,3321792491,-1655,-1655,36209727.716653824,4377.200000157114,-1644,0,39,0.5117622440875924,-3289141090,1548.6098966458183,1371.5382184144826,177.07167823133568,0.7721698395387256,0.7738416009791474,-1644
525,2018-06-10,2018,211919,211919,336521523.8166666,3250333.6499999994,166282,0,140,0.9261746233230626,31485845,3701400886,213620,213620,405885,619505,300566591.1666738,3246372.8166665696,167550,0,85,0.3755692044454852,3333589924,-1701,-1701,35954932.64999282,3960.8333334298804,-1268,0,55,0.5506054188775773,-3302104079,1587.9724036856846,1407.0152193927245,180.95718429296016,0.7846488516838981,0.7843366725961989,-1268
526,2018-06-11,2018,214431,214431,336776357.5666661,3280771.716666668,165308,0,138,0.9108058069961895,30727782,3704546101,215723,215723,419321,635044,301013677.8333422,3276891.1999998996,166406,0,109,0.36124898432233965,3341268532,-1292,-1292,35762679.73332393,3880.5166667685844,-1098,0,29,0.5495568226738499,-3310540750,1570.5581635428932,1395.371276281816,175.18688726107712,0.7709146531984647,0.7713873810395739,-1098
527,2018-06-12,2018,214695,214695,337261587.6999995,3279154.216666662,165443,0,129,0.8972542443932087,30707420,3709100642,219582,219582,426660,646242,301702074.8333519,3280406.4666664787,168331,0,94,0.34678340312142664,3342457664,-4887,-4887,35559512.8666476,-1252.2499998165295,-2888,0,35,0.550470841271782,-3311750244,1570.8870150678847,1373.9836363333602,196.9033787345245,0.7705954959360954,0.7665974442349555,-2888
528,2018-06-13,2018,210361,210361,337629549.14999956,3235892.5999999987,163432,0,133,0.8941058466160557,30369490,3712915021,211817,211817,444328,656145,301536972.76667464,3233663.3166665416,164282,0,90,0.32407470909631325,3339688973,-1456,-1456,36092576.38332492,2229.283333457075,-850,0,43,0.5700311375197424,-3309319483,1605.000685250591,1423.573050164409,181.4276350861819,0.776912070203127,0.7755845848066963,-850
529,2018-06-14,2018,209899,209899,337634554.40000015,3230134.3833333333,162391,0,128,0.9272507253488579,29599817,3714231231,211465,211465,454251,665716,301648595.78334224,3230389.9666665397,163560,0,101,0.34864717086565805,3337580064,-1566,-1566,35985958.61665791,-255.58333320636302,-1169,0,27,0.5786035544831998,-3307980247,1608.557231811491,1426.4705543865048,182.0866774249862,0.7736625710460745,0.7734613292979926,-1169
530,2018-06-15,2018,212509,212509,337813289.46666646,3248974.6333333366,164652,0,126,0.9120225496331926,30706095,3716649179,213599,213599,465293,678892,302005564.16667837,3244257.5833332073,165611,0,89,0.32356251067916436,3342352807,-1090,-1090,35807725.29998809,4717.050000129268,-959,0,37,0.5884600389540282,-3311646712,1589.64227146458,1413.890346708919,175.7519247556611,0.7748001261123059,0.7753360268540583,-959
531,2018-06-16,2018,212667,212667,338201106.9666667,3271740.8333333344,165335,0,121,0.9263449430330047,30559121,3720706022,214123,214123,476878,691001,302531214.48334205,3267186.266666504,166627,0,87,0.3418041363181801,3349336262,-1456,-1456,35669892.48332465,4554.566666830331,-1292,0,34,0.5845408067148247,-3318777141,1590.2848442243821,1412.885185072795,177.39965915158723,0.777436085523377,0.7781835673888372,-1292
532,2018-06-17,2018,215340,215340,338539624.5999999,3258246.9,165507,0,135,0.9315268877124563,31291638,3724693884,216901,216901,486345,703246,303001427.2666745,3252806.216666552,167028,0,86,0.35387759048753265,3360667963,-1561,-1561,35538197.333325386,5440.683333448134,-1521,0,49,0.5776492972249236,-3329376325,1572.1167669731583,1396.957262837306,175.15950413585233,0.7685845639453887,0.7700656059676996,-1521
533,2018-06-18,2018,210278,210278,338931616.78333324,3253317.4000000027,162810,0,132,0.9358325645098389,31363350,3729732812,211811,211811,502277,714088,303555982.416671,3248585.5833326504,164220,0,91,0.3407283135972065,3369339255,-1533,-1533,35375634.366662264,4731.816667352337,-1410,0,41,0.5951042509126323,-3337975905,1611.8263288757419,1433.1455043254173,178.6808245503246,0.774260740543471,0.7753138411130678,-1410
534,2018-06-19,2018,212851,212851,339293536.09999985,3279004.1666666646,165422,0,136,0.9435473641185612,31202382,3732725113,214473,214473,510592,725065,304136327.5833347,3274035.116666476,166729,0,96,0.33203505892575014,3372913618,-1622,-1622,35157208.51666516,4969.050000188872,-1307,0,40,0.6115123051928111,-3341711236,1594.0424808903874,1418.06347457878,175.97900631160746,0.7771727640462107,0.7773892284809742,-1307
535,2018-06-20,2018,215209,215209,340015247.9000006,3342694.3166666655,168414,0,123,0.9448861339442136,31702232,3740358690,216889,216889,519601,736490,304998058.00000477,3336530.133332717,170013,0,82,0.345768442205583,3380121993,-1680,-1680,35017189.899995804,6164.183333948255,-1599,0,41,0.5991176917386306,-3348419761,1579.9304299541402,1406.2403256965765,173.6901042575637,0.782560208913196,0.7838710123611617,-1599
536,2018-06-21,2018,215418,215418,340507541.7500001,3334586.316666667,167771,0,115,0.9333667567241364,30091915,3744464234,217077,217077,528488,745565,305645257.1833268,3328684.9333333075,169257,0,89,0.32886602777759005,3386634917,-1659,-1659,34862284.56667334,5901.383333359379,-1486,0,26,0.6045007289465463,-3356543002,1580.682866566397,1408.0038750458446,172.67899152055247,0.7788160692235561,0.7797095040008845,-1486
537,2018-06-22,2018,221190,221190,340906348.4666665,3352765.483333331,170607,0,871,0.9401690854016915,32486790,3749530525,222994,222994,537966,760960,306220996.7999988,3347426.599999942,172268,0,871,0.3452835891505438,3395794361,-1804,-1804,34685351.6666677,5338.883333389182,-1661,0,0,0.5948854962511477,-3363307571,1541.2376168301755,1373.2252742226194,168.0123426075561,0.7713142547131425,0.7725230275254042,-1661
538,2018-06-23,2018,221717,221717,341079682.95000017,3373432.0666666664,170405,0,225,0.9295182597635723,32618376,3753543653,222575,222575,552054,774629,306492289.48333687,3363022.66666596,171446,0,225,0.31014201637170147,3403755062,-858,-858,34587393.4666633,10409.400000706315,-1041,0,0,0.6193762433918708,-3371136686,1538.3560256994283,1377.0292687109372,161.32675698849107,0.7685698435392866,0.7702841738739751,-1041
539,2018-06-24,2018,221877,221877,341247491.50000066,3348552.633333333,170954,0,122,0.91628695177959,33215758,3758216170,223332,223332,562829,786161,306877821.3833306,3343590.949999923,172294,0,92,0.3051003547619375,3412513677,-1455,-1455,34369670.11667007,4961.68333340995,-1340,0,30,0.6111865970176524,-3379297919,1538.0029994095858,1374.0880007492458,163.91499866033996,0.7704899561468742,0.7714702774344921,-1340
540,2018-06-25,2018,216129,216129,341351707.9999999,3333949.216666669,169235,0,634,0.9341735722647121,30572288,3758962609,217449,217449,576798,794247,307161545.43332934,3329574.8833332723,170409,0,634,0.28606718061257896,3418894927,-1320,-1320,34190162.56667054,4374.3333333968185,-1174,0,0,0.6481063916521331,-3388322639,1579.388735431154,1412.5682133894813,166.82052204167258,0.7830277288101087,0.7836734130761696,-1174
541,2018-06-26,2018,218873,218873,341254464.3,3346104.9333333336,169025,0,229,0.8993891434758972,33047499,3760909205,220397,220397,583970,804367,307311993.5000024,3342126.383333142,170119,0,229,0.26954735835756727,3422668257,-1524,-1524,33942470.79999763,3978.550000191666,-1094,0,0,0.6298417851183299,-3389620758,1559.1437239860559,1394.3565180106916,164.78720597536426,0.772251488306004,0.7718752977581365,-1094
542,2018-06-27,2018,221038,221038,342001057.05000013,3364335.1666666656,171200,0,114,0.9215338539074742,32596638,3769063594,222842,222842,594766,817608,308193591.11666274,3360515.9166666805,172623,0,84,0.29785422843220727,3431218460,-1804,-1804,33807465.93333739,3819.249999985099,-1423,0,30,0.623679625475267,-3398621822,1547.2500522534592,1383.013934162603,164.23611809085628,0.7745274568173798,0.7746430206155034,-1423
543,2018-06-28,2018,222206,222206,342655076.216667,3364600.6333333314,171661,0,111,0.917634987354077,32582938,3774869150,223969,223969,605715,829684,309001374.00000244,3361681.516666276,172936,0,85,0.2854809783001779,3440416416,-1763,-1763,33653702.21666455,2919.116667055525,-1275,0,26,0.6321540090538991,-3407833478,1542.0604133851787,1379.661354919665,162.3990584655137,0.7725308947553171,0.7721425733025553,-1275
544,2018-06-29,2018,222156,222156,343010556.36666673,3368407.716666666,173871,0,103,0.9156718702173253,32241600,3779523409,223575,223575,618001,841576,309494433.7333455,3364009.83333273,175004,0,72,0.2743412359668058,3450455000,-1419,-1419,33516122.633321226,4397.883333935868,-1133,0,31,0.6413306342505195,-3418213400,1544.0076179201405,1384.298037496793,159.70958042334746,0.7826527305136931,0.7827529911662753,-1133
545,2018-06-30,2018,221451,221451,343204621.4499999,3359731.3333333293,172426,0,107,0.8932179127662547,32958590,3784371548,222568,222568,628741,851309,309774525.866663,3355178.4333333243,173450,0,75,0.25938995123980046,3458153374,-1117,-1117,33430095.58333695,4552.900000005029,-1024,0,32,0.6338279615264543,-3425194784,1549.7993752568284,1391.819694954634,157.9796803021943,0.7786191979264036,0.7793123899212825,-1024
546,2018-07-01,2018,218197,218197,343197087.2333332,3316759.35,170109,0,123,0.9084130395926611,33432572,3787191259,219500,219500,273802,493302,309931701.8000065,3312464.016666482,171319,0,82,0.46928453563942035,3445858220,-1303,-1303,33265385.43332666,4295.33333351789,-1210,0,41,0.4391285039532407,-3412425648,1572.8772037806807,1411.9895298405763,160.88767394010438,0.7796120019981942,0.780496583143508,-1210
547,2018-07-02,2018,218378,218378,343460536.6166672,3319999.9833333343,169345,0,107,0.907160977754169,34184873,3794593491,224696,224696,290712,515408,310253656.7000004,3317319.8833330227,171836,0,82,0.4451677117933788,3455378032,-6318,-6318,33206879.916666806,2680.1000003116205,-2491,0,25,0.46199326596079027,-3421193159,1572.779934868289,1380.7707155445598,192.0092193237292,0.7754673089780106,0.7647488161783031,-2491
548,2018-07-03,2018,221888,221888,343546953.25,3344451.3000000003,172376,0,119,0.895041642630517,34035347,3795812480,223643,223643,303715,527358,308139365.0333446,3340272.4999998305,173587,0,80,0.42262372050864366,3418121181,-1755,-1755,35407588.21665537,4178.80000016978,-1211,0,39,0.47241792212187333,-3384085834,1548.2899176611625,1377.8180628651226,170.4718547960399,0.7768603980386501,0.776178999566273,-1211
549,2018-07-04,2018,222608,222608,340772798.8999997,3370950.9333333317,172385,0,119,0.907532523539135,34603598,3763115918,229697,229697,314624,544321,305680275.18334144,3382654.0166665176,174736,0,91,0.4342566243080754,3393217021,-7089,-7089,35092523.716658235,-11703.083333185874,-2351,0,28,0.47327589923105967,-3358613423,1530.8200913713779,1330.7978562338274,200.02223513755052,0.7743881621505068,0.7607239101947348,-2351
550,2018-07-05,2018,221219,221219,341315693.3333333,3356708.599999996,171878,0,128,0.9427128772845005,35154943,3772110026,223113,223112,331821,554934,305802951.13334477,3352066.7166665224,173501,0,89,0.4523060399975487,3393779563,-1894,-1893,35512742.199988544,4641.883333473466,-1623,0,39,0.4904068372869518,-3358624620,1542.8859787510717,1370.625296413213,172.26068233785873,0.7769585795071852,0.777637340719725,-1623
551,2018-07-06,2018,216713,216713,341208963.7000001,3301330.116666668,169731,0,125,0.9346924273116987,34293909,3774758138,218667,218667,344160,562827,305953341.60000813,3297285.4166665324,171221,0,89,0.42432932322011246,3403980860,-1954,-1954,35255622.09999198,4044.7000001356937,-1490,0,36,0.5103631040915861,-3369686951,1574.4739065030715,1399.1747341848936,175.29917231817785,0.7832063604859884,0.7830216722230606,-1490
552,2018-07-07,2018,217237,217237,341122598.54999995,3306927.316666667,169911,0,125,0.9293628617592765,33902090,3778233525,220847,220847,357836,578683,305926030.2333478,3304040.033333189,171854,0,85,0.39994262834747235,3412950072,-3610,-3610,35196568.31665218,2887.28333347803,-1943,0,40,0.5294202334118041,-3379047982,1570.2785370355875,1385.2396918832846,185.03884515230288,0.782145767065463,0.7781586347109084,-1943
553,2018-07-08,2018,216126,216126,341434210.1999997,3301295.2333333353,171723,0,116,0.922993994244098,33564706,3783697692,217417,217417,370474,587891,306082089.00000876,3296587.149999871,172803,0,79,0.38140233478655144,3417862804,-1291,-1291,35352121.19999093,4708.083333464339,-1080,0,37,0.5415916594575465,-3384298098,1579.7923905499556,1407.8112061154775,171.9811844344781,0.7945504011548818,0.7947998546571795,-1080
554,2018-07-09,2018,217535,217535,341836885.5333335,3318728.8666666686,170692,0,125,0.9123221550555082,34502292,3792128068,218779,218779,380341,599120,306659735.6166785,3314085.966666504,171750,0,125,0.3643610628922425,3426371889,-1244,-1244,35177149.916655004,4642.900000164751,-1058,0,0,0.5479610921632656,-3391869597,1571.4109708016342,1401.6872534232193,169.7237173784149,0.7846645367412141,0.7850387834298539,-1058
555,2018-07-10,2018,215272,215272,342005653.80000013,3324737.266666665,169766,0,119,0.9151817235869044,34216651,3797567535,216645,216645,391597,608242,306994618.50001264,3320604.5166664524,170889,0,76,0.36263855504881604,3431706327,-1373,-1373,35011035.299987495,4132.750000212807,-1123,0,43,0.5525431685380884,-3397489676,1588.7140631387274,1417.03994322515,171.67411991357744,0.7886116169311382,0.7887973412725888,-1123
556,2018-07-11,2018,215529,215529,342359006.34999996,3326667.8166666673,169656,0,109,0.9110050155663518,33081297,3803368605,216504,216504,402490,618994,307492510.95001036,3322038.149999855,170510,0,88,0.358257107500228,3439151511,-975,-975,34866495.399989605,4629.666666812263,-854,0,21,0.5527479080661238,-3406070214,1588.4591231342417,1420.2624937645971,168.1966293696446,0.7871608925017051,0.7875605069652293,-854
557,2018-07-12,2018,221802,221802,342992942.20000005,3361389.049999995,174115,0,113,0.9015112577884781,31078645,3808422643,223100,223100,411743,634843,308337382.55001366,3358325.8499998786,175075,0,73,0.35512087240467227,3446423918,-1298,-1298,34655559.64998639,3063.2000001166016,-960,0,40,0.5463903853838058,-3415345273,1546.3924680570963,1382.0590880771567,164.33337997993954,0.7850019386660174,0.7847377857463022,-960
558,2018-07-13,2018,226899,226899,343575475.53333396,3416231.700000002,177971,0,114,0.907963455105576,35828842,3816818032,228352,228352,421151,649503,309104195.3833422,3412080.1166665694,179100,0,79,0.36013690467942194,3458721297,-1453,-1453,34471280.14999175,4151.583333432674,-1129,0,35,0.547826550426154,-3422892455,1514.2220791335967,1353.6303399284534,160.5917392051433,0.7843622052102477,0.7843154428251121,-1129
559,2018-07-14,2018,225275,225275,344034648.93333286,3420498.7666666675,176465,0,94,0.8791787814892896,36066782,3825308115,226504,226504,434151,660655,309707532.7333424,3418039.8833331624,177275,0,72,0.3208770084234593,3468840725,-1229,-1229,34327116.19999045,2458.8833335051313,-810,0,22,0.5583017730658304,-3432773943,1527.1763352938979,1367.3380281731995,159.83830712069835,0.783331483742093,0.7826572599159397,-810
560,2018-07-15,2018,222999,222999,344853134.583333,3391816.3833333347,175140,0,105,0.8996497742142348,36148078,3837341951,224416,224416,446917,671333,310693999.9166749,3388500.949999848,176091,0,76,0.32871019300406223,3485373642,-1417,-1417,34159134.6666581,3315.4333334867842,-951,0,29,0.5709395812101725,-3449225564,1546.4335471608977,1384.4556534145288,161.97789374636886,0.7853846878237122,0.7846633038642521,-951
561,2018-07-16,2018,226068,226068,345611069.5666668,3402336.9499999983,175649,0,119,0.918750110586195,36033392,3850703347,227993,227993,462126,690119,311647863.5666779,3399335.44999984,177179,0,82,0.3590105474563067,3502206041,-1925,-1925,33963205.999988854,3001.500000158325,-1530,0,37,0.5597395631298884,-3466172649,1528.792529533887,1366.91856138863,161.8739681452571,0.7769741847585682,0.7771247362857632,-1530
562,2018-07-17,2018,224565,224565,346091768.1499999,3423072.683333333,175768,0,113,0.9327544363547308,36139556,3858272647,226835,226835,473978,700813,312249855.2166766,3420023.6666665017,177143,0,87,0.3511592964171659,3508221973,-2270,-2270,33841912.933323324,3049.0166668314487,-1375,0,26,0.5815951399375648,-3472082417,1541.1652223187048,1376.5505994078364,164.61462291086832,0.7827043395008126,0.7809332774924505,-1375
563,2018-07-18,2018,224563,224563,346793219.8166669,3450617.149999999,177192,0,126,0.9493594225228553,35963805,3867474839,232714,232714,484299,717013,313152943.6166702,3460092.0499995346,179897,0,85,0.3654215474475309,3519715889,-8151,-8151,33640276.19999671,-9474.899999535643,-2705,0,41,0.5839378750753244,-3483752084,1544.3025779699544,1345.6557990351685,198.64677893478597,0.7890525153297738,0.7730390092559967,-2705
564,2018-07-19,2018,231380,231380,347227461.1166664,3482438.75,180236,0,127,0.9488417322154037,35992829,3876680785,233244,233244,497744,730988,312839805.7333297,3476855.4999999823,181920,0,87,0.36740958811908836,3521205122,-1864,-1864,34387655.38333666,5583.250000017695,-1684,0,40,0.5814321440963153,-3485212293,1500.6805303685123,1341.2555338329378,159.42499653557456,0.7789610165096378,0.7799557544888615,-1684
565,2018-07-20,2018,232531,232531,347761454.01666707,3483192.883333328,182666,0,122,0.9325982342139317,36007579,3883859658,238545,238545,504857,743402,313542845.5666594,3483941.4999999385,184504,0,84,0.3318742752911545,3530963329,-6014,-6014,34218608.45000768,-748.6166666103527,-1838,0,38,0.6007239589227773,-3494955750,1495.5487828146229,1314.3970553424276,181.15172747219526,0.7855554743238536,0.7734557421031671,-1838
566,2018-07-21,2018,224152,224152,347711080.7333338,3434609.0999999978,177180,0,122,0.9215487704771762,34716492,3887641191,225554,225554,524307,749861,313194783.8333303,3429114.9999999716,178497,0,72,0.3156585020423785,3533537890,-1402,-1402,34516296.90000355,5494.10000002617,-1317,0,50,0.6058902684347978,-3498821398,1551.228990744378,1388.5578789705803,162.67111177379775,0.7904457689425033,0.7913714675864759,-1317
567,2018-07-22,2018,219832,219832,347408648.2333335,3349964.000000004,172432,0,237,0.905950907966083,34519279,3889406571,220890,220890,535577,756467,313074357.0999971,3344730.583333293,173366,0,237,0.2946143057132698,3546235420,-1058,-1058,34334291.133336425,5233.416666711215,-934,0,0,0.6113366022528133,-3511716141,1580.3370220592703,1417.3315093485314,163.0055127107389,0.7843807998835475,0.7848521888722894,-934
568,2018-07-23,2018,224183,224183,347828437.2499997,3413332.966666671,176814,0,300,0.9110191227702378,34334286,3895163041,225241,225241,549230,774471,313684306.40001345,3408071.616665908,177799,0,300,0.2899269307695149,3554852158,-1058,-1058,34144130.849986255,5261.350000762846,-985,0,0,0.6210921920007229,-3520517872,1551.5379723261785,1392.6607784551368,158.87719387104175,0.7887038713907835,0.7893722723660435,-985
569,2018-07-24,2018,228091,228091,348105113.8833326,3458647.516666662,180109,0,112,0.9259374547877819,35635817,3901466574,229506,229506,553605,783111,314113111.1833298,3454436.8333332874,181302,0,75,0.31307183783652565,3558299173,-1415,-1415,33992002.70000279,4210.68333337456,-1193,0,37,0.6128656169512563,-3522663356,1526.167686946581,1368.6487986515813,157.51888829499967,0.7896365924126774,0.789966275391493,-1193
570,2018-07-25,2018,231988,231988,348883900.63333416,3521561.149999996,183596,0,117,0.9330827456592572,35637196,3910400831,233554,233554,561195,794749,315061355.8666705,3517843.9666660116,184932,0,81,0.32490509582270705,3566823964,-1566,-1566,33822544.76666367,3717.183333984576,-1336,0,36,0.6081776498365501,-3531186768,1503.8877038180171,1348.9871972506164,154.90050656740073,0.7914030036036347,0.7918168817489746,-1336
571,2018-07-26,2018,231059,231059,349563143.0833331,3510405.4999999977,182142,0,111,0.910745740265472,34183709,3916939429,232487,232487,570880,803367,315962975.3333286,3509861.9166666493,183279,0,91,0.28556935995628235,3575664898,-1428,-1428,33600167.75000447,543.5833333483897,-1137,0,20,0.6251763803091896,-3541481189,1512.873954632077,1359.0565293256336,153.81742530644328,0.7882921678012975,0.7883408534670756,-1137
572,2018-07-27,2018,232077,232077,350072620.76666635,3511302.649999998,182804,0,120,0.914325848748476,32994301,3919628565,233259,233258,582033,815292,316511096.98333144,3507511.3833332704,183922,0,93,0.29395725703184067,3578725986,-1182,-1181,33561523.78333491,3791.266666727606,-1118,0,27,0.6203685917166353,-3545731685,1508.4330664678807,1356.9142193765335,151.5188470913472,0.7876868453142707,0.7884883327117067,-1118
573,2018-07-28,2018,225872,225872,350090973.61666644,3479319.399999998,178931,0,121,0.9393019055040016,33747107,3923164834,227131,227131,595527,822658,316640305.2166637,3472468.399999977,180063,0,77,0.3010169475043065,3589206523,-1259,-1259,33450668.400002718,6851.000000020955,-1132,0,44,0.6382849579996951,-3555459416,1549.9529539591736,1394.0866954165822,155.86625854259137,0.792178756109655,0.792771572352519,-1132
574,2018-07-29,2018,223713,223713,350193961.63333315,3434842.7333333343,177831,0,122,0.9274874504387316,32636292,3926124982,225039,225038,607607,832646,316929514.3166618,3429078.9499999853,178984,0,74,0.2760909197906472,3598914333,-1326,-1325,33264447.31667137,5763.783333349042,-1153,0,48,0.6513965306480844,-3566278041,1565.3715324247278,1408.3377665845846,157.03376584014313,0.7949068672808465,0.7953465843698203,-1153
575,2018-07-30,2018,225116,225116,350617738.9833338,3475048.449999995,180166,0,108,0.9308401002150001,31782551,3930316499,226271,226271,617247,843518,317459843.31667656,3468523.216666192,181212,0,103,0.27929694446355513,3604875290,-1155,-1155,33157895.66665727,6525.233333803248,-1046,0,5,0.651543155751445,-3573092739,1557.498085357477,1403.0072051507996,154.4908802066775,0.8003251656923541,0.8008626823587645,-1046
576,2018-07-31,2018,231257,231257,350980542.1166662,3510993.3999999994,183532,0,152,0.9509117561846778,32641171,3933459890,232654,232654,621463,854117,318050210.4333426,3506554.3166661863,184795,0,152,0.30202419574835837,3607097976,-1397,-1397,32930331.68332362,4439.08333381312,-1263,0,0,0.6488875604363195,-3574456805,1517.7077542157263,1367.0524058616768,150.65534835404947,0.7936278685618166,0.7942910932113783,-1263
577,2018-08-01,2018,242043,242043,351384626.2333329,3602122.7166666645,189180,0,247,0.9095367352082063,33088847,3935176797,243647,243647,275608,519255,318703107.28334534,3596982.883333182,190616,0,250,0.4855109724509144,3590916203,-1604,-1604,32681518.94998753,5139.8333334825,-1436,0,-3,0.4240257627572919,-3557827356,1451.7446331161525,1308.0526634161115,143.691969700041,0.781596658444987,0.7823449498659947,-1436
578,2018-08-02,2018,242172,242172,350910908.16666734,3598296.216666664,190072,0,209,0.8921303866673278,33976581,3926594785,243387,243387,290119,533506,318249077.20000994,3591228.1999998093,191146,0,209,0.4351122574066625,3589556973,-1215,-1215,32661830.9666574,7068.016666854732,-1074,0,0,0.4570181292606653,-3555580392,1449.0151964994604,1307.5845349176823,141.43066158177817,0.784863650628479,0.7853582976905094,-1074
579,2018-08-03,2018,240844,240844,348982238.9833335,3538929.43333333,188976,0,208,0.9099084884821708,34586776,3902904225,242447,242447,308857,551304,316481851.20001733,3533470.0833332017,190086,0,208,0.4460243350311234,3574846663,-1603,-1603,32500387.783316195,5459.35000012815,-1110,0,0,0.4638841534510474,-3540259887,1448.9970229000246,1305.3650950517736,143.63192784825105,0.7846406802743685,0.7840311490758805,-1110
580,2018-08-04,2018,231470,231470,348647008.3666671,3516502.0333333346,184461,0,153,0.9192076727005647,34007432,3902106114,234678,234678,326755,561433,316371452.50001097,3513667.7666665027,185914,0,153,0.42001806092622873,3577838914,-3208,-3208,32275555.866656125,2834.2666668319143,-1453,0,0,0.49918961177433596,-3543831482,1506.2297851413448,1348.1086957448545,158.12108939649033,0.7969110467879207,0.7922088990020368,-1453
581,2018-08-05,2018,233076,233076,348463579.85000044,3513954.850000004,184109,0,91,0.895767904031303,34039510,3903157945,253519,253519,336136,589655,316016409.93335104,3533764.933333224,191670,0,92,0.389027482171779,3572070341,-20443,-20443,32447169.9166494,-19810.083333220333,-7561,0,-1,0.506740421859524,-3538030831,1495.0641844291151,1246.5196294295538,248.54455499956134,0.7899097290154284,0.7560380089855199,-7561
582,2018-08-06,2018,236228,236228,348416313.24999934,3501230.7833333337,186247,0,107,0.9105059518770011,33998803,3903411373,247443,247443,352133,599576,307197875.9500176,3501623.083333212,190637,0,107,0.41027325977024026,3394455036,-11215,-11215,41218437.29998177,-392.29999987827614,-4390,0,0,0.5002326921067608,-3360456233,1474.9153921211682,1241.4894579762513,233.42593414491694,0.7884205089997799,0.7704279369390122,-4390
583,2018-08-07,2018,234070,234070,346872035.0333335,3421123.0833333354,183122,0,111,0.9102405263382739,33337765,3886550763,247919,247919,361476,609395,303049693.4000209,3419595.1666666474,189039,0,68,0.4099426480361704,3327601331,-13849,-13849,43822341.63331258,1527.9166666879319,-5917,0,43,0.5002978783021035,-3294263566,1481.915815924012,1222.373813221338,259.5420027026739,0.782338616653138,0.7625030756013053,-5917
584,2018-08-08,2018,234493,234493,346783551.7166668,3510234.883333338,184404,0,107,0.9185135590401403,33917895,3884752863,237203,237203,376384,613587,300921298.4166804,3506372.0499999053,185730,0,70,0.3908133646899214,3288474082,-2710,-2710,45862253.29998642,3862.8333334326744,-1326,0,37,0.5277001943502189,-3254556187,1478.8652612942255,1268.6234930278301,210.2417682663954,0.786394476594184,0.7830002150057124,-1326
585,2018-08-09,2018,234296,234296,347322591.2333337,3518681.9499999993,184105,0,113,0.9172585106019732,33954395,3891583310,236564,236564,384646,621210,301596210.26667714,3514557.933333177,185456,0,66,0.3821718903430363,3295954129,-2268,-2268,45726380.966656566,4124.016666822135,-1351,0,47,0.5350866202589368,-3261999734,1482.409393388422,1274.9032408425505,207.50615254587137,0.7857795267524841,0.7839569841565073,-1351
586,2018-08-10,2018,236037,236037,347176900.2833336,3513019.6333333375,184318,0,115,0.9356372094205565,34160744,3892468921,238398,238398,396885,635283,301704790.5500122,3508967.733333162,186263,0,79,0.42736071955332305,3305507465,-2361,-2361,45472109.73332143,4051.900000175461,-1945,0,36,0.5082764898672334,-3271346721,1470.857959910241,1265.5508458544625,205.30711405577858,0.7808860475264471,0.7813110848245371,-1945
587,2018-08-11,2018,237669,237669,346926568.3166666,3539064.016666668,186777,0,108,0.933167556559753,34926184,3892546520,239326,239326,412161,651487,301765939.16667944,3533472.099999343,188261,0,76,0.38910523157023597,3314338210,-1657,-1657,45160629.14998716,5591.9166673249565,-1484,0,32,0.5440623249895171,-3279412026,1459.7047503741194,1260.8991048472772,198.80564552684223,0.7858702649483105,0.7866299524497965,-1484
588,2018-08-12,2018,227754,227754,346621954.95000035,3464065.9999999977,180101,0,120,0.9613706016140215,33392765,3891810780,230132,230132,424216,654348,301646199.73335034,3458334.0666665444,181899,0,79,0.4071931143672824,3322800537,-2378,-2378,44975755.21665001,5731.933333453257,-1798,0,41,0.5541774872467391,-3289407772,1521.9137971232135,1310.7529580125768,211.16083911063674,0.7907698657323252,0.7904115898701615,-1798
589,2018-08-13,2018,230867,230867,346873943.66666657,3464667.716666669,182309,0,133,0.9584392745606787,33625834,3895788613,233266,233266,439203,672469,302118098.3833463,3460503.566666557,184090,0,82,0.40023406283412255,3331031308,-2399,-2399,44755845.28332025,4164.150000112131,-1781,0,51,0.5582052117265561,-3297405474,1502.4838702225375,1295.165598001193,207.3182722213444,0.7896711093400096,0.7891848790651016,-1781
590,2018-08-14,2018,231141,231141,346835249.7333328,3469038.3000000007,181594,0,122,0.9373196447190243,33680047,3897301258,233138,233138,448266,681404,302316182.48334366,3464402.1999998693,183035,0,79,0.36804744322017896,3331745832,-1997,-1997,44519067.24998915,4636.10000013141,-1441,0,43,0.5692722014988454,-3298065785,1500.5353863370533,1296.7263272540026,203.80905908305067,0.785641664611644,0.7850929492403641,-1441
591,2018-08-15,2018,234893,234893,347025244.3166662,3493511.316666664,184599,0,123,0.9444896186774415,34898491,3901193809,237581,237581,459357,696938,302715003.1500096,3488277.933333213,186285,0,81,0.37397444248984996,3339352652,-2688,-2688,44310241.16665661,5233.383333451115,-1686,0,42,0.5705151761875915,-3304454161,1477.3758448172835,1274.1549330544512,203.2209117628322,0.7858854882861558,0.7840904786157142,-1686
592,2018-08-16,2018,234928,234928,347289549.56666696,3513322.200000002,185393,0,131,0.9626694136075727,34060686,3903730937,237808,237808,469881,707689,303267627.58332825,3509052.633333281,187191,0,114,0.38589973844442976,3347177489,-2880,-2880,44021921.98333871,4269.566666720901,-1798,0,17,0.576769675163143,-3313116803,1478.280790568459,1275.2625125451132,203.01827802334583,0.7891481645440305,0.7871518199555945,-1798
593,2018-08-17,2018,235781,235781,347204077.266667,3497577.316666662,186376,0,126,0.9538597257624664,33923440,3904549546,237453,237453,484137,721590,303502603.1333472,3491358.283332739,187816,0,124,0.3488615418728096,3353757286,-1672,-1672,43701474.133319795,6219.033333923202,-1440,0,2,0.6049981838896568,-3319833846,1472.5702124711788,1278.1586382709304,194.41157420024842,0.7904623358116218,0.7909607374933144,-1440
594,2018-08-18,2018,236010,236010,347032318.58333313,3521349.2499999986,186671,0,135,0.9617304351510525,35155729,3904933809,237793,237793,495856,733649,303487747.7833292,3515978.4666666263,188272,0,114,0.3591254128336583,3361201830,-1783,-1783,43544570.800003946,5370.783333372325,-1601,0,21,0.6026050223173942,-3326046101,1470.413620538677,1276.2686360966436,194.14498444203332,0.7909452989280116,0.7917474442056747,-1601
595,2018-08-19,2018,230009,230009,347238344.1833333,3484902.999999997,182671,0,128,0.948015077670874,34692334,3906111758,231513,231513,506757,738270,303905707.2166653,3479212.3666666304,184021,0,86,0.33301773064055346,3371821583,-1504,-1504,43332636.96666795,5690.63333336683,-1350,0,42,0.6149973470303205,-3337129249,1509.672857076607,1312.6939187720143,196.9789383045927,0.7941906621045264,0.7948624915231542,-1350
596,2018-08-20,2018,235883,235883,347737014.8666665,3537443.9833333306,186105,0,169,0.9109770521826495,34930262,3912022090,237310,237309,517743,755053,304666376.8833461,3533127.0333327237,187135,0,169,0.30159604690001135,3381373629,-1427,-1426,43070637.983320415,4316.950000606943,-1030,0,0,0.609381005282638,-3346443367,1474.1927772101699,1283.8382736573249,190.35450355284502,0.7889716511999593,0.788567696262273,-1030
597,2018-08-21,2018,244839,244839,348469868.18333346,3629750.900000002,194940,0,116,0.912673226079179,36123540,3920917420,246670,246670,520680,767350,305576587.14999723,3629396.133333276,196129,0,108,0.31306704893464615,3385161366,-1831,-1831,42893281.03333622,354.76666672574356,-1189,0,8,0.5996061771445329,-3349037826,1423.2612785680935,1238.8072613207817,184.45401724731187,0.7961966843517577,0.7951068228807718,-1189
598,2018-08-22,2018,240868,240868,349073337.4833341,3631789.033333335,190795,0,143,0.9007838318082927,35944663,3929899403,243307,243307,530015,773322,306354067.6666621,3630412.11666659,191869,0,144,0.29476466465456547,3396586131,-2439,-2439,42719269.81667203,1376.9166667452082,-1074,0,-1,0.6060191671537272,-3360641468,1449.2308545897924,1259.1255807135105,190.1052738762819,0.792114353089659,0.7885880800798991,-1074
599,2018-08-23,2018,246004,246004,349834982.2333338,3591784.366666663,192162,0,76,0.8874002048747174,36238211,3940601807,247612,247612,543708,791320,307313354.35000736,3588379.0166660706,193182,0,71,0.289550371531103,3409486537,-1608,-1608,42521627.88332647,3405.3500005924143,-1020,0,5,0.5978498333436144,-3373248326,1422.07030061842,1241.108485655006,180.9618149634141,0.7811336401034129,0.7801802820541816,-1020
600,2018-08-24,2018,238090,238090,350235936.8833335,3538075.2666666703,187044,0,69,0.8722079885757491,35586734,3949387481,239285,239285,562055,801340,307867124.3833256,3532978.5999999996,187815,0,58,0.2664162527765964,3416754629,-1195,-1195,42368812.50000793,5096.666666670702,-771,0,11,0.6057917357991527,-3381167895,1471.023297422544,1286.6127186548492,184.4105787676947,0.7856020832458314,0.7849008504502999,-771
601,2018-08-25,2018,242928,242928,349931508.6000004,3602799.0166666647,189314,0,194,0.8773916551406178,36595225,3949905004,244152,244152,571241,815393,307875452.28332806,3597208.083333277,190262,0,194,0.271527962589821,3428456920,-1224,-1224,42056056.316672325,5590.933333387598,-948,0,0,0.6058636925507968,-3391861695,1440.4741676546153,1260.9991000824407,179.47506757217457,0.7793008628070869,0.7792768439332874,-948
602,2018-08-26,2018,237619,237619,350206757.1666661,3570985.916666669,186907,0,81,0.8792436631750824,36298585,3954336959,238442,238442,582324,820766,308411540.96666527,3564840.8666666453,187652,0,82,0.2609635389380227,3439773169,-823,-823,41795216.20000082,6145.0500000235625,-745,0,-1,0.6182801242370597,-3403474584,1473.8163074782155,1293.4446992000792,180.37160827813636,0.7865827227620686,0.7869922245242029,-745
603,2018-08-27,2018,236352,236352,350727720.98333275,3556563.95,185483,0,89,0.8769674045491473,36381119,3963393861,239749,239749,596246,835995,309173239.0833432,3553364.549999433,186851,0,73,0.25781733144336233,3452232562,-3397,-3397,41554481.899989545,3199.4000005670823,-1368,0,16,0.6191500731057851,-3415851443,1483.9211048915718,1289.5705053340919,194.35059955747988,0.7847744042783644,0.7793609149568924,-1368
604,2018-08-28,2018,237606,237606,351361816.43333375,3565719.7499999995,187015,0,72,0.8768507529271151,35783192,3971236203,251103,251103,606279,857382,309119221.8166593,3567626.416666683,192588,0,61,0.25475692281853685,3444425321,-13497,-13497,42242594.61667448,-1906.6666666832753,-5573,0,11,0.6220938301085783,-3408642129,1478.7581813310007,1231.0455144568534,247.71266687414732,0.7870802925852041,0.7669681365814028,-5573
605,2018-08-29,2018,239147,239147,351824819.6999999,3558264.3833333384,186942,0,128,0.8680393230941644,36194004,3978677963,257332,257331,616000,873332,307823214.19999325,3562500.2833333137,193984,0,128,0.2512664141472014,3415322383,-18185,-18184,44001605.500006676,-4235.899999975227,-7042,0,0,0.616772908946963,-3379128379,1471.1655161887873,1196.2150467685326,274.95046942025465,0.7817033038256804,0.7538277400401039,-7042
606,2018-08-30,2018,236551,236551,352480349.21666646,3569458.23333333,187083,0,86,0.8900237158160397,36239642,3988228162,237460,237460,630954,868414,306655405.0333307,3564440.149999957,187834,0,78,0.25048767062714505,3396572559,-909,-909,45824944.18333578,5018.08333337307,-751,0,8,0.6395360451888946,-3360332917,1490.0818395046585,1291.3981514079453,198.68368809671324,0.7908780770320143,0.7910132232797102,-751
607,2018-08-31,2018,250946,250946,353014299.38333285,3664234.05,197033,0,92,0.8869358348011126,36238140,3993495371,252011,252011,636282,888293,307437925.8166611,3658833.0333332745,198037,0,58,0.25993675510220293,3409185015,-1065,-1065,45576373.56667173,5401.016666725278,-1004,0,34,0.6269990796989097,-3372946875,1406.7341156397506,1219.9385178292262,186.79559781052444,0.7851609509615615,0.7858268091472198,-1004
608,2018-09-01,2018,253065,253065,353064031.2999993,3696508.7499999953,196968,0,75,0.8781656886570647,37310278,3995587096,254409,254409,299377,553786,307729893.3166778,3690557.133333181,198213,0,73,0.4160903309220598,3392824940,-1344,-1344,45334137.98332149,5951.616666814312,-1245,0,2,0.46207535773500485,-3355514662,1395.1515669887156,1209.5872917887252,185.56427519999033,0.7783296781459309,0.7791115880334422,-1245
609,2018-09-02,2018,242267,242267,353114611.20000017,3622905.0666666594,191685,0,80,0.8826212402019254,34796306,3992605378,243309,243308,319442,562751,307995948.8000108,3617937.233333163,192723,0,61,0.3921201383915872,3401748835,-1042,-1041,45118662.39998937,4967.83333349647,-1038,0,19,0.49050110181033824,-3366952529,1457.543170138732,1265.868564946532,191.67460519220003,0.7912138260679333,0.7920915379209154,-1038
610,2018-09-03,2018,248522,248522,353914973.2833334,3703187.116666667,195365,0,192,0.886496970087154,35789097,4002068753,250130,250130,334026,584156,309019846.7500101,3700712.3333331873,196335,0,192,0.3881788426379355,3414866783,-1608,-1608,44895126.53332335,2474.7833334798925,-970,0,0,0.4983181274492185,-3379077686,1424.0790484678757,1235.436959780954,188.64208868692162,0.7861074673469552,0.7849318354455683,-970
611,2018-09-04,2018,248941,248941,354510391.2333331,3724366.400000002,196846,0,165,0.891311595920318,36690236,4011103882,251086,251086,342363,593449,309844439.48334205,3720137.433333186,197945,0,168,0.38353422113779234,3420365521,-2145,-2145,44665951.74999106,4228.9666668158025,-1099,0,-3,0.5077773747825256,-3383675285,1424.0739421522896,1234.0171872718593,190.0567548804304,0.7907335473063899,0.7883553842109875,-1099
612,2018-09-05,2018,251993,251993,355227054.19999987,3758300.5500000017,198323,0,96,0.9035568448329908,35632711,4018944438,254149,254149,352520,606669,310707878.8166745,3753519.049999849,199428,0,85,0.3878622444858734,3430016943,-2156,-2156,44519175.3833254,4781.500000152737,-1105,0,11,0.5156946003471174,-3394384232,1409.670324969344,1222.542204835252,187.1281201340919,0.7870178933541805,0.7846892964363424,-1105
613,2018-09-06,2018,245760,245760,355512200.8000005,3660755.9499999974,194319,0,74,0.8958943684895825,34099865,4021570967,246871,246871,366984,613855,311279604.91668236,3655102.1833331664,195270,0,62,0.36874669099380286,3443374630,-1111,-1111,44232595.883318126,5653.766666830983,-951,0,12,0.5271476774957796,-3409274765,1446.5828483072937,1260.899842090332,185.68300621696176,0.79068603515625,0.7909799044845284,-951
614,2018-09-07,2018,244498,244498,355226673.6499998,3598678.4833333325,194278,0,94,0.8951606966110152,35226610,4022825354,245617,245617,382988,628605,311267550.38334846,3593073.1666665617,195175,0,68,0.3564448262422336,3456030057,-1119,-1119,43959123.26665133,5605.316666770726,-897,0,26,0.5387158703687815,-3420803447,1452.8817153923542,1267.2883000091545,185.59341538319973,0.7945995468265589,0.794631479091431,-897
615,2018-09-08,2018,235705,235705,354625560.5333332,3579986.9499999983,188203,0,219,0.8998748435544429,35361025,4022924763,236934,236934,397031,633965,310915693.4666792,3576560.3833331494,189132,0,219,0.34581404336201416,3465264006,-1229,-1229,43709867.06665397,3426.5666668489575,-929,0,0,0.5540608001924288,-3429902981,1504.5313444064961,1312.2459987451325,192.28534566136364,0.7984684245136929,0.7982476132593886,-929
616,2018-09-09,2018,235090,235090,354592717.4500001,3555702.9499999993,186557,0,184,0.8867540091028964,34780021,4024889920,236017,236017,407702,643719,311112878.6000113,3550542.8833331466,187333,0,184,0.32919177467186256,3474925304,-927,-927,43479838.84998882,5160.066666852683,-776,0,0,0.5575622344310338,-3440145283,1508.3275232889537,1318.1799556812064,190.1475676077473,0.7935556595346464,0.7937267230750328,-776
617,2018-09-10,2018,240261,240261,354751959.90000033,3591461.0833333386,187861,0,71,0.8774707505587673,35479179,4026648700,241460,241459,419930,661390,311492666.5666779,3586633.6166664683,188818,0,56,0.32776727800541283,3484073731,-1199,-1198,43259293.333322406,4827.466666870285,-957,0,15,0.5497034725533545,-3448594552,1476.527442656113,1290.0437199138485,186.4837227422645,0.7819038462338873,0.7819845937215274,-957
618,2018-09-11,2018,244569,244569,355009036.7500001,3641946.600000006,192887,0,70,0.8940748827529248,36282147,4030816065,246523,246523,428817,675340,311978808.45001054,3636066.9333331822,194052,0,50,0.3389803654455483,3487878535,-1954,-1954,43030228.29998958,5879.666666823905,-1165,0,20,0.5550945173073765,-3451596388,1451.5700548720406,1265.5160307557937,186.05402411624686,0.7886813128401392,0.7871557623426617,-1165
619,2018-09-12,2018,244858,244858,355354528.4333336,3676161.766666666,191731,0,87,0.8872530201177817,36027680,4035851186,246251,246251,439285,685536,312549193.9500108,3670689.6166665135,192732,0,52,0.32838538019884883,3494456875,-1393,-1393,42805334.4833228,5472.150000152644,-1001,0,35,0.558867639918933,-3458429195,1451.2677896304535,1269.230151146638,182.0376384838155,0.7830293476218869,0.7826648419701849,-1001
620,2018-09-13,2018,245168,245168,355516439.3333335,3686262.5166666633,192489,0,79,0.8944519676303594,35661132,4035871478,246406,246406,449642,696048,313072237.8166613,3680025.933333328,193485,0,78,0.3248181159919997,3501993995,-1238,-1238,42444201.516672194,6236.583333335351,-996,0,1,0.5696338516383597,-3466332863,1450.093157889013,1270.5544419237408,179.5387159652721,0.7851310122038765,0.7852284441125622,-996
621,2018-09-14,2018,242427,242427,355766059.9500002,3623577.0499999993,191064,0,92,0.8961543062447654,35902536,4040805004,243491,243491,461689,705180,313555385.3833289,3618151.299999928,191983,0,77,0.31942057347060365,3511895373,-1064,-1064,42210674.56667131,5425.750000071246,-919,0,15,0.5767337327741617,-3475992837,1467.5183042730398,1287.7493845083757,179.76891976466413,0.7881300350208517,0.788460353770776,-919
622,2018-09-15,2018,231626,231626,355193485.5666666,3528901.533333331,183992,0,195,0.9027742999490561,35456618,4039998220,232793,232793,479703,712496,313169452.11667347,3527395.3499994283,184902,0,195,0.3055638207091657,3522438805,-1167,-1167,42024033.44999313,1506.1833339026198,-910,0,0,0.5972104792398905,-3486982187,1533.478476365635,1345.2700558722704,188.20842049336466,0.7943495117128474,0.7942764602028412,-910
623,2018-09-16,2018,238753,238753,354724904.9666667,3522315.300000001,188921,0,141,0.8944264574685971,34807948,4039864667,252653,252653,489560,742213,312906904.79998916,3563579.716666673,191211,0,131,0.29837930620994313,3533396375,-13900,-13900,41818000.166677535,-41264.416666671634,-2290,0,10,0.5960471512586539,-3498588427,1485.7400952727994,1238.4848183080715,247.25527696472795,0.7912822037838269,0.7568127035895081,-2290
624,2018-09-17,2018,250727,250727,354930956.26666677,3659954.566666667,194574,0,99,0.8923610141707917,36030696,4046943901,255804,255804,506019,761823,308456574.05001193,3659299.983332679,196432,0,69,0.3059542702176094,3486657682,-5077,-5077,46474382.21665484,654.5833339877427,-1858,0,30,0.5864067439531824,-3450626986,1415.6072392150297,1205.8317072837483,209.77553193128142,0.7760392777802151,0.7679004237619428,-1858
625,2018-09-18,2018,252447,252447,355490563.2499999,3719921.933333332,195401,0,103,0.8956573062860719,37110341,4054989688,253919,253919,507461,761380,308156305.78334194,3712929.1833326193,196646,0,103,0.3146300139220851,3455227515,-1472,-1472,47334257.46665794,6992.750000712927,-1245,0,0,0.5810272923639868,-3418117174,1408.178996977583,1213.6008167303034,194.57818024727953,0.7740278157395414,0.7744438186980888,-1245
626,2018-09-19,2018,245077,245077,355949733.18333316,3670170.9499999974,191627,0,206,0.9077514413837282,36601476,4060189002,246355,246354,518176,764531,308886479.98332924,3663934.6333332956,192737,0,206,0.30891880119969306,3463584753,-1278,-1277,47063253.20000392,6236.316666701809,-1110,0,0,0.5988326401840351,-3426983277,1452.3995853684073,1253.8318029475033,198.567782420904,0.7819052787491279,0.7823547319924499,-1110
627,2018-09-20,2018,244949,244949,356472374.49999994,3656609.9333333336,192831,0,95,0.9183136081388361,35794435,4066768542,246264,246264,529421,775685,309657137.7999961,3650569.833333267,193997,0,93,0.307856926458552,3475661634,-1315,-1315,46815236.70000386,6040.100000066683,-1166,0,2,0.6104566816802841,-3439867199,1455.2922220543867,1257.4194271188485,197.8727949355382,0.787229178318752,0.7877602897703277,-1166
628,2018-09-21,2018,245429,245429,356874703.8500007,3658785.1166666714,194146,0,92,0.9245036242660806,35773946,4070255513,246652,246652,539669,786321,310322238.48332894,3652698.766666579,195310,0,70,0.308374060975098,3486960074,-1223,-1223,46552465.36667174,6086.350000092294,-1164,0,22,0.6161295632909826,-3451186128,1454.085311230542,1258.1379371881394,195.94737404240254,0.7910475127226204,0.7918443799361043,-1164
629,2018-09-22,2018,242858,242858,356387663.8,3621280.0999999996,192263,0,105,0.9328002371756332,35977505,4068232060,244089,244089,551376,795465,310137505.0333295,3615051.8333333232,193437,0,105,0.30457153991690866,3493580133,-1231,-1231,46250158.766670525,6228.2666666763835,-1174,0,0,0.6282286972587245,-3457602628,1467.4734363290484,1270.5918948962449,196.8815414328035,0.7916683823468859,0.7924855278197707,-1174
630,2018-09-23,2018,237115,237115,356613290.13333356,3512441.3166666687,187414,0,102,0.917913248845497,35401415,4071724398,238371,238371,564302,802673,310524981.7999977,3507271.7499999967,188521,0,64,0.2882743034834845,3504435759,-1256,-1256,46088308.33333588,5169.566666672006,-1107,0,38,0.6296389453620125,-3469034344,1503.9676533890035,1302.696140889612,201.27151249939152,0.7903928473525504,0.7908722118042882,-1107
631,2018-09-24,2018,227907,227907,356390794.23333365,3476844.1666666674,181692,0,72,0.8998231734874319,34510593,4075222124,228962,228962,582151,811113,310528241.2833321,3472271.100000003,182540,0,58,0.2611929533862728,3516956603,-1055,-1055,45862552.95000154,4573.066666664556,-848,0,14,0.6386302201011591,-3482446010,1563.7553661508143,1356.2435744068102,207.51179174400409,0.7972199186510287,0.7972501987229322,-848
632,2018-09-25,2018,229691,229691,356489411.78333354,3508171.433333329,182984,0,82,0.9069097178383141,35083237,4077192327,230948,230948,588912,819860,310903547.13332856,3503453.2833333304,184034,0,61,0.2682336008586882,3525765166,-1257,-1257,45585864.65000498,4718.14999999851,-1050,0,21,0.6386761169796259,-3490681929,1552.0390950595954,1346.2058434510304,205.83325160856498,0.7966528945409267,0.7968633631813222,-1050
633,2018-09-26,2018,234841,234841,356669044.33333325,3565166.7166666696,185377,0,79,0.8932809858585175,36273250,4081814510,235996,235996,596514,832510,311357525.68333066,3558503.0833327738,186367,0,64,0.26456378902356126,3533835949,-1155,-1155,45311518.6500026,6663.633333895821,-990,0,15,0.6287171968349562,-3497562699,1518.7682062899291,1319.3339110973518,199.43429519257734,0.7893723838682343,0.7897040627807251,-990
634,2018-09-27,2018,239992,239992,357034136.30000037,3607315.7666666694,188250,0,74,0.8752583419447321,36624856,4086418442,241185,241185,604267,845452,311972050.550014,3601840.999999388,189156,0,61,0.25366431210760665,3542402470,-1193,-1193,45062085.74998635,5474.7666672812775,-906,0,13,0.6215940298371254,-3505777614,1487.6918243108119,1293.4969029998301,194.19492131098173,0.7844011467048901,0.7842776292057964,-906
635,2018-09-28,2018,241837,241837,357424255.7166671,3631065.6833333345,190653,0,72,0.8928865310105566,36688364,4091816440,243106,243106,614892,857998,312637961.0833288,3629087.2666666675,191797,0,64,0.26013463900849,3549825634,-1269,-1269,44786294.63333833,1978.416666666977,-1144,0,8,0.6327518920020666,-3513137270,1477.955216599061,1286.0149938024103,191.9402227966507,0.7883533123550159,0.7889439174681003,-1144
636,2018-09-29,2018,246684,246684,357650031.6833332,3668212.099999999,194339,0,74,0.896324852848178,36543516,4095233079,247744,247744,623346,871090,313126041.6166605,3661222.0333332904,195268,0,59,0.26258480753997704,3559505685,-1060,-1060,44523990.06667274,6990.0666667087935,-929,0,15,0.6337400453082009,-3522962169,1449.830680884586,1263.9096874865202,185.92099339806578,0.7878054515088129,0.7881845776285198,-929
637,2018-09-30,2018,246011,246011,357234234.04999983,3583190.083333336,195817,0,75,0.9114185951034705,35654106,4094641632,257567,257567,635694,893261,312955575.3833321,3583491.0499999486,201385,0,64,0.27121412442724385,3571200326,-11556,-11556,44278658.66666776,-300.96666661277413,-5568,0,11,0.6402044706762267,-3535546220,1452.10675152737,1215.0453100875968,237.06144143977326,0.7959684729544614,0.7818742307826702,-5568
638,2018-10-01,2018,241099,241099,357102652.44999963,3578770.499999995,191141,0,90,0.895773105653694,35246021,4096066773,244577,244577,317136,561713,310071018.2500142,3573228.6333331764,192988,0,64,0.40073845540338043,3492980464,-3478,-3478,47031634.199985445,5541.866666818503,-1847,0,26,0.4950346502503135,-3457734443,1481.145307321887,1267.7848622315842,213.36044509030285,0.7927905134405369,0.7890684733233296,-1847
639,2018-10-02,2018,238889,238889,357282061.24999976,3628571.883333339,189026,0,74,0.8999158605042507,35538402,4098707645,246451,246451,321412,567863,310235490.43333334,3635666.7499998016,191888,0,54,0.39894481591511466,3490378016,-7562,-7562,47046570.816666424,-7094.866666462738,-2862,0,20,0.500971044589136,-3454839614,1495.5986305355198,1258.8120577045065,236.78657283101325,0.7912712598738326,0.7786050776827849,-2862
640,2018-10-03,2018,248486,248486,357761618.5833335,3679436.1500000046,197328,0,83,0.8990244923255235,35446381,4102417821,249920,249920,334949,584869,310003195.0500101,3673541.4333331627,198445,0,56,0.3991885362363083,3486488512,-1434,-1434,47758423.53332341,5894.7166668418795,-1117,0,27,0.4998359560892152,-3451042131,1439.765695384583,1240.4097113076589,199.3559840769242,0.7941211979749362,0.7940340909090909,-1117
641,2018-10-04,2018,248072,248072,357458595.61666715,3674326.9999999986,195904,0,76,0.8992913347737742,36395174,4102665984,249041,249041,342097,591138,310084843.6000129,3668470.0499998317,196759,0,59,0.39203197899642833,3495829210,-969,-969,47373752.01665425,5856.950000166893,-855,0,17,0.5072593557773459,-3459434036,1440.9469654643294,1245.1156379873712,195.83132747695822,0.7897062143248734,0.7900666958452625,-855
642,2018-10-05,2018,246424,246424,357479902.2833332,3650918.53333333,195568,0,81,0.9035199493555824,35937759,4105645791,247473,247473,356186,603659,310471877.9500138,3645293.4666665196,196347,0,64,0.3811340508465864,3502699500,-1049,-1049,47008024.333319366,5625.066666810308,-779,0,17,0.522385898508996,-3466761741,1450.6699927090428,1254.5686921402084,196.1013005688344,0.7936239976625653,0.7934077656956516,-779
643,2018-10-06,2018,248466,248466,357202322.3166669,3556602.5666666715,198491,0,67,0.8919369249716259,34674968,4106789333,249940,249940,369302,619242,310473134.13334703,3551023.1999998586,199391,0,54,0.3655226874146095,3511799732,-1474,-1474,46729188.18331987,5579.366666812915,-900,0,13,0.5264142375570164,-3477124764,1437.6305905704075,1242.1906622923384,195.43992827806915,0.7988658407991436,0.7977554613107146,-900
644,2018-10-07,2018,235529,235529,356992523.1000002,3501770.5166666666,185611,0,62,0.8826726220550324,34304005,4107272635,236540,236540,384941,621481,310418652.08334005,3495998.466666514,186440,0,48,0.34256719030830873,3519822836,-1011,-1011,46573871.016660154,5772.050000152551,-829,0,14,0.5401054317467237,-3485518831,1515.7051704885607,1312.3304814548915,203.37468903366926,0.7880600690360847,0.7881964995349624,-829
645,2018-10-08,2018,237043,237043,357530922.4666667,3552172.666666671,186706,0,63,0.885729593364916,34060229,4114622580,238037,238036,395087,633124,311174895.2999996,3547062.183332735,187514,0,51,0.3390868139574636,3530378755,-994,-993,46356027.166667104,5110.483333935961,-808,0,12,0.5466427794074524,-3496318526,1508.2956360941546,1307.2598064998554,201.03582959429923,0.7876461232772113,0.7877514840129896,-808
646,2018-10-09,2018,239297,239297,357619687.6500004,3545608.233333338,187878,0,80,0.8939769407890604,34253829,4115605243,240301,240301,402724,643025,311583037.81667805,3539793.766666471,188752,0,60,0.342775164262662,3535845471,-1004,-1004,46036649.833322346,5814.466666867025,-874,0,20,0.5512017765263983,-3501591642,1494.4595529822789,1296.6364593433987,197.8230936388802,0.7851247612799157,0.7854815418995343,-874
647,2018-10-10,2018,238200,238200,357803257.9333331,3500246.533333336,186565,0,85,0.8826238455079762,33377286,4118553552,239371,239371,414948,654319,311994612.7500153,3496172.1999993552,187324,0,61,0.3296450202424187,3542083827,-1171,-1171,45808645.18331778,4074.3333339807577,-759,0,24,0.5529788252655575,-3508706541,1502.1127537083673,1303.393530335819,198.7192233725484,0.7832283795130143,0.7825676460389939,-759
648,2018-10-11,2018,233066,233066,357991514.1833334,3509931.100000004,183740,0,82,0.8911939107377296,34437862,4122853984,234178,234178,428476,662654,312318930.66667855,3505200.7666665213,184698,0,74,0.3261068370522184,3549176398,-1112,-1112,45672583.51665485,4730.3333334825,-958,0,8,0.5650870736855111,-3514738536,1536.0091741538165,1333.6817748323008,202.3273993215157,0.7883603786052019,0.7887077351416444,-958
649,2018-10-12,2018,235703,235703,358187714.59999985,3538515.466666661,186096,0,86,0.9021734980038439,34540123,4125361820,237013,237013,439423,676436,312792815.1000078,3534288.3833332,187221,0,65,0.3312804167726088,3555693746,-1310,-1310,45394899.49999207,4227.08333346108,-1125,0,21,0.5708930812312352,-3521153623,1519.6570030928747,1319.7285174231276,199.92848566974703,0.789535983844075,0.7899186964428112,-1125
650,2018-10-13,2018,236702,236702,358358528.0999997,3562533.333333333,187899,0,77,0.9028567565969023,35797335,4128724256,237704,237704,448341,686045,313254623.5500129,3557217.233333169,188722,0,65,0.3212908774205726,3565856617,-1002,-1002,45103904.54998684,5316.100000164006,-823,0,12,0.5815658791763297,-3530059282,1513.96493523502,1317.834885193404,196.13005004161596,0.7938209225101605,0.7939369972739205,-823
651,2018-10-14,2018,237992,237992,358433831.99999946,3565056.4166666684,187991,0,82,0.8953284144004839,35452331,4130303755,239117,239117,457922,697039,313600358.6999982,3559132.4499994004,189036,0,62,0.3173294464154911,3578523007,-1125,-1125,44833473.30000126,5923.96666726796,-1045,0,20,0.5779989679849928,-3543070676,1506.0751285757483,1311.4933639180745,194.58176465767383,0.7899047026790816,0.7905585968375314,-1045
652,2018-10-15,2018,242090,242090,358916702.4999997,3601989.9833333255,190434,0,98,0.9046511627906978,36356411,4137941138,243577,243577,469584,713161,314263317.7000073,3595947.133332705,191752,0,66,0.3237585902762555,3593396381,-1487,-1487,44653384.79999238,6042.850000620354,-1318,0,32,0.5808925725144423,-3557039970,1482.5754987814437,1290.201117921673,192.37438085977078,0.7866248089553471,0.7872336058002193,-1318
653,2018-10-16,2018,237370,237370,358938274.15000015,3549972.5500000026,188387,0,88,0.9058305598854113,35525349,4141432580,254556,254556,477503,732059,314565363.3333243,3582570.0500000077,193957,0,64,0.31332037445068767,3597840315,-17186,-17186,44372910.81667584,-32597.500000005122,-5570,0,24,0.5925101854347237,-3562314966,1512.146750431816,1235.741303812616,276.4054466191999,0.7936428360786957,0.761942362387844,-5570
654,2018-10-17,2018,233558,233558,358427056.7833331,3502178.0833333344,184551,0,88,0.889937403128986,34830829,4140480139,234561,234561,500111,734672,309354205.7833303,3496593.1333333342,185389,0,58,0.29642752139729733,3518893778,-1003,-1003,49072851.0000028,5584.950000000186,-838,0,30,0.5935098817316886,-3484062949,1534.638320174574,1318.8646270408565,215.77369313371742,0.790172034355492,0.79036583234212,-838
655,2018-10-18,2018,233365,233365,358475369.1666668,3501430.666666667,186285,0,83,0.9146530113770288,34970452,4142555489,234793,234792,504433,739226,309518679.1666622,3495801.8499999978,187530,0,65,0.31018795334579685,3523480955,-1428,-1427,48956690.00000459,5628.816666669212,-1245,0,18,0.604465058031232,-3488510503,1536.1145380269827,1318.267569451524,217.84696857545873,0.7982559509780816,0.7987035388618912,-1245
656,2018-10-19,2018,239640,239640,358417088.1666663,3543970.633333337,188189,0,87,0.9122684026039056,35302764,4142095633,241301,241301,511221,752522,309811428.03332835,3537973.2166666496,189675,0,63,0.31327721980221024,3524144695,-1661,-1661,48605660.133337975,5997.416666687466,-1486,0,24,0.5989911828016954,-3488841931,1495.6480060368317,1283.9210282316624,211.72697780516933,0.7852987815055917,0.7860514461191623,-1486
657,2018-10-20,2018,240285,240285,358476031.01666695,3597686.449999997,190230,0,125,0.9413945939197201,35877557,4143264342,241936,241936,523134,765070,310211583.29999256,3591713.63333331,191794,0,125,0.3311252565124772,3526279807,-1651,-1651,48264447.71667439,5972.816666686907,-1564,0,0,0.610269337407243,-3490402250,1491.8785234894685,1282.205142268999,209.67338122046954,0.7916848742118734,0.7927468421400701,-1564
658,2018-10-21,2018,240842,240842,358770906.933334,3609861.2666666647,189514,0,97,0.9329352853738131,36532966,4146472681,242537,242537,530014,772551,310810263.4666615,3603504.6166666327,191097,0,79,0.3262166510689885,3538682118,-1695,-1695,47960643.46667248,6356.6500000320375,-1583,0,18,0.6067186343048245,-3502149152,1489.6525810835901,1281.496280842352,208.1563002412381,0.7868810257347141,0.7879086489896387,-1583
659,2018-10-22,2018,239334,239334,359288011.65000004,3591206.533333337,189016,0,86,0.9177759950529386,36269683,4154000945,240856,240856,542176,783032,311508517.43332756,3584551.116666629,190309,0,70,0.30069013782323256,3551849716,-1522,-1522,47779494.21667248,6655.416666707955,-1293,0,16,0.617085857229706,-3515580033,1501.1992096818674,1293.3392459948166,207.85996368705082,0.7897582457987582,0.7901360148802604,-1293
660,2018-10-23,2018,238440,238440,359322811.73333377,3566445.483333335,188470,0,85,0.8934490857238715,36471492,4156835216,239623,239623,551833,791456,311807122.88334894,3560444.883332752,189499,0,67,0.27935981280070327,3557988173,-1183,-1183,47515688.849984825,6000.600000582635,-1029,0,18,0.6140892729231682,-3521516681,1506.9737113459728,1301.240377106325,205.73333423964777,0.7904294581446066,0.790821415306544,-1029
661,2018-10-24,2018,245122,245122,359886473.0999998,3617571.366666662,190653,0,100,0.9060386256639545,36433640,4163647218,246752,246752,559505,806257,312573228.91666245,3611475.616666622,192100,0,64,0.29775121332279975,3569296830,-1630,-1630,47313244.18333733,6095.750000040047,-1447,0,36,0.6082874123411548,-3532863190,1468.1932796729784,1266.7505386649852,201.44274100799316,0.7777882034252331,0.7785144598625341,-1447
662,2018-10-25,2018,246131,246131,359930486.8500003,3584031.48333333,193344,0,93,0.9074801630026286,37052056,4165503316,247612,247610,570537,818149,312931385.6166768,3577921.599999433,194700,0,64,0.2891368198213381,3579137025,-1481,-1479,46999101.233323514,6109.883333897218,-1356,0,29,0.6183433431812905,-3542084969,1462.3533274963345,1263.807542573712,198.5457849226225,0.7855329072729563,0.7863108411547098,-1356
663,2018-10-26,2018,232650,232650,359488428.55000025,3465577.9333333354,183609,0,91,0.9055791962174946,35978787,4165675594,234010,234010,587342,821352,312779956.966669,3459741.899999483,184799,0,69,0.2704613856178439,3590490795,-1360,-1360,46708471.58333123,5836.0333338524215,-1190,0,22,0.6351178105996507,-3554512008,1545.189892757362,1336.6093627053076,208.58053005205443,0.7892069632495164,0.7897055681381138,-1190
664,2018-10-27,2018,222755,222755,358894811.95000035,3397623.149999999,176456,0,94,0.9124643666808836,35075550,4166572006,224164,224164,605156,829320,312420783.7833403,3392413.0999994962,177669,0,66,0.2622039743404163,3599704858,-1409,-1409,46474028.16666007,5210.050000502728,-1213,0,28,0.6502603923404673,-3564629308,1611.163888352676,1393.7152432296903,217.44864512298568,0.7921528136293237,0.7925848932031905,-1213
665,2018-10-28,2018,227922,227922,358802253.0166657,3436698.7166666654,178333,0,91,0.9052044120356961,35174283,4170384644,229176,229175,613810,842986,312498917.9333314,3431350.6999999727,179494,0,73,0.25993076990602404,3612798030,-1254,-1253,46303335.08333433,5348.016666692682,-1161,0,18,0.6452736421296721,-3577623747,1574.2326454518025,1363.5820570888245,210.65058836297794,0.7824299541071068,0.7832146472580026,-1161
666,2018-10-29,2018,235437,235437,359369137.41666687,3527125.633333331,185158,0,100,0.9146353376911875,35705687,4177146616,237344,237344,618734,856078,313333411.28332645,3522088.1666666027,186525,0,77,0.2703328435025798,3622806466,-1907,-1907,46035726.13334042,5037.466666728258,-1367,0,23,0.6443024941886077,-3587100779,1526.3919325198115,1320.1657142515776,206.22621826823388,0.7864439319223402,0.7858846231630039,-1367
667,2018-10-30,2018,229251,229251,359473213.08333373,3498292.0833333354,181249,0,88,0.9301333472918338,35294370,4181099491,232208,232208,627356,859564,313696717.59999645,3494221.2833332755,182800,0,74,0.2741075708149715,3627172748,-2957,-2957,45776495.48333728,4070.800000059884,-1551,0,14,0.6560257764768623,-3591878378,1568.0333480915403,1350.929845655604,217.10350243593643,0.7906137814011717,0.7872252463308758,-1551
668,2018-10-31,2018,229183,229183,359472771.5833331,3486377.7166666677,179783,0,99,0.9271237395443817,34720785,4182190222,231069,231069,638782,869851,313971327.38332796,3482067.1666666493,181218,0,73,0.2735169586515371,3636529397,-1886,-1886,45501444.200005114,4310.55000001844,-1435,0,26,0.6536067808928445,-3601808612,1568.4966667830208,1358.7773668615348,209.71929992148603,0.7844517263496856,0.784259247237838,-1435
669,2018-11-01,2018,229120,229120,359425501.88333344,3482414.933333335,179344,0,98,0.9107149092178758,34441140,4183070993,230810,230810,298563,529373,314119671.800007,3477088.549999853,180853,0,77,0.4301787208641136,3591542468,-1690,-1690,45305830.08332646,5326.383333481848,-1509,0,21,0.4805361883537622,-3557101328,1568.7216388064483,1360.9448108834408,207.77682792300743,0.7827513966480447,0.7835579047701573,-1509
670,2018-11-02,2018,236986,236986,359820393.3833329,3515707.7000000016,183741,0,88,0.8935844311478324,35936572,4189275594,238425,238425,310817,549242,314739387.08334386,3509615.249999842,185102,0,60,0.41663965974925393,3600191146,-1439,-1439,45081006.299989045,6092.450000159442,-1361,0,28,0.47694477139857844,-3564254574,1518.3191976881878,1320.077118940312,198.2420787478759,0.775324280759201,0.7763531508860229,-1361
671,2018-11-03,2018,243520,243520,360155493.4333338,3562278.5166666675,187426,0,95,0.9016959592641249,36606802,4194283311,245576,245576,320500,566076,315246882.6666793,3555175.266666505,189363,0,71,0.44221270642104626,3611017914,-2056,-2056,44908610.76665449,7103.250000162516,-1937,0,24,0.45948325284307867,-3574411112,1478.9565269108648,1283.703955869789,195.25257104107573,0.7696534165571617,0.7710973385021338,-1937
672,2018-11-04,2018,234969,234969,360613213.40000015,3489963.2166666663,180631,0,79,0.8912835310189857,35509554,4201626321,236810,236810,333617,570427,315828893.4166724,3482984.0666665183,182149,0,64,0.40238452948404896,3623058400,-1841,-1841,44784319.98332775,6979.150000147987,-1518,0,15,0.48889900153493676,-3587548846,1534.7267656584493,1333.6805600129742,201.04620564547508,0.7687439619694513,0.7691778218825218,-1518
673,2018-11-05,2018,233941,233941,360957495.4333328,3488420.616666663,180944,0,83,0.8876426107437334,35252005,4208797511,235357,235357,349274,584631,316403166.40001047,3481945.1833331445,182235,0,67,0.38399948001388484,3633674490,-1416,-1416,44554329.033322334,6475.433333518449,-1291,0,16,0.5036431307298486,-3598422485,1542.9424317812304,1344.354178545828,198.58825323540236,0.7734599749509492,0.7742918205109685,-1291
674,2018-11-06,2018,234282,234282,361036448.0666662,3488037.333333334,181441,0,80,0.8891506816571484,35190114,4212597819,235637,235637,358118,593755,316672960.65001506,3482188.5499998424,182661,0,59,0.37894922990121793,3639074486,-1355,-1355,44363487.41665113,5848.783333491534,-1220,0,21,0.5102014517559305,-3603884372,1541.0336605742916,1343.9016820364163,197.13197853787528,0.7744555706370955,0.7751796194994843,-1220
675,2018-11-07,2018,233457,233457,361134347.6,3465407.3833333356,181547,0,86,0.8998102434281264,35008329,4214833200,234781,234781,369842,604623,316998229.983345,3459569.099999798,182788,0,65,0.37965145222725616,3650520725,-1324,-1324,44136117.61665505,5838.2833335376345,-1241,0,21,0.5201587912008703,-3615512396,1546.898776220032,1350.1868975059522,196.71187871407983,0.7776464188265934,0.7785468159689243,-1241
676,2018-11-08,2018,227872,227872,361224090.45000005,3402748.6500000022,179426,0,84,0.9221448883583757,34254425,4219169275,229425,229425,384244,613669,317251222.0166817,3397397.2999998396,180956,0,66,0.3858529598203626,3659047161,-1553,-1553,43972868.43331838,5351.350000162609,-1530,0,18,0.5362919285380131,-3624792736,1585.2061264657355,1382.8101646145,202.39596185123537,0.7873981884566774,0.7887370600414079,-1530
677,2018-11-09,2018,231854,231854,361033190.2999999,3391079.133333331,181740,0,89,0.9111725482415652,34645261,4219700676,237217,237217,398387,635604,317340246.45002025,3390901.216666526,184328,0,70,0.3710281873619398,3670203240,-5363,-5363,43692943.84997964,177.91666680481285,-2588,0,19,0.5401443608796255,-3635557979,1557.1574797070566,1337.7635095714904,219.39397013556618,0.7838553572506837,0.777043803774603,-2588
678,2018-11-10,2018,226725,226725,360871682.7166664,3387268.649999999,176031,0,87,0.9125504465762496,34907765,4219037784,228114,228114,411565,639679,316854318.9166826,3382015.24999988,177391,0,68,0.36267409122387756,3666544421,-1389,-1389,44017363.7999838,5253.400000119116,-1360,0,19,0.549876355352372,-3631636656,1591.6713318631223,1389.0174163649867,202.65391549813558,0.7764075421766458,0.777641880813979,-1360
679,2018-11-11,2018,230842,230842,360922992.95,3419679.333333332,179405,0,81,0.9029292763015393,35274774,4220126938,231974,231974,420314,652288,317080108.1333456,3415263.4666664964,180497,0,64,0.347504476550237,3672987841,-1132,-1132,43842884.816654384,4415.866666835733,-1092,0,17,0.5554247997513023,-3637713067,1563.5066103655313,1366.8777886027985,196.62882176273274,0.7771765969797524,0.7780915102554596,-1092
680,2018-11-12,2018,236809,236809,361551626.26666695,3483923.783333335,182963,0,91,0.8975292324193763,35179429,4226730348,250100,250100,425961,676061,317959154.3833553,3536638.633333214,189644,0,72,0.358781234237737,3684273486,-13291,-13291,43592471.88331163,-52714.84999987902,-6681,0,19,0.5387479981816393,-3649094057,1526.764718683272,1271.3280862989018,255.4366323843701,0.7726184393329646,0.7582726909236306,-6681
681,2018-11-13,2018,193753,193753,348864057.8833335,2839155.400000001,138893,0,48,0.7564269972593972,24129881,4162257998,194418,194418,466631,661049,302531403.7666711,2834981.8166665845,139330,0,35,0.22256897748880813,3631519101,-665,-665,46332654.11666238,4173.583333416376,-437,0,13,0.5338580197705891,-3607389220,1800.5608061982705,1556.0874186889646,244.4733875093059,0.7168559970684325,0.7166517503523336,-437
682,2018-11-14,2018,234212,234212,349138348.28333336,3444253.4833333325,181802,0,75,0.8746904513859244,35135114,4164050199,235137,235137,466481,701618,302454222.3333471,3439900.2166660875,182650,0,64,0.3037393567439825,3607607947,-925,-925,46684125.94998628,4353.266667244956,-848,0,11,0.5709510946419418,-3572472833,1490.6936804405127,1286.2893646399634,204.40431580054928,0.7762283742933752,0.7767811956433909,-848
683,2018-11-15,2018,239672,239672,349776408.16666645,3464033.599999997,185821,0,76,0.8762225040889217,35718418,4168980645,242293,242293,455387,697680,303280438.29999495,3457745.249999946,187236,0,69,0.31736039445017794,3564535687,-2621,-2621,46495969.8666715,6288.35000005085,-1415,0,7,0.5588621096387437,-3528817269,1459.396208846534,1251.7094521921597,207.68675665437422,0.7753137621415935,0.7727668566570227,-1415
684,2018-11-16,2018,236514,236514,350008403.7000004,3455916.5666666646,183440,0,85,0.8751913205983581,35515719,4171322544,240536,240536,468655,709191,303320075.4166603,3454769.9499999597,184848,0,61,0.30082587060467425,3566580787,-4022,-4022,46688328.2833401,1146.616666704882,-1408,0,24,0.5743654499936839,-3531065068,1479.863364113754,1261.0173754309556,218.8459886827984,0.7755989074642516,0.7684837196926864,-1408
685,2018-11-17,2018,229897,229897,350176518.7333335,3398930.283333328,179442,0,95,0.8858793285688813,33168310,4172774537,241753,241753,482541,724294,303701711.9333353,3446219.3166661444,183384,0,67,0.2972605047121821,3573960344,-11856,-11856,46474806.799998224,-47289.033332816325,-3942,0,28,0.5886188238566992,-3540792034,1523.1887268356418,1256.24795528219,266.94077155345167,0.7805321513547371,0.7585593560369468,-3942
686,2018-11-18,2018,223493,223493,350337069.8333335,3375585.9333333364,174595,0,91,0.8857011181558267,35207310,4175879777,224469,224469,501507,725976,301177225.4333428,3370212.383332731,175499,0,84,0.28053268978588786,3554252961,-976,-976,49159844.39999068,5373.550000605173,-904,0,7,0.6051684283699389,-3519045651,1567.55276377038,1341.7319337340248,225.82083003635512,0.7812101497586054,0.7818406996066272,-904
687,2018-11-19,2018,228561,228561,350837095.8500003,3402367.433333334,177939,0,93,0.8747511605216993,35322719,4184125542,230068,230068,507558,737626,301821549.86666226,3397058.7499999385,178762,0,66,0.2789137042349395,3561807662,-1507,-1507,49015545.98333806,5308.683333395515,-823,0,27,0.5958374562867599,-3526484943,1534.9823279124623,1311.8797480165092,223.1025798959531,0.7785186449131741,0.7769963662917051,-823
688,2018-11-20,2018,231375,231375,351337435.86666715,3407893.1333333384,180635,0,99,0.8955937331172332,35185783,4189092466,233412,233412,514064,747476,302588125.64999443,3403232.19999996,181784,0,68,0.29165618695449613,3568181944,-2037,-2037,48749310.21667272,4660.933333378285,-1149,0,31,0.6039375461627371,-3532996161,1518.476222006125,1296.3691911726664,222.10703083345857,0.7807023230686115,0.7788117149075454,-1149
689,2018-11-21,2018,229621,229621,351558522.4500003,3418577.8333333326,178698,0,85,0.9021300316608672,34921600,4191541019,232401,232401,521887,754288,303105260.83332855,3414043.8166666115,179957,0,63,0.29293718049339595,3576964688,-2780,-2780,48453261.61667174,4534.016666721087,-1259,0,22,0.6091928511674713,-3542043088,1531.0381996855701,1304.2338924244239,226.80430726114628,0.7782302141354667,0.7743383204030964,-1259
690,2018-11-22,2018,225167,225167,351758501.0999995,3392714.733333336,177485,0,79,0.8994257595473578,34720181,4198407902,226242,226242,537503,763745,303586415.5166613,3388467.06666665,178460,0,67,0.27743815016792683,3584676796,-1075,-1075,48172085.5833382,4247.666666686069,-975,0,12,0.621987609379431,-3549956615,1562.2116078288536,1341.865858313935,220.34574951491868,0.7882371750745003,0.7888013719822138,-975
691,2018-11-23,2018,225062,225062,352005041.30000013,3379690.966666667,177371,0,81,0.8807306431116765,34115147,4200053998,225894,225894,546064,771958,304143269.34999883,3374430.599999488,178117,0,61,0.261715015583745,3594411673,-832,-832,47861771.9500013,5260.366667178925,-746,0,20,0.6190156275279315,-3560296526,1564.035871448757,1346.3981750289906,217.63769641976637,0.7880983906656832,0.7884981451477242,-746
692,2018-11-24,2018,225780,225780,352163838.6166665,3380046.7333333297,176784,0,94,0.8874169545575327,33571226,4202180461,226785,226785,556838,783623,304604197.11666185,3374751.2166666994,177784,0,77,0.2665490931225797,3604414918,-1005,-1005,47559641.50000465,5295.516666630283,-1000,0,17,0.620867861434953,-3570843692,1559.765429252664,1343.1408475722021,216.62458168046192,0.7829922933829392,0.7839319178958044,-1000
693,2018-11-25,2018,221762,221762,352689221.80000013,3355571.0499999896,173732,0,79,0.9055879726914438,32991395,4207476264,222949,222949,565579,788528,305344382.33332944,3349933.733333338,174833,0,64,0.2743846762575364,3616831075,-1187,-1187,47344839.46667069,5637.316666651517,-1101,0,15,0.6312032964339074,-3583839680,1590.3952065728129,1369.570540048753,220.82466652405992,0.7834164554792976,0.7841838267944687,-1101
694,2018-11-26,2018,226859,226859,353121415.93333346,3299607.900000005,176802,0,93,0.8903019055889342,33695840,4213857481,227944,227944,576795,804739,306079162.64999384,3293835.80000004,177830,0,77,0.2645106053018434,3628514189,-1085,-1085,47042253.28333962,5772.0999999651685,-1028,0,16,0.6257913002870907,-3594818349,1556.5678061409662,1342.7822739356764,213.78553220528988,0.7793475242331139,0.7801477555890921,-1028
695,2018-11-27,2018,225453,225453,353290550.31666636,3305836.9999999995,174984,0,90,0.882033062323411,33683659,4214471455,226332,226332,586467,812799,306445507.98333603,3300476.166666181,175853,0,79,0.2535780678864194,3632659918,-879,-879,46845042.33333033,5360.833333818708,-869,0,11,0.6284549944369917,-3598976259,1567.0252794004355,1353.9645652551828,213.06071414525263,0.7761440300195607,0.7769692310411255,-869
696,2018-11-28,2018,230344,230344,353944899.1166663,3413117.366666666,178970,0,89,0.8937936303962767,34778305,4221682748,231505,231505,592805,824310,307294917.56666225,3407611.7166666277,180054,0,74,0.26387038856741457,3639024733,-1161,-1161,46649981.550004065,5505.650000038557,-1084,0,15,0.6299232418288621,-3604246428,1536.592657575914,1327.3791821630732,209.2134754128408,0.7769683603653665,0.777754260167167,-1084
697,2018-11-29,2018,230324,230324,354405474.56666666,3423469.5166666703,178937,0,88,0.895299664819994,34276418,4226571203,231608,231608,603272,834880,308037009.21667343,3418106.049999562,180035,0,69,0.26345822154082554,3649964967,-1284,-1284,46368465.34999323,5363.466667108238,-1098,0,19,0.6318414432791685,-3615688549,1538.7257713771326,1329.9929588644322,208.73281251270032,0.7768925513624286,0.7773263445131429,-1098
698,2018-11-30,2018,230747,230747,355061460.16666657,3425496.4333333313,180025,0,84,0.8820526377374355,34722610,4234170988,231936,231936,612460,844396,308808952.58332574,3420675.9333333606,180868,0,66,0.24677876257111447,3660120168,-1189,-1189,46252507.58334082,4820.499999970663,-843,0,18,0.635273875166321,-3625397558,1538.747893435956,1331.4403653737486,207.30752806220744,0.7801834910096339,0.7798185706401766,-843
699,2018-12-01,2018,224999,224999,355101449.96666694,3403555.0499999966,175893,0,88,0.8926039671287428,34653840,4236515475,227286,227286,283026,510312,309106500.78334135,3399135.8333331943,177120,0,65,0.4086715577920908,3623724351,-2287,-2287,45994949.18332559,4419.216666802298,-1227,0,23,0.483932409336652,-3589070511,1578.2356808993238,1359.9891800785854,218.24650082073845,0.7817501411117382,0.7792824899025896,-1227
700,2018-12-02,2018,226930,226930,355370387.9833336,3401904.133333333,176653,0,93,0.8955316617459128,34970785,4242777306,229188,229188,296225,525413,309468098.6833429,3397301.016666531,177882,0,74,0.4080066538132824,3634176695,-2258,-2258,45902289.29999071,4603.1166668017395,-1229,0,19,0.4875250079326304,-3599205910,1565.9912218892769,1350.2805499561184,215.71067193315844,0.778447098224122,0.7761401120477512,-1229
701,2018-12-03,2018,233040,233040,356213587.0666672,3475726.949999997,182165,0,90,0.8953613113628551,35176725,4254230881,235435,235435,307120,542555,310469492.45001006,3470971.0333332173,183442,0,71,0.4044364165844903,3647789256,-2395,-2395,45744094.61665714,4755.916666779667,-1277,0,19,0.4909248947783648,-3612612531,1528.5512661631788,1318.705767834052,209.8454983291267,0.7816898386543083,0.7791619767664111,-1277
702,2018-12-04,2018,228423,228423,356357498.01666635,3430886.566666666,179420,0,127,0.9019056749977011,34665485,4257180705,230589,230589,319684,550273,310873420.5166764,3426355.033333255,180533,0,127,0.39370457936333425,3653453204,-2166,-2166,45484077.49998993,4531.533333410975,-1113,0,0,0.5082010956343669,-3618787719,1560.0771289085003,1348.1710771835449,211.90605172495543,0.7854725662477071,0.7829211280676875,-1113
703,2018-12-05,2018,226805,226805,356672248.1999997,3404253.6833333373,178290,0,189,0.8915720552897851,34690746,4262432694,228085,228085,334506,562591,311516674.0000124,3399656.6833331687,179296,0,189,0.3724517455842756,3663305135,-1280,-1280,45155574.19998729,4597.000000168569,-1006,0,0,0.5191203097055095,-3628614389,1572.5942911311465,1365.792024903051,206.8022662280955,0.7860937810013007,0.7860929039612425,-1006
704,2018-12-06,2018,218315,218315,356746839.6166665,3316280.050000001,171902,0,203,0.8994480452557094,34042705,4267742369,219346,219346,348003,567349,311806992.4166771,3310873.5666665295,172823,0,203,0.3580089151474713,3674887176,-1031,-1031,44939847.19998938,5406.483333471697,-921,0,0,0.5414391301082382,-3640844471,1634.0922044599156,1421.5303329747392,212.56187148517643,0.7874035224331815,0.7879013066114723,-921
705,2018-12-07,2018,207612,207612,356356524.73333323,3239252.283333335,163219,0,215,0.8959983045296033,33340804,4265312565,208644,208643,365494,574138,311619707.7166801,3234034.1333332295,164066,0,215,0.3368980976699005,3685319532,-1032,-1031,44736817.01665312,5218.150000105612,-847,0,0,0.5591002068597029,-3651978728,1716.4543703318363,1493.5545775160447,222.89979281579167,0.7861732462478084,0.7863442035237055,-847
706,2018-12-08,2018,209198,209198,355885952.9500003,3240062.533333332,163375,0,206,0.895983709213281,32924491,4262784313,210510,210510,378014,588524,311329397.78334445,3235606.4499998437,164240,0,206,0.3336771312639719,3690671290,-1312,-1312,44556555.16665584,4456.083333488088,-865,0,0,0.562306577949309,-3657746799,1701.191947102746,1478.929256488264,222.26269061448215,0.7809587089742732,0.780200465536079,-865
707,2018-12-09,2018,207958,207958,355596427.9333334,3246257.816666664,162408,0,225,0.8986189519037497,32519892,4263640603,209667,209667,387019,596686,311452756.16667783,3243480.0333332177,163423,0,225,0.33034125151252114,3699123647,-1709,-1709,44143671.766655564,2777.783333446365,-1015,0,0,0.5682777003912286,-3666603755,1709.9434882684648,1485.4638840002376,224.47960426822715,0.7809653872416545,0.7794407322086928,-1015
708,2018-12-10,2018,217057,217057,356178882.94999963,3323003.4333333313,169542,0,224,0.89266413891282,33390665,4271085053,218003,218003,394915,612918,312262130.0833392,3318202.499999848,170477,0,224,0.3336384312420296,3708466561,-946,-946,43916752.866660416,4800.933333483059,-935,0,0,0.5590257076707905,-3675075896,1640.9463088036766,1432.3753805376036,208.570928266073,0.7810943669174456,0.7819938257730398,-935
709,2018-12-11,2018,211955,211955,356491780.53333306,3280607.8333333344,166300,0,233,0.9005921068151258,33509547,4276035829,212943,212943,402231,615174,312765178.3166803,3275295.049999837,167255,0,233,0.32994892501958906,3710685391,-988,-988,43726602.21665275,5312.783333497588,-955,0,0,0.5706431817955367,-3677175844,1681.9220142640327,1468.7741711006247,213.14784316340797,0.7846005048241372,0.785444931272688,-955
710,2018-12-12,2018,217569,217569,356640581.7666663,3281806.1833333285,171958,0,236,0.9022838731620774,32236066,4277202527,235317,235317,413467,648784,313184242.0500169,3353374.533333131,177456,0,236,0.3332958272707113,3716269396,-17748,-17748,43456339.71664941,-71568.34999980265,-5498,0,0,0.5689880458913661,-3684033330,1639.2067884977469,1330.9035983376334,308.30319016011345,0.790360759115499,0.7541146623490865,-5498
711,2018-12-13,2018,214384,214384,356555496.8333332,3282473.099999995,168934,0,135,0.9120969848496159,32775770,4276865211,244322,244322,425890,670212,310347464.8000102,3396545.833333224,178350,0,135,0.3245898312772673,3676391719,-29938,-29938,46208032.03332299,-114072.73333322909,-9416,0,0,0.5875071535723486,-3643615949,1663.162814544617,1270.2395396239806,392.92327492063646,0.7879972385998956,0.7299792896259854,-9416
712,2018-12-14,2018,215627,215627,356298381.6000007,3285198.6166666625,169023,0,173,0.8931163537033856,32032351,4272974922,219013,219013,445186,664199,302072953.4000181,3283329.8166665398,170701,0,173,0.3093063976308297,3553683814,-3386,-3386,54225428.19998258,1868.8000001227483,-1678,0,0,0.5838099560725559,-3521651463,1652.3829650275738,1379.2466812473144,273.1362837802594,0.7838675119535123,0.7794103546364828,-1678
713,2018-12-15,2018,218282,218282,356328618.1833335,3297531.633333329,169878,0,165,0.8807918197560952,33169105,4271284698,230913,230913,443308,674221,301593479.5500101,3295033.0166665483,174658,0,165,0.30112233229163593,3541243652,-12631,-12631,54735138.63332343,2498.6166667807847,-4780,0,0,0.5796694874644592,-3508074547,1632.423278984678,1306.091383118361,326.33189586631715,0.7782501534711979,0.7563801085257218,-4780
714,2018-12-16,2018,214587,214587,356318593.93333364,3292097.9000000004,167201,0,168,0.8851281764505764,33010502,4273033334,215452,215452,453020,668472,299041692.26667905,3287324.5166665195,168009,0,168,0.293711628908911,3491388169,-865,-865,57276901.66665459,4773.383333480917,-808,0,0,0.5914165475416654,-3458377667,1660.485462462002,1387.9736194914833,272.5118429705187,0.7791758121414625,0.7797978203961904,-808
715,2018-12-17,2018,222418,222418,357051940.01666677,3336013.7833333327,174307,0,153,0.8879721964948885,32973100,4280673074,224082,224082,461785,685867,300048124.9333476,3332648.433333201,175335,0,153,0.30224081345217596,3501759590,-1664,-1664,57003815.08331919,3365.3500001318753,-1028,0,0,0.5857313830427124,-3468786490,1605.319443645149,1339.0103842939084,266.30905935124065,0.7836910681689432,0.7824590997938254,-1028
716,2018-12-18,2018,223134,223134,357636235.85000014,3377405.050000001,174389,0,149,0.8831733397868549,33872977,4285783757,225363,225363,467150,692513,300995420.4833448,3375414.0166665046,175436,0,149,0.29714243631527193,3506030246,-2229,-2229,56640815.36665535,1991.0333334966563,-1047,0,0,0.5860309034715829,-3472157269,1602.7868269739267,1335.6026520917133,267.1841748822135,0.7815438256832218,0.7784596406686102,-1047
717,2018-12-19,2018,226353,226353,358190008.1166664,3426055.433333334,176868,0,181,0.8938913997163723,34351462,4291585868,228573,228573,475342,703915,301942546.01667833,3425206.89999987,177922,0,181,0.30110169551721505,3518292001,-2220,-2220,56247462.09998804,848.53333346406,-1054,0,0,0.5927897041991572,-3483940539,1582.439853311714,1320.9895570197632,261.45029629195074,0.7813812938198301,0.7784033984766354,-1054
718,2018-12-20,2018,224361,224361,358568883.3333329,3382183.5833333316,175887,0,222,0.9007626102575754,33625857,4295742293,226004,226004,484430,710434,302744878.0166631,3381184.366666626,176968,0,225,0.3024292193222771,3528413349,-1643,-1643,55824005.31666982,999.2166667054407,-1081,0,-3,0.5983333909352984,-3494787492,1598.178307875847,1339.5553973233352,258.6229105525117,0.7839464077981467,0.7830303888426754,-1081
719,2018-12-21,2018,222357,222357,358653823.23333335,3350329.850000001,173304,0,93,0.8975566319027509,33968492,4296619349,227588,227588,497183,724771,303137651.86666095,3353311.8166666673,176420,0,89,0.2986019032218463,3540819720,-5231,-5231,55516171.3666724,-2981.966666666325,-3116,0,4,0.5989547286809046,-3506851228,1612.963941919226,1331.95797610885,281.005965810376,0.7793952967525196,0.7751726804576691,-3116
720,2018-12-22,2018,215834,215834,358370454.2499995,3275140.050000001,169503,0,93,0.9132388780266314,33955283,4295461919,217938,217938,514859,732797,302906479.5166734,3272383.649999528,171262,0,67,0.2977345704199088,3548497292,-2104,-2104,55463974.73332614,2756.4000004730187,-1759,0,26,0.6155043076067226,-3514542009,1660.3985203906684,1389.874549260218,270.5239711304505,0.7853396591825199,0.7858289972377465,-1759
721,2018-12-23,2018,208387,208387,357703508.11666656,3199849.3999999985,161834,0,87,0.8994323062379126,33739970,4292344360,209839,209839,524917,734756,302377844.73333967,3197024.733332892,163061,0,68,0.27747034389647074,3552696816,-1452,-1452,55325663.38332689,2824.6666671065614,-1227,0,19,0.6219619623414419,-3518956846,1716.5346596316783,1440.9992648332277,275.5353947984506,0.7766031470293252,0.7770767111928669,-1227
722,2018-12-24,2018,207937,207937,357961595.2333331,3195089.3499999978,161903,0,146,0.8973390978998442,34059484,4297226611,209378,209378,537526,746904,302953480.3666597,3192382.9499999955,163116,0,146,0.2676916979959975,3564763072,-1441,-1441,55008114.86667341,2706.400000002235,-1213,0,0,0.6296473999038468,-3530703588,1721.4906208771556,1446.9212637748938,274.56935710226185,0.778615638390474,0.779050330025122,-1213
723,2018-12-25,2018,211057,211057,357839063.4999999,3221581.816666666,164291,0,121,0.8997758899254712,34065953,4296377708,212505,212505,546640,759145,303114724.89999604,3217198.7000000086,165685,0,121,0.27737520500036034,3576270267,-1448,-1448,54724338.60000384,4383.1166666573845,-1394,0,0,0.6224006849251109,-3542204314,1695.461716503124,1426.3886727370934,269.07304376603065,0.7784200476648488,0.7796757723347686,-1394
724,2018-12-26,2018,213911,213911,358169922.0499998,3261944.6999999923,168167,0,105,0.9018143059496708,34381620,4302241700,215231,215231,553798,769029,303727004.566665,3256432.8500000164,169384,0,105,0.26862836121914974,3586801918,-1320,-1320,54442917.48333478,5511.849999975879,-1217,0,0,0.633185944730521,-3552420298,1674.38758198503,1411.1675574924848,263.22002449254524,0.7861540547236935,0.7869870046601094,-1217
725,2018-12-27,2018,205294,205294,358556513.05000037,3220797.4499999983,161223,0,110,0.9025641275439127,33718457,4310279395,206737,206737,563933,770670,304423367.9333285,3215766.2999999877,162503,0,107,0.2611364137698425,3592933839,-1443,-1443,54133145.11667186,5031.150000010617,-1280,0,3,0.6414277137740703,-3559215382,1746.5513509893146,1472.5151662901585,274.03618469915614,0.7853273841417674,0.7860373324562124,-1280
726,2018-12-28,2018,201371,201371,358810710.4166667,3194578.833333336,158126,0,144,0.8938228444016273,33329085,4315587231,202887,202887,574995,777882,304913259.34999686,3190405.166666684,159225,0,144,0.24792063577765971,3601743577,-1516,-1516,53897451.06666982,4173.66666665161,-1099,0,0,0.6459022086239676,-3568414492,1781.8390454269318,1502.872334600033,278.96671082689886,0.7852471309175602,0.7847964630557897,-1099
727,2018-12-29,2018,201459,201459,358934445.23333323,3177999.7999999938,159030,0,145,0.8983713807772297,32459233,4318795489,203783,203783,586431,790214,305281120.3666624,3174089.533333332,160164,0,145,0.24554867415662557,3610422031,-2324,-2324,53653324.86667085,3910.266666661948,-1134,0,0,0.652822706620604,-3577962798,1781.674907714886,1498.0696150643694,283.60529265051673,0.7893913898113264,0.7859536860287659,-1134
728,2018-12-30,2018,201373,201373,358833996.0499999,3156176.1499999966,158768,0,82,0.8883018080874807,32062228,4319221908,203691,203691,594916,798607,305491443.2666814,3152718.8333329167,159981,0,61,0.2414491733731456,3620273371,-2318,-2318,53342552.78331852,3457.3166670799255,-1213,0,21,0.6468526347143351,-3588211143,1781.9369828626475,1499.778798605149,282.15818425749853,0.7884274455860517,0.7854102537667349,-1213
729,2018-12-31,2018,201371,201371,358960429.6333332,3154162.533333334,158002,0,85,0.8861752685341974,31998599,4320094449,203914,203914,604210,808124,305944531.14999616,3151270.983333321,159285,0,56,0.24220911642272963,3631663786,-2543,-2543,53015898.483337045,2891.550000013318,-1283,0,29,0.6439661521114677,-3599665187,1782.5825448219118,1500.360598830861,282.2219459910509,0.7846313520814815,0.7811381268574007,-1283
730,2019-01-01,2019,196978,196978,358760914.90000004,3127184.8833333324,154284,0,77,0.8794992334169299,31883536,4320198876,202827,202827,277479,480306,306087116.10001063,3128082.0499998434,156834,0,52,0.3947920700553378,3600181826,-5849,-5849,52673798.7999894,-897.1666665109806,-2550,0,25,0.48470716336159214,-3568298290,1821.3247921087636,1509.1043899481363,312.2204021606274,0.7832549827899562,0.7732402490792646,-2550
731,2019-01-02,2019,205598,205598,359440854.4333335,3184824.7333333367,161886,0,82,0.8988073813947611,32356403,4327033755,214255,214255,289132,503387,306744579.4500159,3189968.933333203,164443,0,60,0.4001414418727465,3607673176,-8657,-8657,52696274.98331761,-5144.1999998665415,-2557,0,22,0.49866593952201466,-3575316773,1748.270189560859,1431.6799115540637,316.5902780067954,0.7873909279273145,0.7675106765303027,-2557
732,2019-01-03,2019,211555,211555,359812078.20000005,3236433.0500000007,166549,0,85,0.8988537259814223,32687830,4330232878,226250,226250,295293,521543,307208783.36668277,3287721.6499998746,172601,0,68,0.4025880895726713,3602549700,-14695,-14695,52603294.83331728,-51288.5999998739,-6052,0,17,0.49626563640875104,-3569861870,1700.79685282787,1357.8288767588188,342.96797606905125,0.7872609959584977,0.7628773480662984,-6052
733,2019-01-04,2019,210773,210773,360089253.5833331,3227422.583333333,165394,0,87,0.9008411893363945,32654835,4334764319,218641,218641,309666,528307,306010059.73334384,3236351.7833331972,168009,0,54,0.390131116945263,3580856187,-7868,-7868,54079193.849989235,-8929.199999864213,-2615,0,33,0.5107100723911315,-3548201352,1708.4221109123705,1399.6005311599556,308.8215797524149,0.7847020254017355,0.7684240375775815,-2615
734,2019-01-05,2019,205567,205567,360256651.3666668,3195881.9999999977,161911,0,92,0.9058749702043607,32693680,4338100542,223770,223770,319519,543289,305985481.5666721,3259633.316666493,168601,0,61,0.39425609574277676,3579895953,-18203,-18203,54271169.79999471,-63751.31666649552,-6690,0,31,0.5116188744615839,-3547202273,1752.5023538148964,1367.4106518598207,385.0917019550757,0.787631283231258,0.753456674263753,-6690
735,2019-01-06,2019,204915,204915,360587076.2499995,3181487.833333334,161393,0,89,0.9054681209281904,32788224,4341939485,222774,222774,333940,556714,305068004.433346,3227719.716666567,167905,0,64,0.37607999798819686,3566520974,-17859,-17859,55519071.81665355,-46231.883333233185,-6512,0,25,0.5293881229399935,-3533732750,1759.6909755264355,1369.405785384946,390.28519014148947,0.78760949662055,0.7537010602673562,-6512
736,2019-01-07,2019,211297,211297,361413986.3666666,3237659.6000000043,165648,0,140,0.9005759665305237,33459477,4350647231,219714,219714,345205,564919,303755013.6166767,3273110.6666665967,169616,0,140,0.367558888973467,3533769070,-8417,-8417,57658972.74998993,-35451.06666659238,-3968,0,0,0.5330170775570567,-3500309593,1710.4548875122061,1382.5018597662265,327.9530277459796,0.7839581252928343,0.7719853992007792,-3968
737,2019-01-08,2019,210126,210126,361641702.81666636,3226414.633333331,163712,0,158,0.893116511045753,33106802,4354067169,223148,223148,347519,570667,303656137.4833388,3285927.1166665303,170639,0,158,0.36039056051953294,3524366677,-13022,-13022,57985565.33332759,-59512.483333199285,-6927,0,0,0.5327259505262201,-3491259875,1721.0707043234363,1360.7835942214977,360.28711010193865,0.7791134842903782,0.7646898022836862,-6927
738,2019-01-09,2019,213805,213805,362122062.40000033,3227292.033333335,167168,0,149,0.8894880849372094,33559747,4359031428,224967,224967,362311,587278,303048569.85001755,3263905.8833332653,173334,0,149,0.35236804375440045,3507476905,-11162,-11162,59073492.549982786,-36613.849999930244,-6166,0,0,0.537120041182809,-3473917158,1693.7024971352416,1347.0801044153923,346.62239271984936,0.781871331353336,0.7704863379962394,-6166
739,2019-01-10,2019,216026,216026,362434186.4166668,3275888.083333333,168687,0,131,0.8962717450677243,34000854,4361529737,217525,217525,374278,591803,301839298.866675,3271140.6666665142,169984,0,131,0.35568930877335814,3481695617,-1499,-1499,60594887.54999179,4747.416666818783,-1297,0,0,0.5405824362943662,-3447694763,1677.7340987504597,1387.6073962380187,290.12670251244094,0.78086434040347,0.7814458108263418,-1297
740,2019-01-11,2019,215170,215170,362659662.71666616,3281689.383333332,168222,0,147,0.8949017056281086,33744686,4362479096,217504,217504,377305,594809,302239575.8833454,3277657.966666545,169359,0,147,0.34651291422961095,3485443561,-2334,-2334,60420086.83332074,4031.4166667871177,-1137,0,0,0.5483887913984976,-3451698875,1685.4564424253667,1389.581689915337,295.8747525100298,0.7818097318399405,0.7786477490069148,-1137
741,2019-01-12,2019,210603,210603,362626679.11666685,3237365.966666663,165185,0,161,0.8932208942892548,32918020,4363656821,215720,215720,390229,605949,302553058.76667714,3234859.9999999166,167046,0,161,0.32690209902154144,3492975974,-5117,-5117,60073620.34998971,2505.966666746419,-1861,0,0,0.5663187952677133,-3460057954,1721.8495421084544,1402.5266955621971,319.3228465462573,0.7843430530429291,0.7743649174856295,-1861
742,2019-01-13,2019,207396,207396,362769188.88333315,3207025.6833333373,163088,0,168,0.8941059615421707,33016397,4366547733,209591,209591,404986,614577,303073236.80001235,3203890.766666555,164171,0,168,0.3157293553126762,3506380539,-2195,-2195,59695952.0833208,3134.916666782461,-1083,0,0,0.5783766062294945,-3473364142,1749.1619360225518,1446.0221898841664,303.13974613838536,0.7863603926787401,0.7832922215171453,-1083
743,2019-01-14,2019,212991,212991,363652432.71666676,3275655.5666666655,168369,0,170,0.8984558032968527,33625651,4376486066,215655,215655,412042,627697,304197641.6166785,3272477.9833331606,169419,0,170,0.31762458638483315,3518512772,-2664,-2664,59454791.09998828,3177.583333504852,-1050,0,0,0.5808312169120196,-3484887121,1707.3605585056023,1410.5754172946533,296.78514121094895,0.7904981900643689,0.7856020031995549,-1050
744,2019-01-15,2019,209657,209657,363770112.11666715,3239040.1666666716,164774,0,183,0.8876593674430143,33390112,4377303490,211712,211711,420554,632266,304589424.3166778,3234735.933333174,165744,0,183,0.3051959143778057,3525182137,-2055,-2054,59180687.79998934,4304.233333497774,-970,0,0,0.5824634530652086,-3491792025,1735.0725810093015,1438.7038194362967,296.3687615730048,0.7859217674582771,0.7828748488512697,-970
745,2019-01-16,2019,209009,209009,364076204.05000013,3231947.900000001,164038,0,199,0.884961891593185,33398175,4380706694,211187,211187,432429,643616,305237710.2166753,3227737.3333332124,165057,0,199,0.30190206582806806,3536463077,-2178,-2178,58838493.83332485,4210.566666788422,-1019,0,0,0.583059825765117,-3503064902,1741.916396183897,1445.34327499645,296.573121187447,0.7848370165878025,0.7815679942420698,-1019
746,2019-01-17,2019,210808,210808,364387911.48333275,3244218.650000002,165969,0,134,0.890658798527571,33352456,4385501744,213112,213112,442011,655123,305833595.1166762,3240199.649999897,167144,0,136,0.30791469693477097,3547893412,-2304,-2304,58554316.36665654,4019.000000104774,-1175,0,-2,0.5827441015928001,-3514540956,1728.5298066645134,1435.0838766314248,293.44593003308864,0.7872993434784259,0.784301212507977,-1175
747,2019-01-18,2019,215645,215645,364618088.28333324,3271018.666666664,168094,0,99,0.878893551902431,33584865,4387761483,217855,217855,451624,669479,306389395.55000776,3266294.9166661478,169156,0,99,0.2954357044806417,3557970758,-2210,-2210,58228692.73332548,4723.750000516418,-1062,0,0,0.5834578474217893,-3524385893,1690.825608214117,1406.3913867022,284.43422151191703,0.7794940759117995,0.776461407817126,-1062
748,2019-01-19,2019,212622,212622,364946052.06666625,3250565.8166666655,165523,0,83,0.8788319176754987,33331785,4389749024,214661,214661,460897,675558,307000319.20001024,3246708.899999519,166511,0,83,0.285153902403643,3569024202,-2039,-2039,57945732.866656005,3856.9166671466082,-988,0,0,0.5936780152718557,-3535692417,1716.4077662079476,1430.1634633212846,286.24430288666304,0.7784848228311275,0.7756928366121466,-988
749,2019-01-20,2019,204202,204202,364671537.5666666,3180282.4666666705,159285,0,80,0.874487027551151,32198651,4384155817,206095,206095,474536,680631,307165728.3333409,3176233.7333332407,160212,0,76,0.2707810840235019,3578892581,-1893,-1893,57505809.23332572,4048.7333334297873,-927,0,4,0.6037059435276492,-3546693930,1785.8372472682277,1490.4084443258735,295.4288029423542,0.7800364345109254,0.7773696596229894,-927
750,2019-01-21,2019,211366,211366,365314553.8666667,3221394.833333335,163602,0,156,0.8610656396960723,32471781,4391598832,213184,213184,486183,699367,308044022.53334653,3218519.83333319,164437,0,157,0.26828117426186043,3590583299,-1818,-1818,57270531.33332014,2875.0000001448207,-835,0,-1,0.5927844654342118,-3558111518,1728.3506044806954,1444.9678331082378,283.3827713724577,0.7740223120085539,0.7713383743620534,-835
751,2019-01-22,2019,211168,211168,361903561.7333336,3252894.7833333304,163597,0,80,0.8638761554781037,32539800,4323513360,217329,217329,493659,710988,307343838.03334343,3252951.9499998535,164836,0,56,0.2642435596662688,3571837776,-6161,-6161,54559723.69999015,-57.16666652308777,-1239,0,24,0.5996325958118349,-3539297976,1713.8182003586414,1414.1869609363841,299.6312394222573,0.7747243900590999,0.7584629754887751,-1239
752,2019-01-23,2019,211580,211580,362448795.85000056,3269593.749999999,163970,0,82,0.8748227620758103,33422086,4329570271,212797,212797,505159,717956,307919789.5500116,3265094.6999998814,164964,0,82,0.2697853350344627,3580980199,-1217,-1217,54529006.299988985,4499.050000117626,-994,0,0,0.6050374270413477,-3547558113,1713.0579253710207,1447.0118918500334,266.0460335209873,0.7749787314490972,0.7752176957381918,-994
753,2019-01-24,2019,210923,210923,362870626.6833333,3261027.449999995,164940,0,82,0.8771779274901276,32979214,4332709494,212979,212979,510418,723397,308527771.1833365,3257593.76666624,165893,0,67,0.26647331962947113,3588068963,-2056,-2056,54342855.49999678,3433.683333755005,-953,0,15,0.6107046078606564,-3555089749,1720.3938246816767,1448.6300113313355,271.76381335034125,0.7819915324549718,0.7789171702374412,-953
754,2019-01-25,2019,211680,211680,363257910.0333331,3223681.4166666674,165293,0,86,0.8785478080120932,32668594,4337046115,213631,213631,520631,734262,309196379.8333413,3220074.2499995194,166215,0,86,0.263612988279384,3598837457,-1951,-1951,54061530.19999182,3607.166667148005,-922,0,0,0.6149348197327091,-3566168863,1716.07100355883,1447.3385409109226,268.73246264790737,0.7808626228269085,0.7780471935252843,-922
755,2019-01-26,2019,199417,199417,362523815.41666603,3152146.4500000007,156002,0,89,0.8775229794851991,32272541,4330716344,201488,201488,537462,738950,308841120.66666216,3148726.466666651,156935,0,91,0.24534000947289952,3608483729,-2071,-2071,53682694.750003874,3419.9833333496936,-933,0,-2,0.6321829700122996,-3576211188,1817.9183089539308,1532.8015597289275,285.11674922500333,0.782290376447344,0.7788801318192646,-933
756,2019-01-27,2019,200104,200104,362708365.2999998,3120450.8500000006,156026,0,143,0.8747651221364888,32154336,4335702605,202182,202182,548911,751093,309164368.91667384,3117229.0499995444,156951,0,143,0.2410180896373612,3620453939,-2078,-2078,53543996.383325934,3221.800000456162,-925,0,0,0.6337470324991277,-3588299603,1812.5992748770627,1529.1389387614815,283.4603361155812,0.7797245432375165,0.7762857227646378,-925
757,2019-01-28,2019,203686,203686,362979277.1833331,3150571.8500000024,157888,0,147,0.8668489734198719,32377654,4340502613,205712,205712,557829,763541,309654615.8499938,3146556.6499999985,158735,0,148,0.23805008506419764,3635093812,-2026,-2026,53324661.333339274,4015.2000000039116,-847,0,-1,0.6287988883556742,-3602716158,1782.0531464279975,1505.2822190732375,276.77092735476003,0.7751539133764717,0.7716370459671774,-847
758,2019-01-29,2019,197356,197356,362895703.0166671,3086599.8166666664,153164,0,168,0.8676604714323364,31871628,4340988063,199499,199499,568413,767912,309884488.2166638,3082368.433333319,154084,0,168,0.23260347539822745,3636237542,-2143,-2143,53011214.80000335,4231.383333347272,-920,0,0,0.6350569960341089,-3604365914,1838.7872829641212,1553.313491379224,285.4737915848973,0.7760797746204828,0.7723547486453566,-920
759,2019-01-30,2019,195348,195348,362414586.40000015,3038306.5000000005,151903,0,153,0.8593484448266684,31611753,4337841650,197425,197425,580302,777727,309659163.41666365,3034752.4000000176,152736,0,153,0.22195063306276086,3643504633,-2077,-2077,52755422.98333651,3554.0999999828637,-833,0,0,0.6373978117639075,-3611892880,1855.2254765853766,1568.490127474553,286.73534911082356,0.7776020230562893,0.7736406230214006,-833
760,2019-01-31,2019,184380,184380,362034953.66666675,2931738.583333336,143137,0,157,0.8411921032649965,30120234,4336167760,187406,187406,594658,782064,309510974.14999545,2930968.550000019,144457,0,157,0.2013748235438505,3651504832,-3026,-3026,52523979.5166713,770.033333316911,-1320,0,0,0.639817279721146,-3621384598,1963.5261615504216,1651.5531741246034,311.97298742581825,0.7763152185703438,0.7708237729848564,-1320
761,2019-02-01,2019,179734,179734,361375266.03333306,2881433.0833333377,139439,0,179,0.8605550424516241,30576273,4332796962,182493,182493,264370,446863,309183716.9666683,2879483.633333112,141147,0,179,0.356711117277556,3625548972,-2759,-2759,52191549.066664755,1949.4500002255663,-1708,0,0,0.5038439251740681,-3594972699,2010.6116039999836,1694.2223371124828,316.38926688750075,0.7758075823160894,0.7734378852887508,-1708
762,2019-02-02,2019,173597,173597,360525817.5833334,2817134.2666666694,134145,0,199,0.8644216201892897,29765208,4326077035,174529,174529,277248,451777,308272707.86666906,2813029.083333062,134938,0,199,0.3423968019620252,3626954746,-932,-932,52253109.716664314,4105.1833336073905,-793,0,0,0.5220248182272644,-3597189538,2076.797511381725,1766.312233879006,310.4852775027191,0.772738008145302,0.7731551776495597,-793
763,2019-02-03,2019,166520,166520,359640437.04999965,2704396.6500000004,126697,0,171,0.8482044198895036,28797294,4320932817,167429,167429,290556,457985,307592356.0500013,2700786.316666431,127415,0,171,0.31744489448344104,3636875472,-909,-909,52048080.99999833,3610.333333569579,-718,0,0,0.5307595254060625,-3608078178,2159.7431963127533,1837.1510075912854,322.5921887214679,0.7608515493634398,0.7610091441745457,-718
764,2019-02-04,2019,161198,161198,359036358.8166665,2686073.9999999963,124118,0,180,0.8418838943411215,28513674,4320046481,162380,162379,304733,467113,307102239.6166699,2682913.3499999,124672,0,180,0.29847167601843255,3647284795,-1182,-1181,51934119.19999659,3160.6500000962988,-554,0,0,0.543412218322689,-3618771121,2227.30033137301,1891.2682035033465,336.03212786966355,0.76997233216293,0.7677792831629511,-554
765,2019-02-05,2019,163556,163556,358689006.5500001,2717570.3666666714,126691,0,186,0.8604881508474161,28389676,4318053383,169568,169568,312317,481885,306985805.450001,2722034.116666398,127972,0,186,0.30638637849279526,3654221365,-6012,-6012,51703201.09999907,-4463.749999726657,-1281,0,0,0.5541017723546209,-3625831689,2193.065412152413,1810.3993999457505,382.6660122066626,0.7746031940130598,0.7546942819399887,-1281
766,2019-02-06,2019,167886,167886,358952040.46666694,2763381.066666668,130699,0,198,0.8835459776276761,28512186,4319536540,178705,178705,318703,497408,307344716.5333328,2778288.2166664237,133932,0,198,0.32364577972207736,3658548521,-10819,-10819,51607323.93333411,-14907.1499997559,-3233,0,0,0.5599001979055986,-3630036335,2138.070121788993,1719.8439692976292,418.226152491364,0.7784985049378745,0.7494586049634873,-3233
767,2019-02-07,2019,168288,168288,359205670.2666662,2750485.233333336,131126,0,216,0.8675306617227613,28537233,4323165771,170446,170445,329785,500231,305556502.53333277,2747685.2666664375,131992,0,218,0.30833954712922756,3627177621,-2158,-2157,53649167.73333341,2799.96666689869,-866,0,-2,0.5591911145935338,-3598640388,2134.4698984280885,1792.6985393137538,341.7713591143347,0.7791761741776003,0.7743918895133943,-866
768,2019-02-08,2019,168371,168371,359189925.0,2742930.7666666647,130187,0,230,0.8658735768036068,28651803,4323100048,170510,170510,336754,507264,305784277.58333397,2741758.5333330743,130965,0,230,0.3045751324753927,3631400151,-2139,-2139,53405647.41666603,1172.2333335904405,-778,0,0,0.5612984443282141,-3602748348,2133.3241769663423,1793.350991632948,339.9731853333942,0.7732151023632335,0.7680781185854202,-778
769,2019-02-09,2019,167893,167893,358659006.33333355,2736369.6999999997,130063,0,217,0.8621562542810001,28079808,4320419205,170164,170164,347471,517635,305660396.16667247,2737740.8666665927,130855,0,220,0.2894201512648886,3634376352,-2271,-2271,52998610.16666108,-1371.166666592937,-792,0,-3,0.5727361030161114,-3606296544,2136.235616335008,1796.2694586791124,339.9661576558958,0.7746779198656287,0.7689934416210245,-792
770,2019-02-10,2019,174721,174721,358865304.98333335,2794161.0000000005,135070,0,218,0.8484669845067278,29005912,4322725326,176767,176767,355404,532171,306142788.21667516,2795092.3499999363,135693,0,218,0.2831721382788508,3637351201,-2046,-2046,52722516.76665819,-931.3499999358319,-623,0,0,0.565294846227877,-3608345289,2053.9334423643027,1731.9001183290725,322.0333240352302,0.7730610516194389,0.767637624669763,-623
771,2019-02-11,2019,181744,181744,359231538.29999995,2875671.4333333354,140620,0,211,0.8734043489743816,30013823,4327080441,183462,183462,362662,546124,306753865.80000675,2874403.999999913,141664,0,211,0.30726904512528275,3638484596,-1718,-1718,52477672.499993205,1267.433333422523,-1044,0,0,0.5661353038490988,-3608470773,1976.5799052513423,1672.0294436995496,304.55046155179275,0.7737256800774716,0.7721708037631771,-1044
772,2019-02-12,2019,187759,187759,359647419.95000017,2942644.6166666667,142286,0,88,0.8634632694038636,25868101,4326852240,191903,191903,365939,557842,307479035.43333614,2940442.1333331903,143828,0,74,0.31647133059182325,3631534150,-4144,-4144,52168384.51666403,2202.4833334763534,-1542,0,14,0.5469919388120403,-3605666049,1915.4736654434682,1602.2627860603334,313.21087938313485,0.7578118758621424,0.7494828116287916,-1542
773,2019-02-13,2019,192167,192167,360048759.4833333,2999687.4166666633,148208,0,169,0.871991549017261,30815901,4329818686,193185,193185,373355,566540,307951540.4000082,2995664.733333201,149008,0,169,0.3083683411586058,3629860428,-1018,-1018,52097219.08332509,4022.683333462104,-800,0,0,0.5636232078586552,-3599044527,1873.6242928459792,1594.075836115683,279.54845673029627,0.7712458434590747,0.7713228252711132,-800
774,2019-02-14,2019,197753,197753,360589603.3333336,3060945.8499999996,152697,0,134,0.8541564476897949,31170727,4333304730,198719,198719,380661,579380,308872536.33333695,3055939.599999872,153441,0,134,0.29680002761573426,3631959639,-966,-966,51717066.99999666,5006.250000127591,-744,0,0,0.5573564200740606,-3600788912,1823.4343010388395,1554.318089026902,269.1162120119375,0.7721602200725147,0.7721506247515336,-744
775,2019-02-15,2019,201753,201753,361379591.0000001,3082751.7999999984,155970,0,170,0.8505647995321016,32250479,4341401686,202512,202512,389365,591877,309890770.58334243,3078575.083333198,156616,0,173,0.2934646894540537,3638652147,-759,-759,51488820.416657686,4176.716666800436,-646,0,-3,0.5571001100780479,-3606401668,1791.198103621756,1530.2341124641623,260.9639911575937,0.7730740063344783,0.7733665165521055,-646
776,2019-02-16,2019,195743,195743,361594871.51666677,3052743.6833333345,151300,0,131,0.858906831917362,31499639,4345591623,196857,196856,404178,601035,310320437.2500088,3049369.9666665373,152145,0,131,0.2872661325879498,3646058245,-1114,-1113,51274434.26665795,3373.716666797176,-845,0,0,0.5716406993294121,-3614558606,1847.2940105989321,1576.3829258443168,270.91108475461533,0.7729522894816162,0.7728706624605678,-845
777,2019-02-17,2019,194736,194736,362030467.7500002,3054132.299999999,151093,0,99,0.8664756388135731,31482167,4350863193,195610,195610,415534,611144,310932377.1000089,3049897.566666535,151849,0,99,0.28482158051130735,3657995533,-874,-874,51098090.649991274,4234.733333463781,-756,0,0,0.5816540583022658,-3626513366,1859.0834142120623,1589.552564286125,269.5308499259372,0.7758863281570947,0.7762844435356065,-756
778,2019-02-18,2019,202105,202105,362777620.8666671,3112229.533333337,155989,0,102,0.856569604908339,32265278,4359004897,202906,202905,424324,627230,311890589.23334515,3108332.3499998953,156648,0,102,0.2797394895014603,3669027720,-801,-800,50887031.63332194,3897.183333441615,-659,0,0,0.5768301154068787,-3636762442,1794.9957738139437,1537.1261882819308,257.86958553201293,0.7718215778926796,0.7720225128877412,-659
779,2019-02-19,2019,202468,202468,363502975.23333347,3134777.9,156490,0,64,0.8622498370112814,31786229,4365994407,203269,203269,431995,635264,312782175.7666741,3129313.2333332393,157221,0,62,0.284266068909935,3671395907,-801,-801,50720799.46665937,5464.666666760575,-731,0,2,0.5779837681013464,-3639609678,1795.3601321361077,1538.7598490998337,256.60028303627405,0.7729122626785467,0.773462751329519,-731
780,2019-02-20,2019,209014,209014,364063262.5999999,3196845.499999999,161412,0,134,0.8655066167816511,32116401,4367477753,210329,210329,440154,650483,313730716.8000101,3191216.116666562,162522,0,134,0.29666109644679634,3682253002,-1315,-1315,50332545.79998982,5629.383333437145,-1110,0,0,0.5688455203348548,-3650136601,1741.8128096682515,1491.6189246371641,250.19388503108735,0.7722544901298478,0.7727037165583444,-1110
781,2019-02-21,2019,208106,208106,364847028.6666667,3202108.050000001,161432,0,185,0.8722477967958636,32082428,4372903234,209338,209338,450520,659858,314736716.1166743,3196773.266666543,162350,0,185,0.2875285288652983,3690444644,-1232,-1232,50110312.54999238,5334.783333458006,-918,0,0,0.5847192679305653,-3658362216,1753.1788063134493,1503.4858273064342,249.69297900701508,0.7757200657357308,0.7755400357316875,-918
782,2019-02-22,2019,207408,207408,365491485.8999997,3191422.0666666636,160607,0,77,0.8665191313739098,32436485,4381006452,213219,213219,461955,675174,315589360.1833421,3195984.149999913,162383,0,80,0.28070393705918234,3699389544,-5811,-5811,49902125.71665758,-4562.083333249204,-1776,0,-3,0.5858151943147274,-3666953059,1762.1860579148329,1480.1183768019835,282.0676811128494,0.7743529661343824,0.7615784709617811,-1776
783,2019-02-23,2019,206172,206172,365440660.3333334,3179781.7333333394,160426,0,73,0.8809295151620983,32441007,4381433694,212795,212795,476845,689640,315858379.4500097,3176413.1333332215,162258,0,55,0.2769415927150418,3706979384,-6623,-6623,49582280.88332367,3368.6000001179054,-1832,0,18,0.6039879224470565,-3674538377,1772.5038333689026,1484.33177212815,288.17206124075256,0.7781173001183478,0.7625085175873493,-1832
784,2019-02-24,2019,212256,212256,365949531.76666635,3242065.966666666,163567,0,65,0.8649649479873373,32987651,4385293267,214307,214307,488110,702417,315622520.8833425,3237720.549999846,164516,0,54,0.26691979265878035,3708110020,-2051,-2051,50327010.88332385,4345.416666819714,-949,0,11,0.5980451553285568,-3675122369,1724.0951104640922,1472.7588034144592,251.33630704963298,0.7706119026081713,0.7676650786021921,-949
785,2019-02-25,2019,215847,215847,366861689.6333335,3290097.46666667,167467,0,120,0.8658308894726371,33180392,4395071144,217753,217753,496415,714168,316640316.6999981,3287020.8333332455,168258,0,120,0.26647231463745585,3716626933,-1906,-1906,50221372.93333542,3076.633333424572,-791,0,0,0.5993585748351813,-3683446541,1699.6376583104397,1454.1260818450173,245.51157646542242,0.7758597525098797,0.7727011797770869,-791
786,2019-02-26,2019,219974,219974,367455831.3166668,3329747.7000000016,170420,0,178,0.87162119159537,33236411,4401375356,222005,222005,504340,726345,317460937.65000296,3326206.066666213,171314,0,178,0.2728042459161953,3720768158,-2031,-2031,49994893.666663826,3541.633333788719,-894,0,0,0.5988169456791748,-3687531747,1670.45119567161,1429.972017071701,240.47917859990912,0.774727922390828,0.7716673047904327,-894
787,2019-02-27,2019,219206,219206,368188482.19999975,3347137.800000005,170676,0,131,0.8767734459823173,33783372,4409296545,220698,220698,513740,734438,318408443.6000035,3342595.399999569,171621,0,132,0.26903019723926413,3731171413,-1492,-1492,49780038.59999627,4542.400000435766,-945,0,-1,0.6077432487430532,-3697388041,1679.6460051275958,1442.7337066942314,236.9122984333644,0.7786100745417552,0.7776282521817144,-945
788,2019-02-28,2019,217245,217245,368760848.98333335,3303421.283333332,169445,0,79,0.8759096872194987,32991968,4415524115,218850,218850,526296,745146,319146970.2499932,3300462.5499999933,170371,0,79,0.2643629570580816,3742169651,-1605,-1605,49613878.733340144,2958.7333333385177,-926,0,0,0.611546730161417,-3709177683,1697.4422839804522,1458.290931002939,239.15135297751317,0.7799719211029023,0.7784829792095043,-926
789,2019-03-01,2019,215615,215615,369071776.81666577,3288486.4,168510,0,68,0.8735013797741341,32383343,4420081212,217239,217239,253145,470384,319614820.8833449,3286666.3499998627,169498,0,65,0.41139579577536295,3724563766,-1624,-1624,49456955.93332088,1820.0500001371838,-988,0,3,0.46210558399877116,-3692180423,1711.716609775135,1471.2589400768043,240.45766969833085,0.7815318971314612,0.7802374343465032,-988
790,2019-03-02,2019,209721,209721,369073351.88333356,3253823.3500000057,164178,0,74,0.887903452682373,31927441,4422048880,211538,211538,267961,479499,319833024.16667753,3251117.899999846,165116,0,66,0.4039674743847299,3732349106,-1817,-1817,49240327.71665603,2705.450000159908,-938,0,8,0.4839359782976431,-3700421665,1759.8302119641503,1511.9412312051618,247.8889807589885,0.7828400589354428,0.7805500666546908,-938
791,2019-03-03,2019,208732,208732,369152009.4499996,3224116.8333333298,162594,0,71,0.86738976294962,32361112,4425690365,209530,209530,281835,491365,320035965.2666775,3220599.7666665334,163300,0,66,0.37437953456187467,3746005551,-798,-798,49116044.18332207,3517.066666796338,-706,0,5,0.49301022838774533,-3713644439,1768.5453569649098,1527.3992519766978,241.14610498821207,0.778960581032137,0.7793633369923162,-706
792,2019-03-04,2019,214805,214805,369776789.96666694,3282980.150000001,167633,0,86,0.8723307185586926,33053310,4434204084,215743,215743,293249,508992,320901277.5333428,3279482.5333332513,168430,0,71,0.3757387149503409,3758993619,-938,-938,48875512.43332416,3497.6166667495854,-797,0,15,0.4965920036083517,-3725940309,1721.4533645244148,1487.423821553157,234.0295429712578,0.780396173273434,0.7806974038555132,-797
793,2019-03-05,2019,217702,217702,369980898.0833332,3298755.6333333347,169327,0,83,0.863152382614767,33245058,4434935691,218668,218668,301340,520008,321338846.85000926,3293968.233333215,170153,0,65,0.36911355209920055,3762499133,-966,-966,48642051.23332393,4787.400000119582,-826,0,18,0.49403883051556646,-3729254075,1699.483229751372,1469.5284488357202,229.95478091565178,0.7777925788463128,0.7781339747928366,-826
794,2019-03-06,2019,211442,211442,370227904.7666661,3267222.4833333315,165608,0,75,0.8664314563804737,33149160,4438920856,212211,212211,314930,527141,321838645.5166795,3262624.6833332134,166291,0,65,0.354305584274411,3770561679,-769,-769,48389259.24998659,4597.800000118092,-683,0,10,0.5121258721060626,-3737412519,1750.9667179021487,1516.5973748612444,234.36934304090437,0.7832313353070819,0.7836115941209456,-683
795,2019-03-07,2019,210895,210895,370493300.5000003,3266771.1333333347,164915,0,75,0.8801109556888493,33226829,4442313166,211895,211895,329496,541391,322344689.28333926,3262214.7333332505,165770,0,64,0.35515366897492323,3780481914,-1000,-1000,48148611.216661036,4556.400000084192,-855,0,11,0.524957286713926,-3747255085,1756.7666397970568,1521.2472653122502,235.51937448480658,0.781976813106048,0.7823214327851058,-855
796,2019-03-08,2019,222592,222592,371035688.6333328,3359394.6999999974,171390,0,84,0.862277170787809,33908630,4446713810,227523,227523,337684,565207,323119318.91668594,3359066.1666665277,173199,0,70,0.34776462428809307,3789226631,-4931,-4931,47916369.71664685,328.5333334696479,-1809,0,14,0.5145125464997159,-3755318001,1666.8868990499784,1420.1611218060852,246.72577724389316,0.7699737636572743,0.7612373254572066,-1809
797,2019-03-09,2019,221771,221771,371182304.2833332,3338538.06666667,171671,0,69,0.8602026414634908,33429380,4448520602,221563,221563,354536,576099,323072009.8000067,3330974.049999878,172283,0,68,0.33485043369281847,3786137822,208,208,48110294.483326495,7564.016666792333,-612,0,1,0.5253522077706723,-3752708442,1673.7188554109111,1458.149645021988,215.56921038892324,0.7740912923691555,0.7775801916384956,-612
798,2019-03-10,2019,220973,220973,371260764.2666662,3341987.75,170690,0,78,0.8656758970552969,33900507,4446542829,220543,220542,364406,584949,323283113.35001254,3335399.533333212,171270,0,59,0.33186311969077376,3789612737,430,431,47977650.91665363,6588.216666787863,-580,0,19,0.5338127773645231,-3755712230,1680.1182237950618,1465.8573575555338,214.260866239528,0.7724473125675988,0.7765832513387412,-580
799,2019-03-11,2019,229633,229633,371602624.9333334,3414900.466666665,178269,0,85,0.8660950298955282,34147695,4446947464,229281,229281,374681,603962,323844044.85000634,3408600.966666518,178817,0,85,0.3341865878979157,3796473737,352,352,47758580.083327055,6299.500000147149,-548,0,0,0.5319084419976126,-3762326042,1618.2457440060157,1412.4329746032438,205.8127694027719,0.7763213475415119,0.7799032628085188,-548
800,2019-03-12,2019,226539,226539,371721983.16666687,3397345.9333333317,175990,0,136,0.878533056118373,33594378,4443202306,227078,227078,383082,610160,324314303.9000112,3391708.583333207,176737,0,136,0.3357430837813066,3796722581,-539,-539,47407679.26665568,5637.35000012489,-747,0,0,0.5427899723370664,-3763128203,1640.874123955111,1428.2066245960032,212.66749935910775,0.7768640278274381,0.7783096557130149,-747
801,2019-03-13,2019,225607,225607,371795390.1166664,3396636.3833333356,176128,0,77,0.8725837407527247,33849218,4440998706,225481,225481,397662,623143,324669534.61667955,3388978.666666525,176702,0,68,0.3224990090557078,3803350252,126,126,47125855.49998683,7657.71666681068,-574,0,9,0.550084731697017,-3769501034,1647.9780774384942,1439.8975284688267,208.08054896966746,0.7806849964761732,0.7836669165029426,-574
802,2019-03-14,2019,225995,225995,371996533.4500002,3382878.68333333,175851,0,77,0.8741874820239396,33873789,4441440321,225592,225592,408051,633643,325173728.6500126,3374894.016666557,176465,0,61,0.3215706636071138,3812089332,403,403,46822804.799987614,7984.666666772682,-614,0,16,0.5526168184168259,-3778215543,1646.038777185337,1441.424025009808,204.61475217552902,0.778118984933295,0.7822307528635767,-614
803,2019-03-15,2019,225885,225885,371800932.01666605,3377489.7000000007,175570,0,70,0.8663390663390664,33682803,4440244266,224873,224873,422732,647605,325420865.6666759,3370096.6166665154,175865,0,70,0.30715636846534555,3816994606,1012,1012,46380066.34999013,7393.083333485294,-295,0,0,0.5591826978737209,-3783311803,1645.9744206860396,1447.1317840144256,198.84263667161395,0.7772539123890475,0.7820636537067589,-295
804,2019-03-16,2019,228159,228159,371545118.133333,3403076.0833333344,177192,0,114,0.8771032481734229,33646780,4437374504,235280,235279,433769,669049,325419197.0166868,3398070.349999858,180236,0,117,0.31119095910762506,3823174499,-7121,-7120,46125921.11664623,5005.733333476353,-3044,0,-3,0.5659122890657978,-3789527719,1628.4482230958806,1383.120452810012,245.3277702858686,0.7766163070490316,0.7660489629377762,-3044
805,2019-03-17,2019,232767,232767,371262070.4999996,3447617.233333333,178689,0,76,0.8784707454235344,33265369,4427822692,232204,232204,444955,677159,322276880.58334327,3438975.7833331637,179515,0,68,0.3136264894950808,3766991278,563,563,48985189.916656315,8641.450000169221,-826,0,8,0.5648442559284537,-3733725909,1594.9944386446514,1387.904086851834,207.09035179281727,0.7676732526517934,0.77309176413843,-826
806,2019-03-18,2019,234650,234650,371664047.66666645,3487788.316666664,180556,0,81,0.8755550820370769,34473970,4432138548,235616,235616,454361,689977,323039752.6833452,3481442.966666556,181620,0,73,0.3138669839719273,3774579144,-966,-966,48624294.98332125,6345.350000108127,-1064,0,8,0.5616880980651495,-3740105174,1583.9081511470977,1371.043361585568,212.86478956152973,0.7694694225442148,0.7708305038707048,-1064
807,2019-03-19,2019,234930,234930,372104597.71666676,3473957.083333338,181489,0,118,0.8742859575192619,34240558,4434320442,235687,235687,464543,700230,323735305.2333471,3468091.1333332676,182357,0,118,0.3038558759264877,3771613144,-757,-757,48369292.48331964,5865.950000070501,-868,0,0,0.5704300815927741,-3737372586,1583.895618765874,1373.5815095162106,210.31410924966326,0.7725237304729068,0.7737253221433511,-868
808,2019-03-20,2019,225004,225004,371528110.0666662,3405142.9166666623,176430,0,151,0.8865353504826581,34165548,4430383422,226051,226051,479331,705382,323555862.5166751,3401280.349999858,177237,0,151,0.29353598475718473,3778670399,-1047,-1047,47972247.54999107,3862.566666804254,-807,0,0,0.5929993657254733,-3744504851,1651.2066899551394,1431.3401069523034,219.86658300283602,0.7841193934330056,0.7840575799266537,-807
809,2019-03-21,2019,224429,224429,371597058.5666667,3396962.7333333343,177525,0,78,0.8849524794032859,33615132,4432346072,225685,225685,492027,717712,323843652.9500131,3393130.0499993702,178342,0,61,0.2883663642240918,3788200708,-1256,-1256,47753405.61665362,3832.683333964087,-817,0,17,0.5965861151791941,-3754585576,1655.7443938469037,1434.9365396460248,220.80785420087886,0.7910074010043265,0.7902253140439107,-817
810,2019-03-22,2019,222152,222152,371599441.116667,3376719.9166666684,175738,0,93,0.8824093413518665,34208111,4434507065,223012,223012,504155,727167,324070826.10001415,3371449.999999391,176498,0,93,0.2766338406445761,3796250240,-860,-860,47528615.01665282,5269.916667277459,-760,0,0,0.6057755007072905,-3762042129,1672.7260664620035,1453.154207396975,219.57185906502855,0.7910709784291836,0.7914282639499219,-760
811,2019-03-23,2019,216749,216749,371104708.60000026,3344396.416666668,171329,0,66,0.8817572399411305,33877953,4425841515,217468,217468,519144,736612,323979676.06666905,3340044.4833328016,171945,0,69,0.26544639511710355,3806514137,-719,-719,47125032.533331215,4351.933333866298,-616,0,-3,0.616310844824027,-3772636184,1712.140349436446,1489.7809151997951,222.35943423665094,0.7904488602023538,0.7906680523111447,-616
812,2019-03-24,2019,222886,222886,371025593.23333347,3373063.3499999987,175687,0,74,0.8816390441750496,34262931,4426172147,223453,223453,529097,752550,324152954.9833263,3367675.499999985,176183,0,65,0.2632011162049022,3815847133,-567,-567,46872638.25000715,5387.850000013597,-496,0,9,0.6184379279701473,-3781584202,1664.6428812636661,1450.6538510708128,213.9890301928533,0.788237035973547,0.7884566329384702,-496
813,2019-03-25,2019,235249,235249,371918491.5999999,3508773.249999998,184382,0,118,0.8767093590195915,34598967,4435226827,238424,238424,535381,773805,325252754.5500084,3506182.78333284,186022,0,117,0.2708511834376873,3825592436,-3175,-3175,46665737.04999149,2590.4666671580635,-1640,0,1,0.6058581755819041,-3790993469,1580.956737754464,1364.1779122488022,216.77882550566187,0.7837737886239686,0.7802150790188908,-1640
814,2019-03-26,2019,242113,242113,372410101.2833333,3568343.7833333327,186106,0,136,0.8641832532742975,35580777,4434574157,243117,243117,543448,786565,325889100.3833266,3562149.1833332977,186931,0,136,0.2698238543540575,3820251776,-1004,-1004,46521000.90000671,6194.600000035018,-825,0,0,0.59435939892024,-3784670999,1538.1664812849094,1340.4620013546012,197.70447993030825,0.7686741315005803,0.76889316666461,-825
815,2019-03-27,2019,233942,233942,372812947.58333373,3517852.9833333353,182705,0,179,0.8741782151131481,34824937,4437972729,234959,234959,554629,789588,326479235.4333304,3511756.9166666553,183506,0,179,0.264606351666946,3824425394,-1017,-1017,46333712.150003314,6096.0666666799225,-801,0,0,0.6095718634462021,-3789600457,1593.612722740396,1389.5157684248334,204.0969543155627,0.7809841755648836,0.7810128575623833,-801
816,2019-03-28,2019,236636,236636,373125500.4666669,3536696.5666666594,184843,0,147,0.8680927669500845,35046615,4443760664,237691,237691,568259,805950,326999833.18332744,3532371.8499999503,185570,0,149,0.2579365965630654,3835372881,-1055,-1055,46125667.28333944,4324.716666709166,-727,0,-2,0.6101561703870191,-3800326266,1576.7909382624237,1375.7350222908206,201.0559159716031,0.7811279771463344,0.7807195055765679,-727
817,2019-03-29,2019,235775,235775,373375678.1333328,3509111.266666671,185239,0,189,0.875194571095324,35402898,4445318038,236576,236576,578900,815476,327470354.7499945,3504273.8833332676,185953,0,189,0.2570081768194268,3842856450,-801,-801,45905323.38333827,4837.3833334031515,-714,0,0,0.6181863942758972,-3807453552,1583.6101288657949,1384.2078433568686,199.4022855089263,0.785660057257979,0.7860180238063033,-714
818,2019-03-30,2019,223610,223610,372973208.3833333,3390080.3500000034,176964,0,169,0.8733732838424042,34624252,4446434209,224220,224220,596288,820508,327298872.29999155,3384788.8666666644,177531,0,169,0.24079107089754087,3853701965,-610,-610,45674336.08334178,5291.483333338983,-567,0,0,0.6325822129448633,-3819077713,1667.9630087354471,1459.722024351046,208.24098438440114,0.791395733643397,0.7917714744447417,-567
819,2019-03-31,2019,218068,218068,372642525.1833341,3334729.7666666666,173279,0,133,0.8805922923124897,33575061,4444925362,218942,218942,611037,829979,327137637.36666155,3331628.6166666523,173951,0,133,0.23457340486928055,3865589156,-874,-874,45504887.81667256,3101.1500000143424,-672,0,0,0.6460188874432091,-3832014095,1708.8363500528924,1494.1748836068984,214.66146644599394,0.7946099381844195,0.7945072210905171,-672
820,2019-04-01,2019,236429,236429,373225224.59999996,3476825.233333335,185574,0,164,0.8721688117785892,34018212,4451254822,237451,237451,292155,529606,327852646.48333853,3472790.4999998054,186451,0,166,0.39421947636545057,3844606298,-1022,-1022,45372578.11666143,4034.733333529439,-877,0,-2,0.4779493354131386,-3810588086,1578.5932546345837,1380.7170594494803,197.87619518510337,0.7849037131654746,0.7852188451512101,-877
821,2019-04-02,2019,232938,232938,372639303.45000005,3502347.8333333307,182874,0,172,0.8665868170929601,34927035,4445133923,233244,233244,303435,536679,327312270.86668056,3494921.6499998905,183312,0,174,0.3808701290715689,3831389069,-306,-306,45327032.583319485,7426.183333440218,-438,0,-2,0.48571668802139123,-3796462034,1599.7359960590375,1403.3041401565768,196.4318559024607,0.785075857095021,0.7859237536656891,-438
822,2019-04-03,2019,226448,226448,372108036.56666654,3437413.9333333303,176995,0,204,0.8592877835087972,34210126,4442366979,227792,227792,314023,541815,327161646.9000059,3434894.94999988,177842,0,204,0.36390649945091813,3839091833,-1344,-1344,44946389.66666067,2518.9833334502764,-847,0,0,0.49538128405787907,-3804881707,1643.238344196754,1436.2297486303553,207.00859556639875,0.7816143220518618,0.7807210086394606,-847
823,2019-04-04,2019,225624,225624,372168421.48333377,3390749.316666668,175345,0,84,0.8540802396908135,34411590,4445207064,226751,226751,326510,553261,327401329.4000114,3385464.5166665465,176235,0,86,0.3526436889641582,3847232461,-1127,-1127,44767092.083322346,5284.800000121351,-890,0,-2,0.5014365507266553,-3812820871,1649.5072398474176,1443.8804212550833,205.6268185923343,0.7771557990284721,0.777218182058734,-890
824,2019-04-05,2019,230451,230451,372208295.4666668,3448392.4500000025,179261,0,56,0.8564944391649417,35709930,4448321389,231364,231364,340452,571816,327559847.21667445,3443059.4999998705,180011,0,51,0.348825496313494,3853314422,-913,-913,44648448.24999237,5332.950000131968,-750,0,5,0.5076689428514477,-3817604492,1615.1298777903623,1415.7770751572175,199.35280263314485,0.77787034987915,0.7780423920748258,-750
825,2019-04-06,2019,234631,234631,372595225.5333334,3497267.0333333286,183151,0,81,0.862123930767887,35361951,4453169359,235672,235672,347962,583634,328113236.30001575,3491647.133333223,184082,0,81,0.3516244769838609,3864108729,-1041,-1041,44481989.23331767,5619.900000105612,-931,0,0,0.5104994537840261,-3828746778,1588.0051039007353,1392.2453083099213,195.75979559081406,0.7805916524244452,0.7810940629349266,-931
826,2019-04-07,2019,238998,238998,373142790.5,3515908.2666666633,185246,0,59,0.8537100728876388,34812118,4458757255,239876,239876,358913,598789,328801897.06667423,3512037.783333199,186083,0,55,0.3440443962731429,3875783541,-878,-878,44340893.43332577,3870.4833334642462,-837,0,4,0.5096656766144958,-3840971423,1561.2799709621002,1370.7161077668222,190.56386319527792,0.7750943522539938,0.7757466357618102,-837
827,2019-04-08,2019,241071,241071,373845559.8333331,3560333.3666666634,187334,0,61,0.8510272907151829,35270088,4466374787,242069,242069,370264,612333,329656482.3333459,3555893.166666489,188174,0,55,0.3387535866922158,3886279095,-998,-998,44189077.499987185,4440.200000174344,-840,0,6,0.5122737040229671,-3851009007,1550.769523639646,1361.8285791792666,188.94094446037934,0.7770905666795259,0.7773568693223832,-840
828,2019-04-09,2019,226433,226433,373958171.2666675,3447511.8999999957,178001,0,65,0.860148476591309,34862412,4471629159,227082,227082,386028,613110,329958643.2166709,3442904.1333331955,178581,0,62,0.32067328864314587,3889960863,-649,-649,43999528.049996614,4607.766666800249,-580,0,3,0.5394751879481632,-3855098451,1651.5179822140212,1453.0374191555072,198.480563058514,0.7861089152199547,0.7864163606098238,-580
829,2019-04-10,2019,232734,232734,374043333.5666663,3489148.683333336,183546,0,59,0.8567721089312256,34430714,4473398236,233408,233408,398650,632058,330285646.4500181,3484605.749999607,184037,0,56,0.31733796581959317,3899413132,-674,-674,43757687.1166482,4542.933333728928,-491,0,3,0.5394341431116324,-3864982418,1607.1709916327925,1415.0570950867927,192.11389654599975,0.7886514217948387,0.7884776871401151,-491
830,2019-04-11,2019,236643,236643,374484150.55,3540621.7833333365,185515,0,59,0.8590704140836626,34819804,4477577602,237592,237592,405515,643107,330850466.7000123,3535545.866666522,186270,0,55,0.3196513177433828,3907146952,-949,-949,43633683.849987686,5075.916666814592,-755,0,4,0.5394190963402798,-3872327148,1582.4856452546665,1392.5151802249752,189.97046502969124,0.7839445916422628,0.7839910434694771,-755
831,2019-04-12,2019,237947,237947,374753968.7833336,3546074.583333332,186779,0,56,0.8578927240099696,35851348,4482521929,238822,238822,415721,654543,331193498.8833425,3543921.1999994596,187485,0,52,0.31489604197127513,3912890806,-875,-875,43560469.899991095,2153.383333872538,-706,0,4,0.5429966820386944,-3877039458,1574.947231036044,1386.7796889873734,188.1675420486706,0.7849605164175215,0.7850407416402174,-706
832,2019-04-13,2019,235850,235850,374921613.48333335,3532020.0166666666,185041,0,67,0.8569217723129104,35802589,4485043101,236620,236620,428022,664642,331581065.8333441,3525965.3166665677,185729,0,68,0.3064085628052288,3921327857,-770,-770,43340547.64998925,6054.7000000989065,-688,0,-1,0.5505132095076817,-3885525268,1589.6612825242032,1401.323074268211,188.33820825599219,0.7845707017171931,0.7849251965176232,-688
833,2019-04-14,2019,230319,230319,374437553.1333335,3456883.3666666695,180743,0,73,0.858991225213724,34984251,4480857679,231025,231025,441939,672964,331345477.75000954,3451326.3333332296,181352,0,73,0.2961644307867862,3932905378,-706,-706,43092075.38332397,5557.033333439846,-609,0,0,0.5628267944269377,-3897921127,1625.7345383287245,1434.2407867114362,191.49375161728835,0.7847507153122408,0.784988637593334,-609
834,2019-04-15,2019,242374,242374,375183211.36666685,3591688.549999994,187324,0,47,0.8477146888692677,35450838,4489083225,243373,243373,451277,694650,332223321.05001354,3585343.8333332087,188237,0,43,0.2992902900741372,3943795549,-999,-999,42959890.31665331,6344.7166667855345,-913,0,4,0.5484243987951305,-3908344711,1547.9515598482794,1365.0787928406749,182.87276700760458,0.772871677655194,0.7734506292809802,-913
835,2019-04-16,2019,240667,240667,375440213.8999999,3532212.0833333344,189278,0,52,0.8579115541391202,34029045,4487370505,241643,241643,457361,699004,332578344.30000997,3526918.2333334973,189959,0,48,0.29812275752356476,3943703490,-976,-976,42861869.59998995,5293.849999837112,-681,0,4,0.5597887966155555,-3909674445,1559.9987281181047,1376.3210368188193,183.67769129928547,0.7864725949133035,0.7861142263587193,-681
836,2019-04-17,2019,236522,236522,375323008.116667,3468452.566666669,185779,0,56,0.8553749756893657,28656198,4483759217,237498,237498,472189,709687,332602654.2500119,3463429.316666688,186515,0,60,0.28790015880238246,3943651126,-976,-976,42720353.86665505,5023.249999981374,-736,0,-4,0.5674748168869832,-3914994928,1586.841850300044,1400.4440216339167,186.39782866612723,0.7854618175053484,0.7853329291194031,-736
837,2019-04-18,2019,244168,244168,376261483.43333286,3630323.1333333347,191426,0,52,0.8616813013990364,35260101,4493287867,247490,247490,477017,724507,333658062.8166609,3627390.699999941,192650,0,50,0.2932559657808668,3948136545,-3322,-3322,42603420.61667198,2932.433333393652,-1224,0,2,0.5684253356181697,-3912876444,1540.9942475399432,1348.167856546369,192.82639099357425,0.7839929884341929,0.7784152895066467,-1224
838,2019-04-19,2019,245875,245875,376661086.0166664,3655585.966666664,193731,0,58,0.8717925775292319,36127808,4497023375,256341,256341,489718,746059,333978027.41665375,3651537.766666646,200061,0,47,0.29753544960921313,3953610853,-10466,-10466,42683058.60001266,4048.2000000178814,-6330,0,11,0.5742571279200188,-3917483045,1531.9210412472453,1302.8662110885646,229.05483015868072,0.7879247585155058,0.7804486991936522,-6330
839,2019-04-20,2019,245767,245767,376957422.0499999,3664370.4166666633,192917,0,61,0.8678504437129483,36301894,4500782741,246845,246845,500263,747108,328159671.4166621,3658793.516666583,193806,0,48,0.2891817515004539,3837372517,-1078,-1078,48797750.633337796,5576.900000080466,-889,0,13,0.5786686922124944,-3801070623,1533.7999896243186,1329.415914507736,204.3840751165826,0.7849589245098,0.7851323705159108,-889
840,2019-04-21,2019,241842,241842,376288973.03333294,3634063.7666666666,190661,0,57,0.8703409664160892,36497528,4488653559,242803,242802,512636,755439,327452293.6333302,3627524.416666611,191519,0,54,0.28292290972533285,3840913718,-961,-960,48836679.40000272,6539.350000055507,-858,0,3,0.5874180566907563,-3804416190,1555.928966156966,1348.6391942131047,207.2897719438613,0.7883700928705518,0.7887834993801559,-858
841,2019-04-22,2019,240221,240221,376036100.1833336,3598875.1333333314,189949,0,62,0.8750483929381685,36001313,4484692632,241173,241173,525058,766231,327474779.65000844,3593680.416666152,190776,0,62,0.27873970121282826,3849061952,-952,-952,48561320.533325136,5194.716667179484,-827,0,0,0.5963086917253402,-3813060639,1565.3756340342168,1357.8417967600371,207.53383727417963,0.7907260397717102,0.7910338221940267,-827
842,2019-04-23,2019,238023,238023,376025542.9333337,3573238.333333336,187084,0,73,0.8679371321258873,35218157,4486872603,239082,239082,536448,775530,327649995.2666605,3568663.3166666236,187882,0,73,0.2699237940505166,3853924074,-1059,-1059,48375547.66667318,4575.016666712239,-798,0,0,0.5980133380753707,-3818705917,1579.7865875706705,1370.450285954863,209.33630161580754,0.7859912697512426,0.7858475334822362,-798
843,2019-04-24,2019,238987,238987,376005963.8499992,3564957.700000001,187252,0,79,0.8605405314933448,34762729,4488850616,239925,239925,547468,787393,327827274.5833271,3558852.199999947,188035,0,79,0.2647458130819025,3854741502,-938,-938,48178689.266672075,6105.500000054017,-783,0,0,0.5957947184114423,-3819978773,1573.3322894132282,1366.3739692959346,206.95832011729362,0.7835237899969454,0.7837240804418047,-783
844,2019-04-25,2019,241242,241242,376279641.0999996,3590833.0166666633,189648,0,105,0.8598834365491907,34983391,4493189904,242096,242096,554752,796848,328261865.766662,3585118.049999967,190371,0,106,0.2627125875951248,3857651247,-854,-854,48017775.333337605,5714.9666666961275,-723,0,-1,0.5971708489540659,-3822667856,1559.7600795052256,1355.916106695947,203.8439728092785,0.7861317681000821,0.7863450862467781,-723
845,2019-04-26,2019,239537,239537,376433811.54999995,3620926.2,190677,0,96,0.8708425003235408,35143037,4495419231,240328,240328,566487,806815,328654419.18333304,3615653.8499994534,191345,0,96,0.2612284104782475,3862212442,-791,-791,47779392.36666691,5272.3500005467795,-668,0,0,0.6096140898452933,-3827069405,1571.5059116128195,1367.52446316423,203.98144844858962,0.7960231613487687,0.7961827169534968,-668
846,2019-04-27,2019,238031,238031,376430436.96666646,3616954.6166666653,189353,0,136,0.8798853930790517,36143876,4497294121,239029,239029,576015,815044,328813587.1499935,3611430.883333304,190206,0,136,0.26236006890425534,3869521919,-998,-998,47616849.81667298,5523.733333361335,-853,0,0,0.6175253241747963,-3833378043,1581.4345062897962,1375.6221510778755,205.8123552119207,0.7954972251513458,0.7957444494182714,-853
847,2019-04-28,2019,236467,236467,375387375.7666666,3606833.7666666624,188174,0,249,0.8896125040703355,34123206,4482712469,237429,237429,588344,825773,327923814.4333265,3600960.983333258,188979,0,249,0.25934609148034216,3877020167,-962,-962,47463561.33334011,5872.783333404455,-805,0,0,0.6302664125899934,-3842896961,1587.483140424104,1381.1447398309663,206.33840059313775,0.7957727716763862,0.7959389965000063,-805
848,2019-04-29,2019,240730,240730,375008229.3833333,3634884.3500000024,192340,0,354,0.88340879823869,35784051,4479864525,242039,242039,596740,838779,327899653.5166698,3629438.0333328433,193274,0,354,0.25634285073897983,3882205745,-1309,-1309,47108575.866663516,5446.316667159088,-934,0,0,0.6270659474997102,-3846421694,1557.7959929519932,1354.738920242894,203.0570727090992,0.7989864163170357,0.7985242047769161,-934
849,2019-04-30,2019,239599,239599,373175646.3999998,3501476.733333336,191360,0,427,0.879264938501413,33807721,4462662039,240632,240632,604438,845070,326348040.0500004,3497569.1499996656,192104,0,427,0.25187735927201593,3874721392,-1033,-1033,46827606.34999937,3907.5833336706273,-744,0,0,0.627387579229397,-3840913671,1557.5008510052203,1356.2121415688705,201.2887094363498,0.7986677740725128,0.7983310615379501,-744
850,2019-05-01,2019,220368,220368,370500368.2666666,3351744.1500000027,173540,0,513,0.8629928120235248,32464542,4444949320,224784,224784,282573,507357,323817149.7833357,3351731.333333132,174941,0,518,0.38026084197123666,3817622955,-4416,-4416,46683218.483330905,12.816666870843619,-1401,0,-5,0.4827319700522882,-3785158413,1681.2802596868266,1440.5702798390264,240.70997984780024,0.7875009075727873,0.7782626877357819,-1401
851,2019-05-02,2019,227427,227427,370838034.88333344,3511812.150000005,178605,0,582,0.8608080834729394,35098622,4449428365,228221,228221,296453,524674,324114227.63333285,3504136.7333330894,179208,0,584,0.3758791173185619,3821289349,-794,-794,46723807.250000596,7675.41666691564,-603,0,-2,0.48492896615437747,-3786190727,1630.5805154327913,1420.1770548430375,210.40346058975388,0.7853289187299661,0.7852388693415593,-603
852,2019-05-03,2019,227970,227970,370773771.7166669,3526976.98333333,178888,0,574,0.8634688774838793,35364174,4451168803,233631,233631,297519,531150,324141882.3666717,3524113.749999768,180099,0,574,0.37510119551915494,3814396773,-5661,-5661,46631889.349995196,2863.233333562035,-1211,0,0,0.4883676819647244,-3779032599,1626.4147550847342,1387.4095576643153,239.00519742041888,0.7846997411940168,0.7708694479756539,-1211
853,2019-05-04,2019,221924,221924,370704985.48333323,3473569.4000000027,174682,0,436,0.872559975487104,31754210,4448774218,222866,222866,315197,538063,323533455.8166671,3467217.5333330184,175468,0,439,0.36558730111529963,3810380387,-942,-942,47171529.66666615,6351.866666984279,-786,0,-3,0.5069726743718044,-3778626177,1670.4141304380473,1451.6949907866929,218.71913965135445,0.7871253221823687,0.7873251191298808,-786
854,2019-05-05,2019,220695,220695,370713079.8333332,3427842.633333335,174112,0,360,0.8635718978680981,34513239,4452886984,221315,221315,322381,543696,323519184.50000477,3422144.399999896,174639,0,360,0.3531753038462588,3816104509,-620,-620,47193895.333328426,5698.2333334391005,-527,0,0,0.5103965940218393,-3781591270,1679.7529614777552,1461.8041456747385,217.9488158030167,0.788925893201024,0.789096988455369,-527
855,2019-05-06,2019,221079,221079,370935721.8666661,3444260.883333333,175046,0,66,0.8743752233364539,34336906,4457094041,222171,222171,336529,558700,323881539.7666733,3438532.2499998165,175977,0,54,0.3514193663862516,3823279778,-1092,-1092,47054182.09999275,5728.633333516307,-931,0,12,0.5229558569502023,-3788942872,1677.8424086714074,1457.8029525305883,220.03945614081908,0.79178031382447,0.7920790742266093,-931
856,2019-05-07,2019,227347,227347,371631276.0666668,3516426.150000004,177806,0,65,0.8768710385446044,34167366,4463229240,228532,228532,338450,566982,324711910.8333378,3509842.1166665126,178851,0,57,0.3589867050453144,3821998243,-1185,-1185,46919365.233329,6584.033333491534,-1045,0,8,0.51788433349929,-3787830877,1634.6434132258917,1420.8597081955165,213.78370503037513,0.7820908127224023,0.7826081249015455,-1045
857,2019-05-08,2019,228216,228216,371900507.3333337,3516579.9166666665,178109,0,68,0.8633619027587898,34049238,4466414792,229890,229890,347209,577099,325196647.0500047,3509805.3166664606,179300,0,68,0.345876530716568,3828783127,-1674,-1674,46703860.28332895,6774.600000205915,-1191,0,0,0.5174853720422218,-3794733889,1629.598745632794,1414.5750013049924,215.02374432780152,0.7804404599151681,0.7799382313280264,-1191
858,2019-05-09,2019,227205,227205,372362672.8833334,3529860.6999999993,178861,0,53,0.8677361853832434,35014935,4472100522,228467,228467,356981,585448,325445397.8000078,3524072.1666665226,179751,0,52,0.34053921099739154,3826793142,-1262,-1262,46917275.083325565,5788.533333476633,-890,0,1,0.5271969743858518,-3791778207,1638.8841481628194,1424.4744221266433,214.40972603617615,0.7872229924517506,0.7867700805805653,-890
859,2019-05-10,2019,233666,233666,373058219.3000003,3544603.533333335,182988,0,60,0.8699596860476068,35899489,4479184556,234881,234881,363219,598100,326301833.4833425,3538205.483333203,183990,0,54,0.3450660424678124,3831171940,-1215,-1215,46756385.81665778,6398.0500001320615,-1002,0,6,0.5248936435797944,-3795272451,1596.544723237443,1389.2219186879422,207.3228045495007,0.7831177835029487,0.7833328366279094,-1002
860,2019-05-11,2019,230845,230845,373384013.2833332,3518756.1500000055,181597,0,66,0.8748337629145093,35635472,4482287495,232182,232182,372924,605106,326724469.85001236,3513090.3166664867,182719,0,60,0.33961487739338164,3838592922,-1337,-1337,46659543.43332082,5665.833333518822,-1122,0,6,0.5352188855211277,-3802957450,1617.4663227851293,1407.1912114204044,210.2751113647248,0.786662045961576,0.7869645364412401,-1122
861,2019-05-12,2019,224592,224592,373964856.28333354,3491538.3666666653,178340,0,59,0.8694655196979402,34730245,4488597610,225291,225291,383187,608478,327449334.46667886,3485339.133333112,178932,0,57,0.32343486535257304,3851315656,-699,-699,46515521.81665468,6199.233333553188,-592,0,2,0.5460306543453671,-3816585411,1665.0853827533194,1453.4505793248682,211.63480342845128,0.7940621215359407,0.7942261341997683,-592
862,2019-05-13,2019,224170,224170,374089361.31666714,3473934.266666666,178137,0,109,0.8707275728241951,34406514,4491368266,224859,224859,395863,620722,327727998.4166782,3468793.5499998513,178771,0,109,0.31775899678116865,3862578959,-689,-689,46361362.89998895,5140.716666814871,-634,0,0,0.5529685760430265,-3828172445,1668.7753103299601,1457.4822373873324,211.29307294262776,0.7946513806486148,0.7950360003379896,-634
863,2019-05-14,2019,230597,230597,374506156.0166666,3477443.8833333324,179718,0,184,0.8580553953433923,34672923,4495452347,231497,231497,400113,631610,328337193.4833441,3471782.799999904,180439,0,186,0.3168315891135375,3861572588,-900,-900,46168962.53332251,5661.0833334284835,-721,0,-2,0.5412238062298548,-3826899665,1624.0721085559076,1418.3215915685478,205.7505169873598,0.7793596620944765,0.779444226059085,-721
864,2019-05-15,2019,229185,229185,372295330.55000025,3475140.5833333335,179227,0,114,0.8598948447760552,35083526,4489871114,236183,236183,412969,649152,326455635.68334115,3493005.6499998346,181119,0,114,0.30891840431825063,3868213979,-6998,-6998,45839694.866659105,-17865.06666650111,-1892,0,0,0.5509764404578046,-3833130453,1624.4314878809705,1382.2147897322886,242.21669814868187,0.7820188930340118,0.7668587493596067,-1892
865,2019-05-16,2019,228001,228001,372889412.4166663,3543949.7500000033,181884,0,112,0.8747461633940198,35613844,4495605390,239270,239270,419486,658756,326782851.28334236,3602211.8999998523,185889,0,113,0.31247836831847936,3861803747,-11269,-11269,46106561.13332397,-58262.14999984903,-4005,0,-1,0.5622677950755404,-3826189903,1635.4727058945632,1365.749368008285,269.72333788627816,0.7977333432748102,0.7769005725749154,-4005
866,2019-05-17,2019,223615,223615,373302742.73333305,3491418.333333332,179680,0,55,0.8763231446906518,35091500,4501899696,235056,235056,430025,665081,324912029.3833388,3558091.899999844,183424,0,52,0.30230002059899924,3828860847,-11441,-11441,48390713.34999424,-66673.56666651182,-3744,0,3,0.5740231240916525,-3793769347,1669.3993816753484,1382.2749871662022,287.1243945091462,0.8035239138698209,0.7803417058062759,-3744
867,2019-05-18,2019,222203,222203,373352973.9166661,3470168.333333334,178858,0,64,0.8724814696471244,35550133,4504723483,230066,230066,441825,671891,323221198.9833468,3484143.6833331613,181403,0,64,0.29426945739710175,3811735977,-7863,-7863,50131774.93331927,-13975.349999827333,-2545,0,0,0.5782120122500226,-3776185844,1680.2337228420233,1404.9064137393045,275.3273091027188,0.8049306264991922,0.7884824354750376,-2545
868,2019-05-19,2019,221823,221823,373694230.0833335,3437489.56666667,177707,0,116,0.8699864306226136,35021798,4510785433,222468,222468,451391,673859,321957580.9666786,3431849.3666665745,178271,0,116,0.28864792189463734,3801043946,-645,-645,51736649.11665487,5640.200000095647,-564,0,0,0.5813385087279763,-3766022148,1684.6505100162449,1447.2085017471215,237.44200826912333,0.801120713361554,0.8013332254526494,-564
869,2019-05-20,2019,225369,225369,374370171.3999996,3483146.3833333356,178325,0,104,0.8601537922251956,35589937,4522044219,226026,226026,458408,684434,322779844.53333914,3477843.3166665453,178873,0,105,0.2857894260074766,3809734407,-657,-657,51590326.866660476,5303.066666790284,-548,0,-1,0.574364366217719,-3774144470,1661.1431536724199,1428.0651099136344,233.0780437587855,0.7912578926116725,0.7913824073336696,-548
870,2019-05-21,2019,234670,234670,375214569.34999985,3601193.6833333317,183638,0,110,0.8539864490561215,35875725,4529789091,235657,235657,460786,696443,323821533.0833436,3595127.0833332054,184356,0,110,0.289888763330229,3817296571,-987,-987,51393036.26665622,6066.600000126287,-718,0,0,0.5640976857258926,-3781420846,1598.9030099714487,1374.1222755247823,224.78073444666643,0.7825371798696041,0.7823064878191609,-718
871,2019-05-22,2019,239622,239622,375956270.99999976,3638824.3333333344,187353,0,175,0.8571792239443791,35372846,4535190629,240579,240579,466481,707060,324778741.58333015,3632660.783333254,188074,0,175,0.292747433032559,3824494081,-957,-957,51177529.41666961,6163.550000080373,-721,0,0,0.56443179091182,-3789121235,1568.9555675188412,1349.9879107624945,218.96765675634674,0.7818689435861482,0.7817556810860465,-721
872,2019-05-23,2019,238960,238960,376599963.96666694,3629904.1666666665,186468,0,131,0.8518413123535313,36071571,4540557348,239890,239890,476079,715969,325766643.80000484,3622891.5333327143,187142,0,133,0.2863741307235333,3834924923,-930,-930,50833320.1666621,7012.633333952166,-674,0,-2,0.5654671816299981,-3798853352,1575.9958317989076,1357.9834249031007,218.01240689580686,0.7803314362236358,0.7801158864479553,-674
873,2019-05-24,2019,237138,237138,377185374.6833327,3607404.149999996,186496,0,76,0.8564970607831724,36210281,4546202045,237969,237969,488085,726054,326501013.86666286,3600224.2666665763,187181,0,76,0.28210160676754215,3843499998,-831,-831,50684360.81666982,7179.883333419915,-685,0,0,0.5743954540156303,-3807289717,1590.573314624112,1372.0317094523357,218.54160517177638,0.786445023572772,0.7865772432543735,-685
874,2019-05-25,2019,232053,232053,377083352.1500003,3571396.166666666,182746,0,93,0.8538997556592678,35382398,4547043912,232826,232826,499968,732794,326687061.84999424,3564733.683333263,183368,0,93,0.2724558334265835,3852465066,-773,-773,50396290.30000603,6662.483333403245,-622,0,0,0.5814439222326843,-3817082668,1624.9880507901223,1403.1382313401177,221.8498194500046,0.7875183686485415,0.787575270803089,-622
875,2019-05-26,2019,219501,219501,376771150.7000005,3448219.333333331,175981,0,58,0.8697181334025816,36043495,4547573557,220221,220221,512740,732961,326610635.15000683,3443083.616666127,176464,0,58,0.26308903202214773,3866915012,-720,-720,50160515.549993694,5135.716667204164,-483,0,0,0.6066291013804339,-3830871517,1716.489449706382,1483.1039508039962,233.38549890238573,0.8017321105598608,0.8013041444730521,-483
876,2019-05-27,2019,221382,221382,377183989.2500004,3485495.3666666686,179105,0,177,0.8766882583046508,34714980,4555020263,221983,221983,524844,746827,327200157.8166596,3480639.9499999178,179635,0,178,0.2621919132543433,3879873411,-601,-601,49983831.43334079,4855.416666750796,-530,0,-1,0.6144963450503075,-3845158431,1703.76990563822,1473.9874576731536,229.78244796506647,0.809031447904527,0.809228634625174,-530
877,2019-05-28,2019,232229,232229,377805063.81666684,3559851.2166666663,182521,0,69,0.8679665330342041,35728325,4560827443,233112,233112,526868,759980,328056359.0833398,3553641.4999994976,183301,0,58,0.271259769993958,3881558187,-883,-883,49748704.73332703,6209.716667168774,-780,0,11,0.5967067630402461,-3845829862,1626.8642754206703,1407.2907404309508,219.57353498971952,0.7859526587979968,0.7863215964858093,-780
878,2019-05-29,2019,232395,232395,378101586.74999994,3543034.0166666717,183596,0,103,0.8597861399771933,35161313,4562682701,233167,233167,533239,766406,328535295.3500063,3535886.1999995755,184259,0,103,0.2635300349945212,3888563484,-772,-772,49566291.39999366,7147.816667096224,-663,0,0,0.5962561049826721,-3853402171,1626.9781481959592,1409.0128335056258,217.96531469033334,0.7900169969233417,0.7902447601933378,-663
879,2019-05-30,2019,227765,227765,377021505.29999995,3514664.9333333336,183318,0,251,0.8708888547406317,34994332,4550629061,233990,233990,544637,778627,327675205.4833266,3512512.766666595,185602,0,251,0.2587837308492984,3895411690,-6225,-6225,49346299.81667334,2152.166666738689,-2284,0,0,0.6121051238913333,-3860417358,1655.3092235418083,1400.3812363063662,254.92798723544206,0.8048558821592431,0.7932048378135818,-2284
880,2019-05-31,2019,235012,235012,377202677.58333325,3554996.883333331,187690,0,305,0.8793721171684843,35341640,4550906446,245048,245048,548521,793569,325720485.08333915,3552384.966666147,192480,0,305,0.2700332296246475,3858227248,-10036,-10036,51482192.4999941,2611.916667183861,-4790,0,0,0.6093388875438368,-3822885608,1605.035817674558,1329.2109508477488,275.8248668268093,0.7986400694432625,0.7854787633443244,-4790
881,2019-06-01,2019,236196,236196,377273743.5999998,3560196.7166666607,186700,0,71,0.8624447492760262,36243308,4553290689,236913,236913,269322,506235,323044984.4166678,3553019.066666379,187491,0,75,0.4082945667525938,3766822702,-717,-717,54228759.18333197,7177.650000281632,-791,0,-4,0.4541501825234324,-3730579394,1597.2909939203025,1363.559553155242,233.7314407650606,0.7904452234584837,0.7913917767281661,-791
882,2019-06-02,2019,232943,232943,377335818.36666685,3531151.0666666697,183747,0,80,0.868697492519629,36671319,4556899536,233890,233890,279173,513063,323247577.0666734,3524629.199999838,184602,0,79,0.40568702089217223,3772354888,-947,-947,54088241.299993455,6521.866666831542,-855,0,1,0.4630104716274568,-3735683569,1619.8633071895995,1382.0495834224353,237.81372376716422,0.7888067037859047,0.7892684595322588,-855
883,2019-06-03,2019,227461,227461,377421407.8166659,3501567.416666669,179630,0,67,0.8646713062898701,35365334,4560554273,228505,228505,295213,523718,323564338.2500026,3496539.216666424,180556,0,54,0.3862593991422874,3782496463,-1044,-1044,53857069.566663265,5028.200000244658,-926,0,13,0.4784119071475827,-3747131129,1659.2796471336444,1416.0055064440717,243.27414068957273,0.7897177977763221,0.7901621408721909,-926
884,2019-06-04,2019,228632,228632,377626450.99999976,3497591.3999999985,180896,0,71,0.8635930228489452,34669994,4564463048,229704,229704,301856,531560,323974847.133339,3493004.6333331275,181680,0,62,0.3776845511325125,3785936058,-1072,-1072,53651603.866660774,4586.76666687103,-784,0,9,0.48590847171643275,-3751266064,1651.6780284474603,1410.4014171862004,241.27661126125986,0.7912103292627454,0.7909309372061436,-784
885,2019-06-05,2019,228406,228406,377940943.7166663,3501519.566666662,181336,0,141,0.8661681391907409,34492537,4570022374,229893,229893,311121,541014,324373535.20000803,3497194.4833330815,182433,0,141,0.37348756224422486,3792856311,-1487,-1487,53567408.51665825,4325.083333580755,-1097,0,0,0.492680576946516,-3758363774,1654.6892100762077,1410.9761288947816,243.7130811814261,0.7939195993100007,0.7935561326356174,-1097
886,2019-06-06,2019,223358,223358,378182795.81666607,3461276.8499999964,180046,0,197,0.8908299680333813,34421726,4571879351,225122,225122,321237,546359,324718282.7500062,3458964.0166664757,181148,0,198,0.3814451670055731,3796366081,-1764,-1764,53464513.06665987,2312.8333335206844,-1102,0,-1,0.5093848010278081,-3761944355,1693.1687954613942,1442.4102608807943,250.75853458059987,0.8060870888886899,0.8046659144819254,-1102
887,2019-06-07,2019,223967,223967,378369678.7999998,3484438.5166666694,180746,0,185,0.8778837953805694,33764219,4573508737,224738,224738,331929,556667,324896562.76667315,3481051.8499997896,181297,0,185,0.35709679215760975,3801797650,-771,-771,53473116.033326626,3386.6666668797843,-551,0,0,0.5207870032229596,-3768033431,1689.3992364946612,1445.6681236224988,243.73111287216238,0.8070206771533306,0.8067038062098978,-551
888,2019-06-08,2019,226958,226958,378609457.03333277,3516237.0333333323,181302,0,218,0.870072876919958,35015772,4577110664,227679,227679,338839,566518,325292246.1666779,3511125.6666665487,181860,0,218,0.3537504545310078,3808598502,-721,-721,53317210.86665487,5111.366666783579,-558,0,0,0.5163224223889502,-3773582730,1668.1917228444593,1428.731882021082,239.45984082337736,0.7988350267450365,0.7987561435178475,-558
889,2019-06-09,2019,232378,232378,378707817.9333336,3512292.4499999965,183086,0,193,0.8523956656826385,35394488,4578835435,233367,233367,348180,581547,325583208.1666746,3506010.9333331496,183736,0,193,0.3441321165787168,3820898174,-989,-989,53124609.76665896,6281.5166668468155,-650,0,0,0.5082635491039217,-3785503686,1629.705987371152,1395.1553054488193,234.55068192233284,0.7878800919192006,0.787326400047993,-650
890,2019-06-10,2019,231271,231271,375888764.03333366,3515885.1666666665,180406,0,193,0.8467036506955042,34295091,4542696202,233155,233155,359521,592676,322482588.4000058,3506899.1999999527,181473,0,194,0.33536535982560595,3786576575,-1884,-1884,53406175.63332784,8985.966666713823,-1067,0,-1,0.5113382908698982,-3752281484,1625.3173291650646,1383.1253389376416,242.19199022742305,0.7800632158809362,0.7783362998863417,-1067
891,2019-06-11,2019,230005,230005,372743258.26666695,3501599.4499999955,174728,0,190,0.8209778048303298,33791589,4497039857,231997,231997,368040,600037,319373070.18334246,3493937.0333332606,175891,0,190,0.3184453625359708,3744983075,-1992,-1992,53370188.08332449,7662.416666734964,-1163,0,0,0.502532442294359,-3711191486,1620.5876318630767,1376.6258623315925,243.96176953148415,0.7596704419469142,0.7581606658706793,-1163
892,2019-06-12,2019,226317,226317,368627072.0666668,3504832.933333334,174083,0,75,0.833949725385189,33864480,4447210505,227157,227157,378174,605331,316482870.76667076,3500270.766666567,174740,0,79,0.31435198263429737,3706731839,-840,-840,52144201.29999602,4562.166666767094,-657,0,-4,0.5195977427508915,-3672867359,1628.8085829463398,1393.23406615984,235.57451678649977,0.769199839163651,0.7692477009293132,-657
893,2019-06-13,2019,227314,227314,368839794.4166668,3517799.6999999946,175491,0,57,0.837942229691088,34929650,4446642556,228026,228026,382797,610823,316925549.8000121,3511759.3333331784,176093,0,58,0.3144413357060892,3715041039,-712,-712,51914244.616654694,6040.366666816175,-602,0,-1,0.5235008939849988,-3680111389,1622.600431195029,1389.8658477542565,232.73458344077244,0.7720202011314745,0.772249655741012,-602
894,2019-06-14,2019,230384,230384,369417970.5500002,3530682.0499999966,178516,0,51,0.8454753802347391,36338896,4455214705,234073,234073,391376,625449,317705725.08334786,3525794.999999859,180226,0,44,0.316750046766403,3721036979,-3689,-3689,51712245.466652334,4887.0500001376495,-1710,0,7,0.5287253334683362,-3684698083,1603.4879616205994,1357.2933447400933,246.19461688050615,0.7748628376970623,0.769956381128964,-1710
895,2019-06-15,2019,226933,226933,369696975.58333343,3539288.016666671,177095,0,65,0.8487086496895545,36440034,4461958877,227646,227646,400446,628092,317359903.9166813,3534120.233333177,177621,0,66,0.3096568655547314,3713265516,-713,-713,52337071.66665214,5167.783333493862,-526,0,-1,0.5390517841348231,-3676825482,1629.101874047994,1394.093917383487,235.007956664507,0.7803845187786703,0.7802509158957328,-526
896,2019-06-16,2019,227084,227084,370162017.81666696,3513642.299999996,176725,0,46,0.8424944073558689,36918958,4467114675,227749,227749,408461,636210,318014555.9333449,3508746.433332982,177264,0,40,0.30345011867150123,3727377830,-665,-665,52147461.88332206,4895.866667014081,-539,0,6,0.5390442886843676,-3690458872,1630.0664856029794,1396.337880444458,233.7286051585213,0.7782362473798242,0.7783305305402,-539
897,2019-06-17,2019,233633,233633,371159877.1166664,3577260.116666664,180225,0,49,0.840086802806111,37129155,4480828532,234614,234614,418739,653353,319120083.9166762,3572587.7666665083,180949,0,41,0.30377452923610654,3741378803,-981,-981,52039793.19999015,4672.350000155624,-724,0,8,0.5363122735700045,-3704249648,1588.6449136751503,1360.1919915975868,228.45292207756347,0.7714021563734575,0.7712625845004987,-724
898,2019-06-18,2019,226147,226147,371405714.116667,3535984.38333333,176721,0,49,0.8455871623324651,35997899,4484613980,231773,231773,425846,657619,319588639.6666769,3532224.1166665293,179190,0,41,0.2963053074804745,3745736743,-5626,-5626,51817074.44999009,3760.266666800715,-2469,0,8,0.5492818548519907,-3709738844,1642.3198809476446,1378.8864089720412,263.4334719756034,0.7814430436839754,0.7731271545865999,-2469
899,2019-06-19,2019,228109,228109,372064818.8833333,3560352.0999999987,178015,0,121,0.8443331915882314,36292423,4490770702,228944,228944,434721,663665,319111445.66667306,3555094.5166665493,178667,0,121,0.2932247444117133,3731534350,-835,-835,52953373.21666026,5257.583333449438,-652,0,0,0.5511084471765181,-3695241927,1631.083468356502,1393.840614589913,237.24285376658895,0.780394460542986,0.7803960793905933,-652
900,2019-06-20,2019,229655,229655,372701348.95000017,3550756.3833333305,178748,0,171,0.8439746576386321,36253821,4499401697,230555,230555,441549,672104,319814101.81667495,3545271.0666665253,179369,0,171,0.29193398640686746,3743045480,-900,-900,52887247.13332522,5485.316666805185,-621,0,0,0.5520406712317647,-3706791659,1622.8749600487695,1387.1488443827934,235.72611566597607,0.7783327164660033,0.7779878987660211,-621
901,2019-06-21,2019,227675,227675,373246468.75000006,3530384.7166666696,178138,0,51,0.8429647523882741,35743297,4506778936,228667,228667,451870,680537,320640055.4500144,3529093.3999998663,178742,0,52,0.2843974684697511,3752794884,-992,-992,52606413.29998565,1291.3166668033227,-604,0,-1,0.558567283918523,-3717051587,1639.3827550236085,1402.2139418893605,237.168813134248,0.7824223125068629,0.7816694144760722,-604
902,2019-06-22,2019,228056,228056,373410139.31666666,3547187.699999999,178489,0,41,0.843275335882415,35444054,4508124375,228810,228810,461367,690177,321027527.6333462,3542436.14999987,179122,0,37,0.2817813401489783,3764107317,-754,-754,52382611.68332046,4751.550000128802,-633,0,4,0.5614939957334366,-3728663263,1637.3616099408332,1403.0310197690058,234.33059017182745,0.7826542603571053,0.7828416590183995,-633
903,2019-06-23,2019,232556,232556,374035877.6833339,3554913.6333333347,181097,0,37,0.8402234300555564,36197854,4517035902,233310,233310,468296,701606,321778296.7500144,3548616.266666534,181740,0,36,0.2808556369244311,3776969295,-754,-754,52257580.93331945,6297.366666800808,-643,0,1,0.5593677931311254,-3740771441,1608.3690710337892,1379.1877619905465,229.18130904324266,0.7787242642632313,0.778963610646779,-643
904,2019-06-24,2019,234139,234139,374735706.1333329,3586973.1499999934,180356,0,36,0.8359991287226828,36300414,4525400124,235226,235226,479363,714589,322628833.76666725,3579915.999999549,181302,0,32,0.27742240644621946,3788363916,-1087,-1087,52106872.36666566,7057.150000444613,-946,0,4,0.5585767222764633,-3752063502,1600.4839267842303,1371.5696129112737,228.91431387295665,0.7702945686109534,0.7707566340455562,-946
905,2019-06-25,2019,234391,234391,374967742.2666671,3620773.8833333356,180647,0,42,0.8334620356583654,36215404,4525451081,235608,235608,484000,719608,323033503.55000764,3613445.566666159,181497,0,42,0.2743771608987122,3793789618,-1217,-1217,51934238.71665949,7328.316667176783,-850,0,0,0.5590848747596532,-3757574214,1599.7531571889156,1371.0633915232404,228.68976566567517,0.7707079196726837,0.7703346236121015,-850
906,2019-06-26,2019,226404,226404,375198485.2333336,3570968.9333333317,178580,0,36,0.8480503878023358,35387700,4529192945,227247,227247,493992,721239,323501160.00001055,3565221.7499994403,179171,0,34,0.2679527868016127,3801057126,-843,-843,51697325.23332304,5747.183333891444,-591,0,2,0.580097601000723,-3765669426,1657.2078462983586,1423.5662516997388,233.6415945986198,0.7887669829154962,0.7884416515949606,-591
907,2019-06-27,2019,229748,229748,375393837.2000001,3571931.6333333314,178947,0,40,0.8410736981388307,35223192,4531782581,235879,235879,501346,737225,323948112.9000001,3579006.8833332406,180789,0,35,0.26630133270033113,3811012046,-6131,-6131,51445724.30000001,-7075.249999909196,-1842,0,5,0.5747723654384995,-3775788854,1633.9373452652476,1373.3656361948292,260.57170907041836,0.7788838205338022,0.7664480517553491,-1842
908,2019-06-28,2019,234731,234731,376146309.7666673,3590100.4333333317,182628,0,43,0.8441918621741493,35992700,4539725654,239495,239495,510903,750398,324434789.38333106,3584492.499999921,183951,0,43,0.26764330395337144,3815070526,-4764,-4764,51711520.383336246,5607.9333334108815,-1323,0,0,0.5765485582207779,-3779077826,1602.4568964758269,1354.6620571758535,247.79483929997332,0.7780310227451849,0.7680786655253763,-1323
909,2019-06-29,2019,232611,232611,376067748.3666665,3585286.2833333323,181714,0,35,0.8433436079979016,36430455,4540375637,239666,239666,520209,759875,323821906.2666641,3595869.51666615,185682,0,35,0.26448034216154676,3809707664,-7055,-7055,52245842.10000241,-10583.233332817908,-3968,0,0,0.5788632658363548,-3773277209,1616.7238366485958,1351.138276879758,265.5855597688378,0.7811926349140841,0.7747531982008294,-3968
910,2019-06-30,2019,228425,228425,376122369.96666616,3544138.4333333317,180049,0,37,0.8500120389624598,34903944,4543225383,229127,229127,528436,757563,320922554.48332846,3540217.2499999683,180572,0,33,0.2587269969626296,3749104645,-702,-702,55199815.4833377,3921.183333363384,-523,0,4,0.5912850419998302,-3714200701,1646.5902154609441,1400.631765280078,245.95845018086607,0.7882193280070044,0.7880869561422268,-523
911,2019-07-01,2019,227395,227395,376406925.5333336,3553451.983333332,178221,0,36,0.8419886101277507,34416541,4548881710,228018,228018,268307,496325,321324396.7666633,3549562.4666663557,178755,0,36,0.3877902583992326,3725077559,-623,-623,55082528.76667029,3889.5166669762693,-534,0,0,0.45419835172851813,-3690661018,1655.2999209891757,1409.2062765512517,246.093644437924,0.7837507421007498,0.7839512670052364,-534
912,2019-07-02,2019,225518,225518,376624015.4833336,3538507.533333333,177154,0,38,0.839454056882377,34820217,4552041704,225978,225978,276676,502654,321743157.08333385,3533985.899999682,177543,0,38,0.37842929728998387,3729382635,-460,-460,54880858.39999974,4521.633333651349,-389,0,0,0.4610247595923931,-3694562418,1670.0397107252352,1423.78088611871,246.2588246065252,0.7855426174407364,0.7856649762366248,-389
913,2019-07-03,2019,229282,229282,376925838.7833336,3563252.0500000063,178394,0,32,0.8315349656754568,35397920,4557352668,230082,230082,286277,516359,322270274.4499999,3558111.199999717,178985,0,28,0.37166196386622685,3737864883,-800,-800,54655564.33333367,5140.850000289269,-591,0,4,0.45987300180922996,-3702466963,1643.9399463688105,1400.6757349553634,243.26421141344713,0.7780549716070166,0.7779183073860624,-591
914,2019-07-04,2019,227498,227498,377087545.73333323,3564117.783333331,178849,0,34,0.8444425885062727,35416517,4558560116,228344,228344,296472,524816,322745620.5833361,3559402.933333042,179498,0,32,0.3696209719215879,3748321970,-846,-846,54341925.149997115,4714.850000288803,-649,0,2,0.47482161658468486,-3712905453,1657.5422453530723,1413.4184414012898,244.12380395178252,0.7861563618141698,0.7860859054759486,-649
915,2019-07-05,2019,230426,230426,377871022.2166665,3580981.833333332,182072,0,33,0.8469052971452882,36122892,4568676581,231212,231212,304332,535544,323710719.8000051,3575809.483333086,182638,0,33,0.3667467098875172,3759451165,-786,-786,54160302.41666144,5172.350000245962,-566,0,0,0.480158587257771,-3723328273,1639.8801446740667,1400.0602036226712,239.81994105139552,0.7901538888840669,0.7899157483175614,-566
916,2019-07-06,2019,225998,225998,378142827.81666684,3536964.216666672,178421,0,26,0.843047283604279,35164378,4574901515,233153,233153,315587,548740,324151168.10000956,3534080.7833331926,181480,0,26,0.35354448372635444,3769595003,-7155,-7155,53991659.71665728,2883.4333334793337,-3059,0,0,0.4895027998779246,-3734430625,1673.2131603672017,1390.293790343721,282.9193700234807,0.7894804378799812,0.778372999704057,-3059
917,2019-07-07,2019,223939,223939,378132530.3166665,3504624.283333335,176884,0,38,0.8458687410410872,35542053,4577606058,224598,224598,326538,551136,322702396.166679,3500090.6333331326,177343,0,38,0.34575313534227786,3751584936,-659,-659,55430134.14998746,4533.6500002024695,-459,0,0,0.5001156056988094,-3716042883,1688.5514819511852,1436.7999544371678,251.75152751401743,0.7898758143958846,0.7896018664458276,-459
918,2019-07-08,2019,226944,226944,378647463.3999999,3550107.783333336,178177,0,35,0.843965912295545,36536755,4584994205,227651,227651,334754,562405,323393324.7500056,3544939.6833331934,178746,0,35,0.34283656795370027,3763701154,-707,-707,55254138.64999431,5168.1000001425855,-569,0,0,0.5011293443418448,-3727164399,1668.4621025451208,1420.5662384527438,247.895864092377,0.7851143894529047,0.7851755538082416,-569
919,2019-07-09,2019,226924,226924,379031502.55000013,3573839.5833333344,179331,0,32,0.8480063809909931,37409133,4590614139,227785,227785,339424,567209,324060519.3666716,3569166.533333189,179982,0,32,0.34185987881010005,3767989072,-861,-861,54970983.18332851,4673.050000145566,-651,0,0,0.5061465021808931,-3730579939,1670.301521875166,1422.6596104513976,247.6419114237683,0.790268988736317,0.7901398248348223,-651
920,2019-07-10,2019,229501,229501,379432371.71666676,3572827.883333335,180550,0,35,0.8417174652833758,37514957,4597421970,230304,230304,348682,578986,324713966.0333463,3568096.633333172,181168,0,31,0.335643694320767,3779807322,-803,-803,54718405.68332046,4731.250000162981,-618,0,4,0.5060737709626087,-3742292365,1653.2928907354076,1409.9362843604379,243.35660637496972,0.7867068117350251,0.7866472141169932,-618
921,2019-07-11,2019,232791,232791,379624734.2666671,3603708.6333333263,182787,0,35,0.8408830238282408,38151279,4602597818,233673,233673,356550,590223,325121045.28334755,3598719.1166664883,183393,0,35,0.3337196280050094,3793546682,-882,-882,54503688.98331958,4989.516666837968,-606,0,0,0.5071633958232313,-3755395403,1630.7534838832564,1391.3504995585606,239.4029843246958,0.7851978813613928,0.7848275153740484,-606
922,2019-07-12,2019,233363,233363,380083506.35,3604374.550000004,183715,0,29,0.8439212728667357,38674608,4612538738,234125,234125,364923,599048,325711077.10000646,3599215.2166664884,184255,0,28,0.3306730011618482,3801130559,-762,-762,54372429.24999356,5159.333333515562,-540,0,1,0.5132482717048874,-3762455951,1628.7222325304356,1391.1845257875343,237.53770674290126,0.7872499067975643,0.7869941270688735,-540
923,2019-07-13,2019,230106,230106,380170387.9833333,3581508.900000001,181462,0,44,0.8444977532093908,39054705,4620281290,230977,230977,376833,607810,326018702.66667426,3577070.8999998486,182135,0,44,0.32150013984633297,3814558836,-871,-871,54151685.31665903,4438.000000152271,-673,0,0,0.5229976133630578,-3775504131,1652.153303187806,1411.4769118426261,240.6763913451798,0.7886017748342068,0.7885417162747806,-673
924,2019-07-14,2019,230631,230631,380254390.53333396,3564728.91666667,182318,0,42,0.84887547641037,38682896,4627551826,237979,237979,386338,624317,326277438.0333423,3579621.9833331387,184404,0,42,0.3176367134004031,3831819287,-7348,-7348,53976952.499991655,-14893.066666468978,-2086,0,0,0.5312387630099669,-3793136391,1648.756630866336,1371.0345788214183,277.72205204491775,0.7905181870607161,0.774875094020901,-2086
925,2019-07-15,2019,232748,232748,380635294.6166668,3599282.866666663,182478,0,33,0.8434315225050266,38658917,4634232734,244898,244898,396422,641320,326608691.2666637,3632006.3499997975,187115,0,33,0.314212873448517,3836945921,-12150,-12150,54026603.35000312,-32723.483333134558,-4637,0,0,0.5292186490565096,-3798287004,1635.3966290437158,1333.6519337302211,301.74469531349473,0.7840153298846821,0.7640527893245351,-4637
926,2019-07-16,2019,232935,232935,381096384.7666666,3595785.1500000046,182625,0,34,0.8437504024727932,38608040,4643804018,233667,233667,404886,638553,323782647.18334246,3590908.3999998355,183195,0,34,0.30962034474820926,3791703519,-732,-732,57313737.583324134,4876.750000169035,-570,0,0,0.534130057724584,-3753095479,1636.063214058285,1385.6584249523573,250.40478910592765,0.7840170004507695,0.7840003081308016,-570
927,2019-07-17,2019,231579,231579,381204822.2166669,3570598.083333333,181021,0,32,0.8361552645101668,38416219,4650861661,232332,232332,411676,644008,324109252.4666761,3565952.883333217,181600,0,31,0.30221674264916115,3804382996,-753,-753,57095569.74999076,4645.200000116136,-579,0,1,0.5339385218610055,-3765966777,1646.1113581830255,1395.0263091897634,251.08504899326203,0.7816814132542242,0.7816400668009572,-579
928,2019-07-18,2019,230992,230992,381420930.3499996,3571716.266666665,181907,0,31,0.8450725566253382,38799507,4657297055,231906,231906,420949,652855,324574351.5666736,3566234.0333328512,182553,0,31,0.3009565676911396,3817138982,-914,-914,56846578.78332603,5482.233333813958,-646,0,0,0.5441159889341987,-3778339475,1651.23004411408,1399.5944545060222,251.6355896080579,0.7875034633234052,0.7871853250886135,-646
929,2019-07-19,2019,234849,234849,381523920.1499992,3592237.4833333343,184654,0,37,0.8450110496531804,39278686,4662058334,235740,235740,428849,664589,324900225.7333417,3586204.983333154,185345,0,37,0.3005932990163805,3827790962,-891,-891,56623694.41665751,6032.500000180211,-691,0,0,0.5444177506368,-3788512276,1624.5499029163386,1378.2142433755057,246.33565954083292,0.7862669204467552,0.7862263510647324,-691
930,2019-07-20,2019,232410,232410,381412943.35000026,3579118.666666665,182874,0,36,0.8488016866744114,38724567,4662736026,233236,233236,440509,673745,325022097.9333415,3573418.299999822,183585,0,38,0.29521703315052505,3840155387,-826,-826,56390845.41665876,5700.366666843183,-711,0,-2,0.5535846535238863,-3801430820,1641.1210505141787,1393.5331506857497,247.58789982842904,0.7868594294565638,0.7871211991287794,-711
931,2019-07-21,2019,234053,234053,381999381.8666665,3595843.399999996,184475,0,31,0.848239501309533,39016247,4672362590,235083,235083,447726,682809,325816815.7166756,3591401.149999809,185309,0,28,0.29344223640872313,3855265546,-1030,-1030,56182566.149990916,4442.250000187196,-834,0,3,0.5547972649008098,-3816249299,1632.1063257752155,1385.9650239135776,246.14130186163788,0.7881761823176802,0.7882705257292105,-834
932,2019-07-22,2019,235347,235347,383022824.2333327,3645931.6999999955,185695,0,41,0.8508415233676222,42290093,4689254930,236191,236191,455776,691967,327018741.76667774,3640947.549999825,186407,0,41,0.29149511465141864,3871992165,-844,-844,56004082.46665496,4984.150000170339,-712,0,0,0.5593464087162036,-3829702072,1627.4812265859887,1384.5520860942108,242.92914049177784,0.7890264163129337,0.7892214351943978,-712
933,2019-07-23,2019,237014,237014,383589769.81666726,3652533.316666663,186050,0,30,0.8470681056815209,42198944,4699949442,238021,238020,462060,700081,327840560.51666,3646827.116666597,186827,0,28,0.2890251270924367,3888305817,-1007,-1006,55749209.30000728,5706.20000006631,-777,0,2,0.5580429785890841,-3846106873,1618.426632252387,1377.3656017001092,241.06103055227777,0.7849747272313028,0.7849181374752647,-777
934,2019-07-24,2019,240844,240844,384420949.0666664,3668836.616666664,188132,0,33,0.8407973626081614,42339690,4713512822,241840,241840,470585,712425,328919108.649994,3662938.049999907,188957,0,33,0.2865213882163059,3906993515,-996,-996,55501840.41667241,5898.566666756757,-825,0,0,0.5542759743918555,-3864653825,1596.140859089977,1360.0690896873718,236.07176940260524,0.7811363372141303,0.7813306318226927,-825
935,2019-07-25,2019,240413,240413,385206652.88333297,3673928.0166666717,188074,0,32,0.8445841115081134,42336297,4729795967,241235,241235,481429,722664,329951251.33332974,3667823.23333323,188774,0,32,0.28290187417666174,3925089887,-822,-822,55255401.55000323,6104.783333441708,-700,0,0,0.5616822373314516,-3882753590,1602.270479896399,1367.7586226431893,234.51185725320966,0.7822954665513097,0.782531556366199,-700
936,2019-07-26,2019,238151,238151,385896554.48333365,3642900.616666668,187808,0,34,0.8475966928545338,42316821,4742383357,238786,238785,491679,730465,330805046.5666616,3636967.8999998774,188355,0,34,0.2776601206081053,3941400676,-635,-634,55091507.91667205,5932.716666790657,-547,0,0,0.5699365722464285,-3899083855,1620.38603442074,1385.3677851065252,235.01824931421493,0.7886089077937947,0.788802526111246,-547
937,2019-07-27,2019,231346,231346,385771487.39999974,3584137.666666669,181177,0,165,0.8298263207490079,40299115,4750272111,231863,231857,504786,736649,330915547.9666622,3579576.6166666104,181676,0,165,0.2617284486913097,3959244028,-517,-511,54855939.43333751,4561.050000058487,-499,0,0,0.5680978720576981,-3918944913,1667.5087851097478,1427.239841655254,240.26894345449386,0.7831429979338307,0.7835489060350294,-499
938,2019-07-28,2019,227874,227874,385848480.6333336,3550435.9833333353,179677,0,195,0.8376427323871959,40586666,4759292543,228526,228525,515582,744108,331182653.8999981,3545587.14999992,180239,0,195,0.25778516021867304,3979231382,-652,-651,54665826.733335495,4848.833333415445,-562,0,0,0.5798575721685229,-3938644716,1693.2536429488823,1449.2184833169156,244.03515963196674,0.7884927635447659,0.7887023795979451,-562
939,2019-07-29,2019,232883,232883,386479578.5833326,3592425.466666664,183820,0,90,0.8416715689852843,41323517,4773841194,236896,236896,524591,761487,332015389.5666798,3589211.0333329067,184859,0,93,0.2594463201604297,3995812188,-4013,-4013,54464189.01665282,3214.4333337573335,-1039,0,-3,0.5822252488248546,-3954488671,1659.5439709353307,1401.5238314141218,258.0201395212089,0.7893233941507108,0.7803382074834526,-1039
940,2019-07-30,2019,230820,230820,387156439.0833337,3601339.7166666617,182428,0,35,0.8490425439736582,40790570,4786635232,234513,234513,531264,765777,332837472.8166622,3600904.816666601,183658,0,33,0.2586079237166958,4005287885,-3693,-3693,54318966.26667148,434.90000006044284,-1230,0,2,0.5904346202569624,-3964497315,1677.3088947376036,1419.2708839879333,258.0380107496703,0.7903474568928169,0.7831463500957303,-1230
941,2019-07-31,2019,233652,233652,387477360.44999945,3624725.2499999995,183723,0,38,0.8437248557684076,41310825,4796957275,234632,234631,540744,775376,333270933.5499947,3619470.549999914,184564,0,36,0.2563852892016281,4016289771,-980,-979,54206426.900004745,5254.700000085402,-841,0,2,0.5873395665667795,-3974978946,1658.3524234759361,1420.404522633389,237.94790084254714,0.7863104103538596,0.7866105220089331,-841
942,2019-08-01,2019,244103,244103,387762506.3333329,3703836.300000002,191713,0,41,0.844209206769273,41287125,4804425040,245022,245022,274412,519434,333720549.5166826,3697948.916666476,192517,0,41,0.3993481366256333,4001042742,-919,-919,54041956.81665027,5887.383333526086,-804,0,0,0.44486107014363974,-3959755617,1588.5200359411106,1362.00238964943,226.51764629168065,0.7853774840948288,0.7857131196382365,-804
943,2019-08-02,2019,243517,243517,388069926.7666669,3697472.950000001,190742,0,34,0.8411527737283239,41238245,4813288400,244517,244517,285937,530454,334225619.48334193,3692597.4833331797,191484,0,34,0.3887311623628104,4013179051,-1000,-1000,53844307.28332496,4875.46666682139,-742,0,0,0.45242161136551345,-3971940806,1593.605073841526,1366.8809100526423,226.72416378888374,0.7832800174115154,0.7831111947226573,-742
944,2019-08-03,2019,242494,242494,388340109.016667,3694883.9166666684,189988,0,53,0.8427260055918913,41666084,4822595135,251426,251426,299266,550692,334766521.79999936,3726266.483333115,193551,0,53,0.3786998903198205,4028842066,-8932,-8932,53573587.21666765,-31382.566666446626,-3563,0,0,0.46402611527207077,-3987175982,1601.442134719486,1331.4713744799637,269.9707602395222,0.7834750550529085,0.7698129867237279,-3563
945,2019-08-04,2019,239024,239024,388735861.633333,3656103.749999995,187709,0,31,0.8468354642211666,40976440,4831636876,239942,239942,317942,557884,334478169.366682,3650831.9333331385,188476,0,31,0.3654343913788531,4033721813,-918,-918,54257692.266651034,5271.816666856408,-767,0,0,0.48140107284231354,-3992745373,1626.3465661746645,1393.9959213755074,232.35064479915718,0.7853144454113394,0.7855064974035392,-767
946,2019-08-05,2019,238995,238995,389247598.466667,3661000.6000000015,186936,0,33,0.8446327329023617,40400065,4840107758,239748,239748,324477,564225,335063697.3166752,3656191.9166664626,187574,0,33,0.3598493508795263,4046206275,-753,-753,54183901.14999181,4808.683333538938,-638,0,0,0.48478338202283544,-4005806210,1628.685112519789,1397.5661833119575,231.11892920783157,0.7821753593171406,0.7823798321570983,-638
947,2019-08-06,2019,240058,240058,389366502.20000017,3666631.4833333343,187047,0,110,0.8401053078839287,40386234,4846469342,240709,240709,331796,572505,335355986.3000112,3659458.6333331624,187593,0,110,0.3541401385140733,4053815396,-651,-651,54010515.89998895,7172.850000171922,-546,0,0,0.4859651693698554,-4013429162,1621.968450124554,1393.2008620367797,228.76758808777436,0.7791741995684376,0.7793352138889696,-546
948,2019-08-07,2019,244871,244871,389734498.7499998,3686083.316666664,191773,0,131,0.8457841067337504,41809924,4855011229,249821,249821,342559,592380,335963966.01668024,3686945.3666665563,193300,0,134,0.3535838482055392,4068663888,-4950,-4950,53770532.73331958,-862.049999892246,-1527,0,-3,0.4922002585282112,-4026853964,1591.5910775469526,1344.818754294796,246.77232325215664,0.7831592961191811,0.7737540078696347,-1527
949,2019-08-08,2019,242402,242402,389702050.1500001,3696295.800000001,189603,0,139,0.8448898936477427,42005660,4863994932,253496,253496,354125,607621,335875989.6833382,3706443.1499997946,193260,0,140,0.34397264084025747,4082564804,-11094,-11094,53826060.46666187,-10147.34999979334,-3657,0,-1,0.5009172528074852,-4040559144,1607.6684604499967,1324.9755013228541,282.69295912714256,0.7821841403948813,0.7623788935525609,-3657
950,2019-08-09,2019,238647,238647,389723799.6333333,3608526.066666665,185760,0,150,0.842135036266955,41898693,4871271207,239388,239387,372612,612000,332658333.0833514,3602331.93333317,186419,0,150,0.33128104575163564,4032967161,-741,-740,57065466.54998195,6194.133333494887,-659,0,0,0.5108539905153193,-3991068468,1633.0555156081298,1389.6257235495302,243.42979205859956,0.7783881632704371,0.7787315989105552,-659
951,2019-08-10,2019,221350,221350,388173501.3000002,3500426.6166666644,175505,0,160,0.8594849785407719,40963350,4864505314,222087,222087,391610,613697,331420855.0833413,3494234.2499998105,176192,0,160,0.31317572026586044,4039675274,-737,-737,56752646.21665889,6192.366666853894,-687,0,0,0.5463092582749114,-3998711924,1753.6638866049252,1492.3019135894551,261.3619730154701,0.7928845719448837,0.7933467514982867,-687
952,2019-08-11,2019,228641,228641,387671255.96666676,3514611.8833333333,180212,0,160,0.85381449521302,40539268,4869387138,229444,229444,398980,628424,331123884.55001056,3509697.8166664755,180901,0,160,0.3129336244319089,4055164315,-803,-803,56547371.416656196,4914.066666857805,-689,0,0,0.540880870781111,-4014625047,1695.545663142948,1443.157740232957,252.38792290999095,0.78818759540065,0.7884320357037011,-689
953,2019-08-12,2019,239208,239208,388162371.6666665,3631808.399999999,185337,0,128,0.8420704993144038,41844999,4881353239,240753,240753,402973,643726,331803521.6333456,3627546.7999998797,186547,0,128,0.3161127560483863,4064244933,-1545,-1545,56358850.033320904,4261.600000119302,-1210,0,0,0.5259577432660175,-4022399934,1622.6981190707104,1378.1906004633197,244.5075186073907,0.7747943212601586,0.7748480808131155,-1210
954,2019-08-13,2019,240739,240739,388614396.53333306,3654472.41666667,185723,0,115,0.8354815796360365,41275429,4887896071,245814,245814,405935,651749,332529751.91668344,3652443.3499998813,188247,0,115,0.3141408732502885,4067594459,-5075,-5075,56084644.61664963,2029.0666667884216,-2524,0,0,0.521340706385748,-4026319030,1614.2560886824863,1352.7697849458673,261.486303736619,0.7714703475548208,0.7658107349459348,-2524
955,2019-08-14,2019,237967,237967,389028169.4166668,3625037.216666666,184796,0,143,0.8409401303542092,40775456,4896956744,259951,259950,419765,679716,333043867.4333279,3641028.2166666123,192439,0,143,0.3066972088342799,4072224364,-21984,-21983,55984301.98333889,-15990.999999946449,-7643,0,0,0.5342429215199294,-4031448908,1634.798814191324,1281.1843332691976,353.6144809221264,0.7765614560002017,0.7402895161011114,-7643
956,2019-08-15,2019,238121,238121,389237065.45000046,3632345.5499999924,186312,0,117,0.8470189525493346,41247772,4906123231,245145,245145,430452,675597,329162867.81668174,3627479.966666504,188946,0,117,0.30408068715521136,3995912771,-7024,-7024,60074197.63331872,4865.583333488554,-2634,0,0,0.5429382653941233,-3954664999,1634.6188091348536,1342.7272341539976,291.8915749808559,0.782425741534766,0.7707520039160497,-2634
957,2019-08-16,2019,253241,253241,390047264.00000006,3795860.033333333,196879,0,120,0.8477576695716726,42858621,4917511598,254462,254462,435470,689932,329730057.38332653,3789885.8499999037,197871,0,120,0.31398166775856207,3999627424,-1221,-1221,60317206.61667353,5974.183333429508,-992,0,0,0.5337760018131106,-3956768803,1540.2216228809714,1295.7929175410338,244.42870533993755,0.7774373028064177,0.7776053005949808,-992
958,2019-08-17,2019,248593,248593,390700065.4833332,3793965.8333333344,192257,0,134,0.8446818695618937,42300223,4930089243,249785,249785,443733,693518,330570751.3166792,3787874.083332869,193299,0,134,0.30603243174653744,4016716239,-1192,-1192,60129314.16665399,6091.750000465196,-1042,0,0,0.5386494378153563,-3974416016,1571.6454827100247,1323.4211474535268,248.22433525649785,0.7733805859376571,0.7738615209079809,-1042
959,2019-08-18,2019,245843,245843,391649626.38333344,3758555.8666666653,190682,0,156,0.8454867537412095,42221036,4945334940,246838,246838,454453,701291,331616361.6833439,3752793.633332817,191624,0,156,0.2992067486963331,4034549044,-995,-995,60033264.69998956,5762.233333848417,-942,0,0,0.5462800050448764,-3992328008,1593.0883791010256,1343.4574971574227,249.63088194360284,0.7756250940640979,0.7763148299694537,-942
960,2019-08-19,2019,248174,248174,392222847.6833332,3786972.9333333387,192085,0,109,0.8495370183822644,41817937,4955251275,249294,249294,465124,714418,332501840.31666136,3780536.8999999613,193066,0,110,0.2982959555890206,4052707585,-1120,-1120,59721007.36667186,6436.033333377447,-981,0,-1,0.5512410627932438,-4010889648,1580.4348871490697,1333.7739388700143,246.66094827905545,0.7739932466737047,0.774451049764535,-981
961,2019-08-20,2019,248258,248258,392759196.59999967,3780748.583333336,192399,0,95,0.8460472572887884,40690727,4962630853,249342,249342,472490,721832,333385192.8833286,3775028.5666666143,193202,0,95,0.29328015383080636,4061891899,-1084,-1084,59374003.71667105,5720.016666721553,-803,0,0,0.552767103457982,-4021201172,1582.0605845531652,1337.0599132249224,245.0006713282428,0.7749961733358038,0.7748473983524636,-803
962,2019-08-21,2019,250182,250182,393350742.06666726,3813225.849999999,193257,0,119,0.8410836910728982,41113686,4969792935,251131,251131,480668,731799,334319595.88332826,3807480.5166665595,193998,0,119,0.2899020086116566,4075043534,-949,-949,59031146.183339,5745.333333439659,-741,0,0,0.5511816824612416,-4033929848,1572.2583641775477,1331.2557823738537,241.00258180369406,0.7724656450104324,0.7724972225651154,-741
963,2019-08-22,2019,253129,253129,394065693.36666656,3830795.6833333345,195563,0,112,0.8414958380904598,42411708,4979564867,254236,254236,488984,743220,335365983.4000046,3825300.883332708,196409,0,112,0.28884986948682,4091002819,-1107,-1107,58699709.96666193,5494.800000626594,-846,0,0,0.5526459686036398,-4048591111,1556.7781382878554,1319.112884878635,237.66525340922044,0.7725823591923485,0.7725459808996366,-846
964,2019-08-23,2019,257886,257886,394858819.4166667,3805538.8333333344,198909,0,136,0.833794777537361,42253031,4991504214,259017,259017,499797,758814,336380841.4499959,3799032.899999939,199838,0,138,0.28591591615336737,4108108564,-1131,-1131,58477977.96667081,6505.933333395515,-929,0,-2,0.5478788613839936,-4065855533,1531.1370893211213,1298.682485898593,232.45460342252818,0.7713059258742235,0.771524648961265,-929
965,2019-08-24,2019,250980,250980,394708364.75000036,3769215.166666666,195254,0,122,0.8415252211331575,42515890,5001666139,251955,251955,514970,766925,336455844.23332787,3762249.383333222,196044,0,122,0.2778459432147827,4125813517,-975,-975,58252520.51667249,6965.7833334440365,-790,0,0,0.5636792779183748,-4083297627,1572.6685980954671,1335.3806998604032,237.28789823506395,0.777966371822456,0.7780913258319938,-790
966,2019-08-25,2019,252483,252483,394979635.50000066,3730105.1833333285,196436,0,195,0.8459341817072841,42773847,5011697826,253449,253449,528148,781597,336948969.2999973,3723085.549999897,197295,0,196,0.2758454804713926,4144905825,-966,-966,58030666.200003326,7019.633333431557,-859,0,-1,0.5700887012358915,-4102131978,1564.3811088271316,1329.4547198844632,234.92638894266838,0.7780167377605621,0.7784406330267628,-859
967,2019-08-26,2019,252951,252951,395173448.8833332,3788079.5166666633,195263,0,250,0.8464287549762599,43235196,5022481398,254023,254023,539918,793941,337404003.4999946,3781211.1499999347,196157,0,250,0.272749486422793,4162376555,-1072,-1072,57769445.38333863,6868.366666728631,-894,0,0,0.5736792685534668,-4119141359,1562.2529615749027,1328.24194462704,234.01101694786257,0.7719400200038743,0.7722017297646276,-894
968,2019-08-27,2019,251948,251948,395480936.1166668,3824817.6833333327,195760,0,188,0.8534816708209628,44351760,5030563074,252938,252938,545708,798646,337991131.91666263,3817995.0999999084,196549,0,188,0.2724824265068648,4173227937,-990,-990,57489804.20000416,6822.5833334242925,-789,0,0,0.580999244314098,-4128876177,1569.692698956399,1336.2607908525513,233.43190810384772,0.776985727213552,0.7770639445239544,-789
969,2019-08-28,2019,251398,251398,396272080.3833327,3802608.7500000033,196206,0,158,0.8534753657546993,44369764,5045171614,253386,253386,552766,806152,339023311.7333254,3797249.8666665815,197407,0,159,0.26857093947542865,4188175352,-1988,-1988,57248768.65000731,5358.883333421778,-1201,0,-1,0.5849044262792706,-4143805588,1576.273798452385,1337.9717574503936,238.30204100199148,0.7804596695279994,0.7790761920548097,-1201
970,2019-08-29,2019,244820,244820,396502506.63333356,3745877.9499999997,192231,0,150,0.857675026550119,43734620,5053588075,245909,245909,565115,811024,338866947.38332856,3740273.5333332415,193108,0,150,0.2612401112667392,4189248176,-1089,-1089,57635559.25000501,5604.416666758247,-877,0,0,0.5964349152833798,-4145513556,1619.5674643956113,1378.0176706965933,241.54979369901798,0.7851932031696757,0.7852823605480076,-877
971,2019-08-30,2019,247003,247003,396693235.2333336,3771723.083333335,194958,0,90,0.8587507034327516,43911001,5060647225,248003,248003,575101,823104,339255075.61667377,3765466.9999994966,195725,0,90,0.26006434180856847,4207575569,-1000,-1000,57438159.61665982,6256.083333838265,-767,0,0,0.5986863616241831,-4163664568,1606.025980386204,1367.947466831747,238.078513554457,0.7892940571572005,0.7892041628528688,-767
972,2019-08-31,2019,250427,250427,396515893.20000017,3807406.249999994,196200,0,149,0.8549557356035891,43858849,5060876255,251560,251560,582525,834085,339585273.28332675,3801207.883333259,197223,0,149,0.25946875917921813,4220624833,-1133,-1133,56930619.91667342,6198.36666673515,-1023,0,0,0.5954869764243709,-4176765984,1583.3591952944378,1349.9176072639798,233.44158803045798,0.7834618471650421,0.7839998409922087,-1023
973,2019-09-01,2019,257319,257319,396465212.6166667,3819051.950000004,196908,0,157,0.839184047816135,43667313,5066498497,261557,261557,298409,559966,339755255.6833354,3816540.3499996555,198622,0,159,0.3915594875403169,4205333185,-4238,-4238,56709956.93333125,2511.600000348408,-1714,0,-2,0.4476245602758181,-4161665872,1540.7537438613808,1298.9721387052743,241.78160515610648,0.7652291513646485,0.7593832319532645,-1714
974,2019-09-02,2019,244710,244710,396559179.84999985,3813163.4000000022,189946,0,65,0.8531404519635482,43075231,5073927859,257528,257528,317808,575336,340131988.78333884,3877233.7166664824,195709,0,68,0.3763870155874102,4215356595,-12818,-12818,56427191.066661,-64070.316666480154,-5763,0,-3,0.47675343637613793,-4172281364,1620.5270722487837,1320.7573109849757,299.76976126380805,0.7762085734134282,0.7599523158646827,-5763
975,2019-09-03,2019,244190,244190,396713831.2499998,3790680.716666669,189137,0,74,0.8475531348540073,42303298,5081568589,258376,258375,327987,586363,338044165.86667883,3848978.1999998093,194380,0,74,0.36509636522086486,4180158093,-14186,-14185,58669665.38332099,-58297.483333140146,-5243,0,0,0.48245676963314243,-4137854795,1624.611291412424,1308.3470377036433,316.26425370878064,0.7745485073098817,0.7523144564510635,-5243
976,2019-09-04,2019,248088,248088,396825003.9500001,3838991.416666668,192936,0,84,0.8582277256457381,42971766,5087294765,261414,261414,337427,598841,336045781.1000119,3884009.5499998117,198302,0,84,0.36979765914491236,4149887974,-13326,-13326,60779222.84998822,-45018.13333314378,-5366,0,0,0.48843006650082577,-4106916208,1599.5332460659126,1285.4926710123095,314.0405750536031,0.7776917867853342,0.7585745216400039,-5366
977,2019-09-05,2019,249677,249677,397240657.5333336,3889863.9666666696,193065,0,107,0.8547643555473673,42473007,5093065243,251121,251121,347279,598400,334863814.6500132,3883498.083333139,194271,0,107,0.3645137032085528,4136834761,-1444,-1444,62376842.88332039,6365.883333530743,-1206,0,0,0.4902506523388145,-4094361754,1591.0182256809142,1333.4759524293595,257.54227325155466,0.773259050693496,0.7736151098474441,-1206
978,2019-09-06,2019,251420,251420,397476102.9500001,3860208.2833333276,195525,0,88,0.8568809163948774,42259032,5096761435,252669,252669,349243,601912,335370118.71668446,3853768.83333321,196470,0,89,0.36370765161685015,4147248297,-1249,-1249,62105984.23331565,6439.450000117533,-945,0,-1,0.49317326477802725,-4104989265,1580.9247591679266,1327.310112109853,253.61464705807361,0.7776827619123379,0.7775785711741449,-945
979,2019-09-07,2019,258366,258366,396986831.85000014,3873537.966666668,199660,0,116,0.8491171438966433,41405709,5095876029,267936,267936,361384,629320,335261132.96668565,3883746.0833331365,204095,0,116,0.36026822602173647,4160411431,-9570,-9570,61725698.88331449,-10208.116666468326,-4435,0,0,0.4888489178749068,-4119005722,1536.5289235038672,1251.273188249006,285.2557352548613,0.7727797001153403,0.7617304132330108,-4435
980,2019-09-08,2019,253285,253285,397422741.11666614,3873997.3666666714,194599,0,162,0.837487415362141,42159285,5103668049,254536,254536,373505,628041,334257199.8500125,3868606.2833332056,195605,0,162,0.34151273563349743,4132463871,-1251,-1251,63165541.26665366,5391.083333465736,-1006,0,0,0.49597467972864356,-4090304586,1569.0733407689604,1313.2020612016079,255.87127956735253,0.7683005310223661,0.7684767577081435,-1006
981,2019-09-09,2019,247106,247106,397777929.50000006,3790948.6166666714,190279,0,150,0.8423267747444417,42145511,5113540200,248042,248042,380577,628619,334815754.78334713,3785449.4499998204,191096,0,150,0.3336806555322041,4136367400,-936,-936,62962174.71665293,5499.166666850913,-817,0,0,0.5086461192122376,-4094221889,1609.746139308637,1349.834926275982,259.91121303265504,0.77002986572564,0.7704179130953629,-817
982,2019-09-10,2019,241204,241204,397817677.1166667,3744060.3999999966,186407,0,120,0.8436344339231526,41484794,5120438139,242249,242249,391109,633358,335150080.0500152,3738414.983333125,187235,0,120,0.3241815845067184,4144511061,-1045,-1045,62667597.06665146,5645.416666871868,-828,0,0,0.5194528494164342,-4103026267,1649.2996679850528,1383.4941735570228,265.80549442803,0.7728188587253942,0.772903087319246,-828
983,2019-09-11,2019,244358,244358,398054439.66666615,3726237.916666669,189414,0,60,0.8492171322404027,40987395,5127632023,246292,246291,399757,646049,335615956.6500164,3721479.816666007,190769,0,60,0.32498928099880214,4158227335,-1934,-1933,62438483.01664972,4758.100000661798,-1355,0,0,0.5242278512416005,-4117239940,1628.9805926823192,1362.680555318775,266.3000373635441,0.775149575622652,0.7745643382651487,-1355
984,2019-09-12,2019,239095,239095,398199181.3500004,3674000.4166666656,186055,0,99,0.8475124950333538,41386089,5131845510,240344,240344,408674,649018,336102726.11667776,3668055.116666543,186998,0,99,0.3151638321279186,4173419378,-1249,-1249,62096455.23332262,5945.300000122748,-943,0,0,0.5323486629054353,-4132033289,1665.4433649804487,1398.4236182999275,267.01974668052117,0.7781634914991948,0.778043138168625,-943
985,2019-09-13,2019,235627,235627,398256662.11666673,3642928.56666667,183953,0,110,0.8441604739694513,42132345,5141119377,236777,236777,420348,657125,336427701.3833431,3637547.4833331387,184879,0,110,0.3052509035571621,4189320059,-1150,-1150,61828960.73332363,5381.083333531395,-926,0,0,0.5389095704122892,-4147187714,1690.1996041059247,1420.8630964297338,269.3365076761909,0.7806957606725885,0.7808148595513923,-926
986,2019-09-14,2019,245730,245730,398488360.7833335,3752534.9666666687,190494,0,185,0.8420298701827219,42346021,5149595294,246756,246756,428273,675029,336888667.5333456,3746893.4833331234,191378,0,187,0.3090874614275886,4206259924,-1026,-1026,61599693.2499879,5641.483333545271,-884,0,-2,0.5329424087551333,-4163913903,1621.6512464222255,1365.2704190915138,256.3808273307118,0.7752167012574778,0.7755758725218435,-884
987,2019-09-15,2019,248010,248010,399201761.1166673,3780419.099999999,192708,0,213,0.8471190677795232,43060122,5160976269,248941,248941,430057,678998,337812040.6666779,3774541.3666664846,193529,0,217,0.311641565954535,4222690256,-931,-931,61389720.44998938,5877.733333514538,-821,0,-4,0.5354775018249882,-4179630134,1609.6196166149239,1356.996399414632,252.62321720029195,0.7770170557638805,0.7774091049686472,-821
988,2019-09-16,2019,248501,248501,399687319.9333334,3796316.416666665,193397,0,208,0.8498678073730088,43767386,5171758370,249449,249449,442645,692094,338503604.4999906,3790477.3499998944,194218,0,208,0.3077139810488179,4241225895,-948,-948,61183715.433342814,5839.066666770726,-821,0,0,0.542153826324191,-4197458509,1608.3932053928693,1357.0052575876855,251.38794780518379,0.7782544134631249,0.778588007969565,-821
989,2019-09-17,2019,248407,248407,400025062.3999998,3796396.1500000022,192911,0,224,0.84710575788927,43503813,5178562432,249481,249481,445998,695479,339106869.78332907,3791067.416666517,193797,0,226,0.30500849055111057,4248637384,-1074,-1074,60918192.61667073,5328.733333485201,-886,0,-2,0.5420972673381594,-4205133571,1610.361472905352,1359.2492806399248,251.1121922654272,0.7765924470727475,0.776800638124747,-886
990,2019-09-18,2019,245436,245436,400339715.8499999,3771786.999999997,192569,0,281,0.8555713098322985,43295487,5187312361,246475,246475,458249,704724,339679694.3666849,3766803.9499994153,193403,0,281,0.30010614084379406,4264876446,-1039,-1039,60660021.48331499,4983.05000058189,-834,0,0,0.5554651689885044,-4221580959,1631.1368986212287,1378.1507023701588,252.98619625106994,0.784599651232908,0.7846759306217669,-834
991,2019-09-19,2019,247764,247764,400995314.3666665,3848127.9833333325,193007,0,271,0.8481296717844409,43833182,5198112825,249060,249060,462801,711861,340592828.53332835,3842358.6333332937,193987,0,278,0.29778285367508883,4280466589,-1296,-1296,60402485.83333814,5769.350000038743,-980,0,-7,0.550346818109352,-4236633407,1618.4567345000344,1367.5131636285569,250.9435708714775,0.7789953342697082,0.7788765759254798,-980
992,2019-09-20,2019,254415,254415,401700888.6333339,3900634.5999999973,197469,0,282,0.8450916809150403,44344626,5208217972,255765,255765,468970,724735,341528868.8833245,3894429.9666665476,198536,0,282,0.2991659020193603,4298207547,-1350,-1350,60172019.75000942,6204.633333449718,-1067,0,0,0.54592577889568,-4253862921,1578.919830329713,1335.3229287952788,243.5969015344342,0.7761688579682802,0.7762438175669071,-1067
993,2019-09-21,2019,247313,247313,401522678.6333329,3836686.766666666,192395,0,282,0.8478365472094064,43404269,5211651717,248285,248285,479343,727628,341641014.06665856,3830386.2333332133,193301,0,282,0.29042037964454465,4313013494,-972,-972,59881664.56667435,6300.533333452884,-906,0,0,0.5574161675648617,-4269609225,1623.5405281296694,1376.003439864102,247.5370882655675,0.777941313234646,0.7785448174476911,-906
994,2019-09-22,2019,252843,252843,401622983.01666695,3834185.7,197518,0,273,0.8562863120592615,44360936,5218458701,260013,260013,490989,751002,342067412.43333125,3842667.499999923,199735,0,273,0.29225221770381454,4332825090,-7170,-7170,59555570.5833357,-8481.79999992298,-2217,0,0,0.5640340943554469,-4288464154,1588.4283251530276,1315.5781150685975,272.85021008443005,0.781188326352717,0.7681731298050483,-2217
995,2019-09-23,2019,255004,255004,401600817.13333374,3831821.1000000015,195959,0,239,0.8384731219902425,44146520,5226333767,279565,279565,500631,780196,341358156.0833369,3861965.2666665814,206304,0,237,0.2884608482996579,4329642369,-24561,-24561,60242661.04999685,-30144.1666665799,-10345,0,2,0.5500122736905846,-4285495849,1574.880461221525,1221.0332340719935,353.84722714953136,0.768454612476667,0.7379464525244577,-10345
996,2019-09-24,2019,248487,248487,402008141.933333,3840876.616666666,191819,0,213,0.8402652855078927,43448922,5236154628,249645,249645,507557,757202,336508255.2166629,3835234.8333332473,192757,0,212,0.2781424243464767,4221515047,-1158,-1158,65499886.716670096,5641.783333418891,-938,0,1,0.562122861161416,-4178066125,1617.823636380708,1347.9471057568262,269.87653062388176,0.771947828256609,0.7721244166716738,-938
997,2019-09-25,2019,249587,249587,402370665.2666666,3846794.166666667,191499,0,251,0.8361733583880563,43400148,5243608078,253181,253180,511467,764648,337168124.0499909,3843857.8166666017,192724,0,251,0.27556601207352793,4235565454,-3594,-3593,65202541.2166757,2936.3500000652857,-1225,0,0,0.5606073463145284,-4192165306,1612.145926136644,1331.7328542933521,280.41307184329185,0.7672635193339397,0.7612103593871578,-1225
998,2019-09-26,2019,248641,248641,402967007.5,3824806.533333329,191266,0,178,0.8364227943098683,43797999,5251858767,264673,264673,520467,785140,338114752.2999904,3887470.816666562,196073,0,180,0.2717922918205672,4250228514,-16032,-16032,64852255.200009584,-62664.28333323309,-4807,0,-2,0.5646305024893011,-4206430515,1620.678035802623,1277.4810891174786,343.19694668514444,0.7692456191858945,0.7408122475658643,-4807
999,2019-09-27,2019,250392,250392,403603336.6333328,3825899.4500000007,193063,0,79,0.8393518962267164,43825035,5262761826,261731,261729,537858,799589,336734236.2666593,3839470.916666588,197880,0,79,0.26971106405915934,4219062323,-11339,-11337,66869100.36667347,-13571.466666587163,-4817,0,0,0.569640832167557,-4175237288,1611.8859094273491,1286.5759478951868,325.30996153216233,0.771043004568836,0.7560434186244656,-4817
1000,2019-09-28,2019,252839,252839,404105638.33333397,3884049.15,194698,0,61,0.8446204897187533,44109209,5274648059,253812,253812,545470,799282,335980808.5833273,3878355.766666563,195569,0,61,0.2691378011765534,4202330281,-973,-973,68124829.75000668,5693.383333436679,-871,0,0,0.5754826885421999,-4158221072,1598.2725700280969,1323.738864133009,274.5337058950879,0.7700473423799334,0.7705270042393583,-871
1001,2019-09-29,2019,256641,256641,404750533.20000005,3872987.016666668,197660,0,60,0.8456170292353914,43618693,5286306381,257644,257644,545186,802830,336856103.1000122,3868367.31666601,198462,0,60,0.2723328724636475,4220487362,-1003,-1003,67894430.09998786,4619.700000658166,-802,0,0,0.5732841567717439,-4176868669,1577.107840134663,1307.4478858425275,269.6599542921356,0.7701809141953156,0.7702954464299576,-802
1002,2019-09-30,2019,262296,262296,405162000.1333329,3987700.5166666633,201095,0,66,0.8399403727086953,44309122,5297349163,263225,263225,552919,816144,337553775.099994,3982108.666666569,201883,0,66,0.2717241075104397,4237712391,-929,-929,67608225.0333389,5591.850000094157,-788,0,0,0.5682162651982556,-4193403269,1544.6747191468146,1282.3773391584918,262.29737998832275,0.7666720041479855,0.7669598252445626,-788
1003,2019-10-01,2019,252246,252246,405204767.5166669,3931835.4333333345,193375,0,32,0.8335910182916684,44540658,5304359910,253188,253188,295676,548864,337909987.1666813,3926877.499999805,194286,0,30,0.38596446478545443,4199692355,-942,-942,67294780.3499856,4957.933333529625,-911,0,2,0.44762655350621394,-4155151697,1606.3872866831066,1334.6208634164386,271.76642326666797,0.7666127510446151,0.7673586425896962,-911
1004,2019-10-02,2019,258223,258223,405406029.26666707,3901122.6166666653,198958,0,49,0.8424462576919951,43614406,5307684427,259166,259166,307618,566784,338423732.400012,3895557.7666664794,199703,0,49,0.3862035625564579,4218995676,-943,-943,66982296.86665505,5564.850000185892,-745,0,0,0.4562426951355372,-4175381270,1569.9841968634362,1305.8184036486732,264.16579321476297,0.7704890733977996,0.77056018150529,-745
1005,2019-10-03,2019,251697,251697,405262982.8000004,3803547.3833333347,193130,0,38,0.8383373659598649,43221979,5311975796,252606,252606,321066,573672,338622688.3833436,3798131.516666471,193867,0,38,0.3699221854997309,4234825259,-909,-909,66640294.41665685,5415.866666863672,-737,0,0,0.468415180460134,-4191603280,1610.1224202116052,1340.5172022174595,269.60521799414573,0.7673114896085372,0.7674679144596723,-737
1006,2019-10-04,2019,243099,243099,405020506.41666675,3702806.9500000067,186673,0,35,0.8351412387545816,42272456,5317062546,243918,243918,336393,580311,338742229.7166805,3697425.8166664597,187312,0,35,0.3517320884835978,4247889789,-819,-819,66278276.69998622,5381.133333547041,-639,0,0,0.48340915027098375,-4205617333,1666.072285022426,1388.754539298783,277.31774572364316,0.7678888025043296,0.7679302060528538,-639
1007,2019-10-05,2019,239983,239983,404537833.05000025,3633768.233333333,184942,0,35,0.8388594192088599,42193359,5319670039,240737,240737,352510,593247,338575622.3833473,3628978.0166665325,185557,0,35,0.34114963918906277,4264001234,-754,-754,65962210.66665298,4790.216666800436,-615,0,0,0.4977097800197971,-4221807875,1685.693707679295,1406.4129003158937,279.2808073634012,0.7706462541096661,0.7707872076166107,-615
1008,2019-10-06,2019,233259,233259,403711352.8166661,3601200.2499999963,180037,0,57,0.8399461542748611,42470357,5318915395,234023,234023,362311,596334,338098506.7833483,3596346.566666503,180680,0,57,0.33034004433756536,4282066072,-764,-764,65612846.033317804,4853.6833334933035,-643,0,0,0.5096061099372957,-4239595715,1730.7428773023382,1444.7234108756334,286.01946642670487,0.7718330268071114,0.7720608658123347,-643
1009,2019-10-07,2019,232412,232412,403779910.7666667,3587558.066666668,179606,0,36,0.8437989432559418,42348824,5327880491,233262,233261,373195,606457,338482287.0166762,3581770.5833331374,180350,0,36,0.32557131008463314,4297631039,-850,-849,65297623.74999052,5787.48333353037,-744,0,0,0.5182276331713087,-4255282215,1737.345364123482,1451.0882102737971,286.257153849685,0.7727914221296662,0.7731649389956358,-744
1010,2019-10-08,2019,235450,235450,403941617.63333356,3619448.9666666584,181788,0,49,0.8423699299214272,42456226,5331718296,236441,236434,379750,616191,338865130.25001013,3614786.96666654,182571,0,50,0.3239401419365116,4303236171,-991,-984,65076487.38332343,4662.000000118278,-783,0,-1,0.5184297879849156,-4260779945,1715.6152798187877,1433.2335038531266,282.38177596566106,0.7720874920365258,0.7721630343299174,-783
1011,2019-10-09,2019,237658,237658,404144739.71666664,3678049.5833333298,183666,0,71,0.8448568952023503,42562662,5336294584,238754,238754,384931,623685,339328946.800015,3674680.7999998243,184559,0,71,0.32416364029919165,4315498361,-1096,-1096,64815792.916651666,3368.783333505504,-893,0,0,0.5206932549031587,-4272935699,1700.5307615004192,1421.2492640961616,279.2814974042576,0.772816400037028,0.7730090385920236,-893
1012,2019-10-10,2019,244543,244543,404701331.466667,3724041.283333335,186301,0,40,0.8321603971489674,42784760,5343582734,245676,245676,390448,636124,340120094.7333425,3719064.8666664786,187227,0,40,0.32225163647339766,4328849387,-1133,-1133,64581236.73332447,4976.416666856501,-926,0,0,0.5099087606755697,-4286064627,1654.9291186689743,1384.4254006632416,270.5037180057327,0.7618332972115334,0.7620890929516925,-926
1013,2019-10-11,2019,243171,243171,404936522.73333323,3623393.599999994,187133,0,50,0.8411899445246342,42020661,5348334552,244254,244254,399328,643582,340650240.6833466,3617552.4333331743,188082,0,52,0.3201736530853883,4338698515,-1083,-1083,64286282.0499866,5841.166666819714,-949,0,-2,0.521016291439246,-4296677854,1665.2336122865524,1394.6557300324523,270.57788225410013,0.7695531128300661,0.7700262841140779,-949
1014,2019-10-12,2019,231854,231854,404662449.8666664,3538857.96666667,180658,0,44,0.8499055440061414,40847236,5346680664,239954,239953,414138,654092,340669274.23335063,3541503.583333196,183971,0,44,0.3072335390128587,4354968338,-8100,-8099,63993175.63331574,-2645.616666526068,-3313,0,0,0.5426720049932827,-4314121102,1745.3330538471037,1419.733340418126,325.59971342897757,0.7791886273258171,0.7666927827833668,-3313
1015,2019-10-13,2019,229573,229573,404401127.4333332,3523421.21666667,177488,0,39,0.8387397472699314,41094441,5349496120,232478,232478,431111,663589,340174072.2500085,3519826.699999961,179296,0,42,0.29349491929492366,4363001883,-2905,-2905,64227055.183324695,3594.5166667089798,-1808,0,-3,0.5452448279750077,-4321907442,1761.5361015160024,1463.25274757185,298.2833539441524,0.7731222748319707,0.7712385688108122,-1808
1016,2019-10-14,2019,227049,227049,404177378.8166661,3568613.550000001,176893,0,39,0.8439808147140047,41558673,5355580156,228025,228023,438463,666488,339930725.20000947,3563494.549999776,177752,0,39,0.28964962609979344,4362921089,-976,-974,64246653.61665666,5119.00000022538,-859,0,0,0.5543311886142113,-4321362416,1780.1328295507408,1490.7738482521916,289.3589812985492,0.7790961422424234,0.7795285604648613,-859
1017,2019-10-15,2019,232692,232692,404445292.6666671,3629504.683333332,180383,0,45,0.8400675571141248,42169323,5361750301,233634,233634,439119,672753,340437116.65001166,3624322.4333331813,181127,0,45,0.2923896288831134,4370980935,-942,-942,64008176.016655445,5182.250000150874,-744,0,0,0.5476779282310115,-4328811612,1738.1142998756602,1457.1385870635766,280.97571281208366,0.7752006944802572,0.7752595940659321,-744
1018,2019-10-16,2019,237554,237554,404823771.3666668,3695605.3333333354,185197,0,45,0.8466032986184191,42283971,5368522180,238440,238439,443007,681447,341117782.266678,3690547.316666543,185903,0,45,0.296752351980418,4382619641,-886,-885,63705989.09998882,5058.016666792333,-706,0,0,0.549850946638001,-4340335670,1704.1336764132232,1430.6291431631485,273.5045332500747,0.7795995857783914,0.7796636470390874,-706
1019,2019-10-17,2019,236230,236230,405178332.383334,3696721.516666666,183669,0,59,0.8438174660288699,42460027,5376597011,237195,237195,450201,687396,341826481.26667845,3691473.349999874,184393,0,58,0.2915859271802548,4394684307,-965,-965,63351851.11665553,5248.16666679224,-724,0,1,0.5522315388486151,-4352224280,1715.185761263743,1441.1200964045552,274.0656648591878,0.7775007408034542,0.7773899112544531,-724
1020,2019-10-18,2019,236239,236239,405436441.0499998,3676899.5666666697,183023,0,30,0.8426720397563487,41575376,5379987019,237094,237094,458405,695499,342287360.5333431,3672246.249999836,183737,0,30,0.28763233304433417,4407193760,-855,-855,63149080.5166567,4653.316666833591,-714,0,0,0.5550397067120145,-4365618384,1716.2129921393155,1443.6778684122883,272.5351237270272,0.7747366014925563,0.7749542375597864,-714
1021,2019-10-19,2019,236077,236077,405488892.05000013,3686180.2333333306,182951,0,45,0.8439322763335695,41674671,5381841036,236873,236873,466394,703267,342606315.8833306,3681363.049999899,183625,0,45,0.2847339630609782,4420355577,-796,-796,62882576.16666955,4817.183333431371,-674,0,0,0.5591983132725913,-4378680906,1717.6128638113842,1446.3713292917748,271.24153451960933,0.774963253514743,0.7752044344437736,-674
1022,2019-10-20,2019,238171,238171,405801319.03333384,3674791.5833333316,183827,0,34,0.8394262945530734,41726544,5386937979,238971,238971,473466,712437,343161549.83332956,3669904.6333332937,184496,0,34,0.28213020940798705,4437124353,-800,-800,62639769.20000428,4886.950000037905,-669,0,0,0.5572960851450863,-4395397809,1703.8233833394236,1435.996626508361,267.82675683106254,0.7718278043926423,0.7720434697097137,-669
1023,2019-10-21,2019,243005,243005,406342013.8333338,3744962.4666666663,187151,0,38,0.8418221847287101,42216179,5395490957,251256,251256,480634,731890,343978300.28333443,3767619.9166666027,189609,0,38,0.2835754006749635,4452535935,-8251,-8251,62363713.549999356,-22657.44999993639,-2458,0,0,0.5582467840537466,-4410319756,1672.1549508583519,1369.0351684470597,303.11978241129214,0.7701528775128084,0.754644665202025,-2458
1024,2019-10-22,2019,243426,243426,406494765.1166671,3767424.2499999977,187434,0,43,0.8424572560038777,42990681,5397607682,244673,244673,489339,734012,343904557.73333085,3763086.083333214,188251,0,43,0.2810076674495784,4456013721,-1247,-1247,62590207.383336246,4338.166666783858,-817,0,0,0.5614495885542993,-4413023040,1669.8905010831509,1405.5680754857742,264.32242559737665,0.7699834857410466,0.769398339824991,-817
1025,2019-10-23,2019,241452,241452,406768822.11666685,3736541.833333333,185734,0,36,0.8345261169921965,41578978,5402964655,242575,242575,492520,735095,344294680.09999293,3734027.149999925,186449,0,36,0.27558886946584465,4466243035,-1123,-1123,62474142.01667392,2514.6833334080875,-715,0,0,0.5589372475263519,-4424664057,1684.677791514118,1419.3329077604574,265.3448837536607,0.7692377781091065,0.7686241368648872,-715
1026,2019-10-24,2019,239737,239737,406978018.16666657,3656858.433333331,185150,0,40,0.8374051564839801,42171369,5409951829,240803,240802,503125,743928,344803463.1999954,3653969.766666593,185877,0,39,0.27124264713789803,4480893637,-1066,-1065,62174554.96667117,2888.6666667377576,-727,0,1,0.566162509346082,-4438722268,1697.6020312536928,1431.896176942033,265.7058543116598,0.7723046505128537,0.7719048350726527,-727
1027,2019-10-25,2019,233837,233837,406322585.56666726,3585009.966666665,181274,0,89,0.8398243220705026,41172731,5409403967,234923,234923,517976,752899,344425160.16666186,3581883.616666643,182034,0,89,0.26238977605229985,4491197948,-1086,-1086,61897425.4000054,3126.350000021979,-760,0,0,0.5774345460182028,-4450025217,1737.6317074144265,1466.1193674806718,271.5123399337547,0.7752152140166013,0.7748666584370197,-760
1028,2019-10-26,2019,230687,230687,406086052.01666677,3592854.8000000045,178265,0,78,0.8364103742300173,40989851,5409956486,231635,231634,527117,758752,344432650.4833273,3589072.183333273,179069,0,78,0.2558345809961594,4503704343,-948,-947,61653401.53333944,3782.6166667314246,-804,0,0,0.5805757932338579,-4462714492,1760.3334909061489,1486.969315745216,273.364175160933,0.7727570257535101,0.7730653830379692,-804
1029,2019-10-27,2019,228975,228975,406024207.866667,3534664.0833333316,177068,0,113,0.8395545365214553,40715209,5413117157,230013,230012,535305,765318,344631927.66666126,3532630.4999999637,177853,0,113,0.2528413025696526,4516291794,-1038,-1037,61392280.20000571,2033.5833333679475,-785,0,0,0.5867132339518026,-4475576585,1773.2250589220089,1498.3215122109336,274.90354671107525,0.7733071295993013,0.7732302087273328,-785
1030,2019-10-28,2019,230218,230218,406109624.6833331,3555685.6000000015,178596,0,76,0.8392610482238575,41146603,5419157844,231346,231346,545957,777303,344974664.98332745,3552474.4166665897,179440,0,76,0.25022931855402275,4528626358,-1128,-1128,61134959.70000565,3211.183333411813,-844,0,0,0.5890317296698347,-4487479755,1764.0220342602797,1491.1633007846578,272.8587334756219,0.775769053679556,0.7756347635143896,-844
1031,2019-10-29,2019,233350,233350,406109367.9666666,3605783.9333333354,180360,0,38,0.835187486608099,41091801,5419651753,234325,234325,548905,783230,345208166.4666623,3602767.899999959,181098,0,38,0.25018832271490943,4530195505,-975,-975,60901201.50000429,3016.0333333765157,-738,0,0,0.5849991638931896,-4489103704,1740.344409542175,1473.2024601159171,267.14194942625795,0.7729162202699807,0.7728496745972474,-738
1032,2019-10-30,2019,234332,234332,406508041.5666669,3647206.8833333314,180585,0,43,0.8321398699281357,41249725,5426554088,235328,235328,554723,790051,345846881.36666465,3642949.5166665968,181413,0,43,0.24840548268402696,4536286769,-996,-996,60661160.20000225,4257.366666734684,-828,0,0,0.5837343872441088,-4495037044,1734.7525799577818,1469.637617991334,265.1149619664477,0.7706373862724681,0.770894241229263,-828
1033,2019-10-31,2019,238496,238496,407217711.53333277,3718682.0833333344,183284,0,35,0.8328273849456583,41076692,5436027159,239486,239486,558422,797908,346720281.94999754,3713593.299999932,184138,0,35,0.2505928001724549,4546877870,-990,-990,60497429.58333522,5088.783333402593,-854,0,0,0.5822345847732034,-4505801178,1707.4404247171137,1447.7684789507425,259.6719457663712,0.7684992620421307,0.7688883692574932,-854
1034,2019-11-01,2019,234397,234397,407061559.6666662,3630495.166666664,179671,0,79,0.8317811234785432,41003326,5437277383,235388,235388,280620,516008,346892409.3666775,3625376.449999835,180689,0,83,0.3808526224399653,4481290710,-991,-991,60169150.29998869,5118.716666829307,-1018,0,-4,0.45092850103857784,-4440287384,1736.632975962432,1473.704731620463,262.92824434196905,0.7665243155842438,0.767621968834435,-1018
1035,2019-11-02,2019,233049,233049,407037550.28333354,3628051.6500000004,178463,0,113,0.8337731550017377,41497596,5437228161,234022,234022,290307,524329,347088887.4666753,3622186.849999827,179437,0,113,0.37352692679597194,4494017487,-973,-973,59948662.81665826,5864.800000173505,-974,0,0,0.4602462282057657,-4452519891,1746.5749704282514,1483.1464027598913,263.4285676683601,0.7657745795948492,0.766752698464247,-974
1036,2019-11-03,2019,228632,228632,406999648.9000002,3540906.8499999945,176803,0,147,0.8444793379754364,41688049,5443473331,229641,229641,302440,532081,347245121.7333394,3535790.483333152,177779,0,147,0.36547818847129543,4512205293,-1009,-1009,59754527.166660786,5116.366666842718,-976,0,0,0.47900114950414097,-4470517244,1780.1517237307123,1512.1216234615745,268.03010026913785,0.7733081983274432,0.7741605375346737,-976
1037,2019-11-04,2019,227296,227296,406960274.10000026,3563756.283333329,176685,0,206,0.8426853090243546,40973661,5450248118,229788,229788,314660,544448,347454555.1166837,3559488.8333331523,177902,0,206,0.354691357117659,4526330090,-2492,-2492,59505718.98331654,4267.450000176672,-1217,0,0,0.4879939519066956,-4485356429,1790.4418647930463,1512.0657088998717,278.37615589317465,0.777334400957342,0.7742005674795899,-1217
1038,2019-11-05,2019,228168,228168,407015840.3833331,3590573.5666666687,177061,0,237,0.8417131236632661,40891655,5452628289,235883,235883,320476,556359,347738220.3833431,3608698.633333159,180360,0,237,0.3519993385565779,4530555286,-7715,-7715,59277619.99998999,-18125.0666664904,-3299,0,0,0.4897137851066882,-4489663631,1783.8427841911796,1474.197887865353,309.6448963258265,0.7760115353599102,0.764616356413985,-3299
1039,2019-11-06,2019,233233,233233,407166884.46666646,3591850.81666667,179935,0,201,0.8384319543117829,41218947,5453983345,234329,234327,329875,564204,346875055.9833373,3586950.799999873,180776,0,201,0.348790508397669,4518018775,-1096,-1094,60291828.48332918,4900.01666679699,-841,0,0,0.48964144591411385,-4476799828,1745.7516066194169,1480.3034049995829,265.448201619834,0.7714817371469732,0.7714623456763781,-841
1040,2019-11-07,2019,230550,230550,406808475.4500001,3555456.38333333,178954,0,57,0.8422901756668837,41903135,5454741186,231640,231639,336369,568009,346806751.7666797,3550496.799999865,179807,0,57,0.34403504169827875,4522264345,-1090,-1089,60001723.6833204,4959.583333465271,-853,0,0,0.49825513396860494,-4480361210,1764.5130143135984,1497.1863622562682,267.3266520573302,0.7762047278247669,0.7762346744949059,-853
1041,2019-11-08,2019,231413,231413,406723720.1500001,3607235.083333334,179278,0,51,0.8399268839693536,42073134,5455403315,232438,232434,344313,576751,347046795.90000534,3601736.099999875,180190,0,50,0.33953300471087633,4533535312,-1025,-1021,59676924.249994755,5498.983333459124,-912,0,1,0.5003938792584772,-4491462178,1757.5664295005038,1493.0982382095792,264.46819129092455,0.7747101502508502,0.7752174773487984,-912
1042,2019-11-09,2019,234140,234140,406630888.71666664,3562786.8333333363,179836,0,154,0.8319723242504488,41315854,5454106771,235026,235026,352175,587201,347260969.23334587,3556962.3999998122,180651,0,155,0.3337749765412598,4542288463,-886,-886,59369919.48332077,5824.433333524037,-815,0,-1,0.49819734770918894,-4500972609,1736.6997895133964,1477.5427792386624,259.1570102747339,0.7680703852396003,0.7686426182635113,-815
1043,2019-11-10,2019,229255,229255,405915601.04999995,3553773.5833333344,174981,0,326,0.8326492333864035,40895875,5452867512,230121,230121,363658,593779,346778075.300013,3548743.2833331656,175791,0,326,0.32353282955443147,4557389121,-866,-866,59137525.74998695,5030.300000168849,-810,0,0,0.509116403831972,-4516493246,1770.5855970425944,1506.9379817574797,263.6476152851146,0.7632592527971037,0.7639068142412035,-810
1044,2019-11-11,2019,235857,235857,406194236.8000003,3637481.6333333342,180582,0,128,0.8346837278520455,41516396,5460494318,236778,236773,368387,605165,347349745.33334655,3631600.366666537,181407,0,128,0.32720167227120045,4570981759,-921,-916,58844491.466653764,5881.266666797455,-825,0,0,0.507482055580845,-4529465363,1722.2055601487355,1467.0158562561885,255.18970389254696,0.7656418931810377,0.7661480374021236,-825
1045,2019-11-12,2019,234949,234949,406636617.75000036,3600025.766666668,180603,0,76,0.8345002532464506,41556032,5468240056,235971,235971,372555,608526,348030935.900015,3594406.3833331745,181456,0,76,0.3242835967567481,4577055094,-1022,-1022,58605681.84998536,5619.38333349349,-853,0,0,0.5102166564897025,-4535499062,1730.7441944847621,1474.8885918185497,255.85560266621246,0.7686902263895569,0.7689758487271741,-853
1046,2019-11-13,2019,229598,229598,406474320.1833336,3531672.4333333364,177395,0,38,0.8369933536006414,40664348,5470182897,230448,230448,384447,614895,348132658.6000134,3526692.6333331745,178151,0,40,0.3141902275998365,4582800494,-850,-850,58341661.5833202,4979.800000161864,-756,0,-2,0.5228031260008049,-4542136146,1770.3739587598045,1510.677717315895,259.69624144390946,0.7726330368731434,0.7730637714365063,-756
1047,2019-11-14,2019,229689,229689,406170318.7666667,3521271.8666666644,178271,0,47,0.8420995345880736,40046473,5467894477,234524,234524,393931,628455,348167294.46668583,3516722.599999847,180286,0,47,0.3116134011186103,4596682448,-4835,-4835,58003024.29998088,4549.266666817479,-2015,0,0,0.5304861334694633,-4556635975,1768.3490230993505,1484.5699990904377,283.77902400891276,0.7761407816656436,0.7687315583906125,-2015
1048,2019-11-15,2019,234639,234639,406360034.2000004,3568508.583333333,180771,0,44,0.8370262403095817,40014944,5472606559,235469,235469,403657,639126,347655645.98334396,3562955.9166665124,181552,0,44,0.3091315327494095,4586106332,-830,-830,58704388.21665645,5552.666666820645,-781,0,0,0.5278947075601722,-4546091388,1731.8520544325556,1476.4391320443199,255.41292238823576,0.7704217968879854,0.7710229372019247,-781
1049,2019-11-16,2019,229932,229932,406367579.04999983,3567232.749999994,176118,0,48,0.837517178992049,40213904,5473367293,230651,230650,405249,635900,347835733.7333452,3562029.399999842,176785,0,48,0.30441736122031016,4592702943,-719,-718,58531845.31665462,5203.350000151899,-667,0,0,0.5330998177717389,-4552489039,1767.3380784318836,1508.067347640777,259.27073079110664,0.7659568916027347,0.7664610168609718,-667
1050,2019-11-17,2019,234386,234386,406436872.86666644,3535741.1333333342,179181,0,78,0.8401440359065815,40497446,5477454638,235079,235079,414375,649454,348168867.38334584,3530734.8333331477,179872,0,75,0.3048499200867274,4608438956,-693,-693,58268005.483320594,5006.300000186544,-691,0,3,0.5352941158198541,-4567941510,1734.0492728519043,1481.0717562323553,252.97751661954908,0.7644697208877663,0.7651555434556043,-691
1051,2019-11-18,2019,222961,222961,405660595.8666661,3505232.0333333295,172598,0,57,0.8391916075008635,40381666,5473508835,223674,223674,428213,651887,347966021.4333415,3499304.4166665482,173230,0,57,0.28861443777831913,4618130566,-713,-713,57694574.433324575,5927.61666678125,-632,0,0,0.5505771697225443,-4577748900,1819.4240062910826,1555.68381409257,263.74019219851266,0.774117446548948,0.774475352521974,-632
1052,2019-11-19,2019,230118,230118,405696035.50000095,3542908.666666665,177953,0,36,0.8367837370392576,40013941,5473482716,232296,232296,432228,664524,348223472.71668196,3539217.4833331797,178910,0,37,0.2917622237872503,4622105057,-2178,-2178,57472562.783319,3691.1833334853873,-957,0,-1,0.5450215132520073,-4582091116,1762.991315325185,1499.0506625886023,263.9406527365827,0.7733119529980271,0.7701811481902401,-957
1053,2019-11-20,2019,229572,229572,405369675.4333334,3541532.7499999967,177223,0,49,0.8348579095011586,39775340,5461109735,230395,230395,437060,667455,348275762.2166805,3536821.949999828,177889,0,34,0.2886321924324555,4622638434,-823,-823,57093913.21665287,4710.800000168849,-666,0,15,0.546225717068703,-4582863094,1765.7627037850148,1511.6463561131125,254.1163476719023,0.7719713205443173,0.7721044293495952,-666
1054,2019-11-21,2019,231018,231018,405053882.16666687,3554727.283333339,177512,0,38,0.8336233540243615,39590546,5455642731,231765,231765,443356,675121,348358356.4833441,3548799.2333331485,178112,0,38,0.2865264152648188,4626124228,-747,-747,56695525.68332279,5928.050000190269,-600,0,0,0.5470969387595427,-4586533682,1753.343385219623,1503.0671433708458,250.27624184877732,0.768390341878122,0.7685025780424136,-600
1055,2019-11-22,2019,237701,237701,405163494.71666616,3622855.8333333335,183108,0,75,0.8446788191888127,40648249,5456560935,238729,238729,447383,686112,348747448.7500129,3617505.4333331836,183917,0,75,0.2944286064082799,4631404169,-1028,-1028,56416045.96665329,5350.40000014985,-809,0,0,0.5502502127805329,-4590755920,1704.5090038185206,1460.8507921116113,243.65821170690924,0.7703291109418976,0.7704007472908612,-809
1056,2019-11-23,2019,234654,234654,405182955.5833335,3633004.799999999,180646,0,50,0.8451166398186268,41319442,5458621913,239576,239576,452381,691957,348933852.5166644,3631567.266666193,182104,0,50,0.2895078740441916,4636140817,-4922,-4922,56249103.06666911,1437.5333338058554,-1458,0,0,0.5556087657744353,-4594821375,1726.7251169097203,1456.464138797978,270.26097811174236,0.769839849310048,0.7601095268307343,-1458
1057,2019-11-24,2019,225035,225035,405097159.4166663,3492618.116666665,174083,0,84,0.8486724287333077,40497779,5461014203,232765,232765,464040,696805,348968238.81666243,3490880.099999573,176518,0,84,0.278083538436141,4650792863,-7730,-7730,56128920.6000039,1738.0166670917533,-2435,0,0,0.5705888902971668,-4610295084,1800.1517960169144,1499.2298619494445,300.9219340674699,0.7735818872619815,0.7583528451442442,-2435
1058,2019-11-25,2019,225238,225238,405269485.35000014,3506513.700000002,173840,0,40,0.8352187463927041,40882039,5470547041,226225,226225,480277,706502,346990798.7000152,3501836.016666529,174704,0,40,0.2684366073981431,4619040999,-987,-987,58278686.649984956,4677.68333347328,-864,0,0,0.566782138994561,-4578158960,1799.2944589722877,1533.830472759488,265.4639862127997,0.7718058231737096,0.7722577080340369,-864
1059,2019-11-26,2019,226172,226172,405707901.0333339,3522965.899999999,174750,0,90,0.8366906602055072,40459357,5477537703,227294,227294,476285,703579,347579552.15001047,3518305.4166661487,175623,0,91,0.27086226280204556,4622959597,-1122,-1122,58128348.88332343,4660.483333850279,-873,0,-1,0.5658283974034617,-4582500240,1793.8025088575682,1529.206895694609,264.5956131629591,0.7726420600251136,0.7726688781930011,-873
1060,2019-11-27,2019,218428,218428,405720403.9500002,3477442.616666667,168387,0,83,0.8358635339791616,40283953,5480526241,219371,219371,485621,704992,347890150.18334156,3471771.816666509,169111,0,84,0.2606909014570342,4635429490,-943,-943,57830253.766658664,5670.800000158139,-724,0,-1,0.5751726325221274,-4595145537,1857.4560218927986,1585.8529622572792,271.60305963551946,0.7709039134176937,0.7708904093977782,-724
1061,2019-11-28,2019,220643,220643,405672088.06666654,3455310.483333335,167896,0,57,0.8222105391968022,40126352,5484451447,222209,222209,495108,717317,348063247.74999666,3450897.633333262,168755,0,57,0.2546781966689806,4647505919,-1566,-1566,57608840.31666988,4412.850000072736,-859,0,0,0.5675323425278216,-4607379567,1838.5903385408399,1566.3778143549391,272.21252418590075,0.760939617390989,0.7594426868398669,-859
1062,2019-11-29,2019,230200,230200,405965276.9499998,3499850.916666671,175066,0,67,0.8225456125108604,39977372,5490581037,231193,231193,499747,730940,348545273.75001365,3496125.083332834,175878,0,66,0.2609625961091049,4655883342,-993,-993,57420003.19998616,3725.833333837334,-812,0,1,0.5615830164017556,-4615905970,1763.532914639443,1507.5944070539058,255.9385075855373,0.7604952215464813,0.7607410258961128,-812
1063,2019-11-30,2019,223077,223077,405933336.6833338,3482447.1,170364,0,44,0.8305472998112765,39868154,5493571956,225926,225926,505919,731845,348752713.3999952,3477644.283333285,171477,0,44,0.25550492249041606,4665205496,-2849,-2849,57180623.28333861,4802.816666715313,-1113,0,0,0.5750423773208604,-4625337342,1819.7005369595872,1543.6590449970133,276.0414919625739,0.7637004263101979,0.7589963085258005,-1113
1064,2019-12-01,2019,219616,219616,405715286.6666661,3415784.700000002,167299,0,45,0.8393923939967946,39995597,5497404355,220625,220625,273045,493670,348827706.18334204,3410537.699999867,168335,0,45,0.3768610610326746,4612181578,-1009,-1009,56887580.48332405,5247.000000135042,-1036,0,0,0.46253133296411997,-4572185981,1847.384920345813,1581.088753238944,266.296167106869,0.7617796517557919,0.7629915014164306,-1036
1065,2019-12-02,2019,221749,221749,406217687.7166671,3447798.333333335,170679,0,40,0.8338526893018694,40360805,5510667739,228307,228307,283825,512132,349473921.9666772,3452644.166666502,173701,0,40,0.3681726586114482,4627994692,-6558,-6558,56743765.74998993,-4845.8333331672475,-3022,0,0,0.4656800306904212,-4587633887,1831.8805844295448,1530.719259447486,301.1613249820589,0.769694564575263,0.7608220510102625,-3022
1066,2019-12-03,2019,221243,221243,406675935.6333327,3488352.3499999978,169866,0,39,0.8284284700532891,40172430,5519871068,225011,225011,289800,514811,349318647.68334484,3485455.349999834,171794,0,37,0.3609266313268369,4621137603,-3768,-3768,57357287.94998789,2897.000000163913,-1928,0,2,0.46750183872645223,-4580965173,1838.1414807850767,1552.4514254118458,285.69005537323096,0.7677802235550956,0.7634915626347156,-1928
1067,2019-12-04,2019,222523,222523,406954640.4666665,3486415.4666666714,170855,0,45,0.8299276928677042,40797321,5526325655,223757,223757,293102,516859,349108715.0666772,3481514.3833331224,171846,0,45,0.36014851245697904,4612120267,-1234,-1234,57845925.39998931,4901.08333354909,-991,0,0,0.46977918041072514,-4571322946,1828.8205734538296,1560.2136025540083,268.60697089982136,0.7678082715045186,0.7680027887395702,-991
1068,2019-12-05,2019,219985,219985,407256003.8166666,3479664.299999999,169607,0,48,0.8360797327090473,40312818,5531572742,221119,221119,302641,523760,349657528.15000856,3475119.0999998683,170472,0,51,0.3537555368871177,4626097151,-1134,-1134,57598475.666658044,4545.200000130571,-865,0,-3,0.48232419582192965,-4585784333,1851.2898780219862,1581.3092866285058,269.9805913934804,0.7709934768279656,0.7709513881665528,-865
1069,2019-12-06,2019,216222,216222,407460485.9166668,3458025.466666667,166702,0,43,0.8326118526329428,39440245,5535139476,217327,217327,311564,528891,350085057.733341,3453503.766666504,167589,0,43,0.34355661185385933,4636239054,-1105,-1105,57375428.18332583,4521.700000162702,-887,0,0,0.48905524077908347,-4596798809,1884.4543382110369,1610.8677602568525,273.58657795418435,0.7709761263886191,0.7711375024732315,-887
1070,2019-12-07,2019,224851,224851,407729718.4,3471640.316666666,172157,0,67,0.828304076922052,39851209,5538728900,225901,225901,318662,544563,350560074.3833449,3467908.416666471,173065,0,67,0.3445239577422663,4650461175,-1050,-1050,57169644.01665509,3731.900000195019,-908,0,0,0.4837801191797857,-4610609966,1813.3329111278135,1551.830555789239,261.5023553385745,0.765649252171438,0.7661099331122926,-908
1071,2019-12-08,2019,224561,224561,407706583.06666684,3452435.6499999957,171088,0,38,0.8292357087829134,39809630,5540289204,233899,233899,326075,559974,350857556.43334603,3494499.649999803,174661,0,38,0.33989256644058435,4666918764,-9338,-9338,56849026.63332081,-42063.999999807216,-3573,0,0,0.48934314234232906,-4627109134,1815.5716400740416,1500.0387194188347,315.5329206552069,0.7618776189988467,0.7467368394050423,-3573
1072,2019-12-09,2019,226417,226417,407785086.1499997,3528233.6666666646,172431,0,34,0.8273009535503075,39922206,5542947835,234168,234168,335372,569540,350643887.28333974,3544157.599999849,175452,0,34,0.33539523123924964,4662143160,-7751,-7751,57141198.86665994,-15923.93333318457,-3021,0,0,0.4919057223110579,-4622220954,1801.035638445875,1497.4030921532392,303.6325462926359,0.7615638401710119,0.7492569437327047,-3021
1073,2019-12-10,2019,229399,229399,408256112.4666665,3549078.5166666703,175028,0,38,0.8296287254957526,40619494,5550108640,231679,231679,338894,570573,350306106.58334583,3545524.8833331373,176265,0,38,0.33654939858703264,4642166533,-2280,-2280,57950005.88332069,3553.633333533071,-1237,0,0,0.49307932690872,-4601547039,1779.676949187514,1512.0321936098906,267.6447555776235,0.7629850173714794,0.7608156112552281,-1237
1074,2019-12-11,2019,226040,226040,408146926.03333277,3478897.2666666633,173206,0,44,0.8342461511236957,39856731,5552358059,227036,227036,346868,573904,350095246.5000123,3474494.1333331633,174054,0,46,0.33073649948423184,4637585968,-996,-996,58051679.53332049,4403.133333500009,-848,0,-2,0.5035096516394639,-4597729237,1805.6402673568075,1542.0252581089003,263.6150092479072,0.766262608387896,0.7666361281911239,-848
1075,2019-12-12,2019,223255,223255,407910815.3833332,3456555.6999999993,172027,0,37,0.8368726344314795,39966863,5552931745,234799,234799,356324,591123,350091748.1333365,3513237.3666665,176367,0,37,0.3244383994532436,4645281167,-11544,-11544,57819067.24999672,-56681.666666500736,-4340,0,0,0.5124342349782359,-4605314304,1827.1071885661383,1491.027424023682,336.07976454245636,0.7705404134285906,0.7511403370542464,-4340
1076,2019-12-13,2019,222450,222450,407799987.4666664,3442016.066666667,171262,0,49,0.8371768936839735,39580863,5554996949,223707,223707,373591,597298,348581820.5833412,3436915.9999998375,172204,0,49,0.3140023907664149,4636550304,-1257,-1257,59218166.88332522,5100.0666668294,-942,0,0,0.5231745029175586,-4596969441,1833.2208921855085,1558.2070323384658,275.0138598470428,0.7698898628905372,0.7697747500078227,-942
1077,2019-12-14,2019,221167,221167,407851799.73333335,3443429.766666676,168975,0,39,0.8299068124991509,39054161,5558714896,222043,222043,373694,595737,348585406.68334556,3439299.183333193,169769,0,39,0.31019057067128364,4632469332,-876,-876,59266393.04998779,4130.583333482966,-794,0,0,0.5197162418278672,-4593415171,1844.0897590207098,1569.9004547918446,274.18930422886524,0.7640154272563267,0.7645771314565197,-794
1078,2019-12-15,2019,219545,219545,408121698.3999997,3446627.083333334,168083,0,39,0.8373590835591787,39410290,5561237731,220515,220515,380772,601287,349024091.76667,3442617.1333331903,168890,0,39,0.30767337394621447,4646617145,-970,-970,59097606.63332969,4009.95000014361,-807,0,0,0.5296857096129641,-4607206855,1858.943261745882,1582.768028327642,276.17523341823994,0.7655970302215946,0.7658889417953427,-807
1079,2019-12-16,2019,227358,227358,408563208.2000006,3505926.199999996,174535,0,105,0.8416330192911619,39666348,5569466275,228487,228487,387516,616003,349638740.5500103,3501689.7666665157,175383,0,105,0.31283613878504124,4658958285,-1129,-1129,58924467.64999026,4236.433333480265,-848,0,0,0.5287968805061206,-4619291937,1797.0038802241424,1530.2347203561267,266.7691598680158,0.7676659717274079,0.7675841513959218,-848
1080,2019-12-17,2019,226425,226425,408601458.4999996,3503259.4333333364,174691,0,53,0.8425968863862209,40813316,5570641104,227425,227424,390615,618040,349838640.0666816,3498933.616666535,175479,0,53,0.31078570966280084,4665668708,-1000,-999,58762818.43331796,4325.81666680146,-788,0,0,0.53181117672342,-4624855392,1804.5774914430808,1538.266146346391,266.3113450966898,0.7715181627470464,0.7715906342750357,-788
1081,2019-12-18,2019,224128,224128,408474906.0166669,3467679.0333333313,173518,0,138,0.8431967447173032,41620729,5574590718,231934,231934,401910,633844,350101307.9666835,3472996.049999587,175597,0,137,0.3021295460712765,4678470411,-7806,-7806,58373598.04998338,-5317.016666255426,-2079,0,1,0.5410671986460267,-4636849682,1822.5072548573444,1509.486784890027,313.02046996731747,0.7741915334094803,0.7570990023023791,-2079
1082,2019-12-19,2019,218787,218787,408823698.3333337,3453790.283333332,169707,0,85,0.8430208376183231,42377524,5581748988,243655,243654,412077,655732,350048697.85002136,3503995.0166665614,181054,0,87,0.2996590070333631,4683745946,-24868,-24867,58775000.48331231,-50204.73333322955,-11347,0,-2,0.54336183058496,-4641368422,1868.5922762016648,1436.6630461639102,431.9292300377547,0.775672229154383,0.7430752498409636,-11347
1083,2019-12-20,2019,219080,219080,409146293.1666664,3452051.099999998,169093,0,306,0.8394924228592295,42566158,5587714872,220021,220021,426764,646785,340077904.20001066,3447542.633333186,169940,0,308,0.2866362083227048,4458075568,-941,-941,69068388.96665573,4508.466666812077,-847,0,-2,0.5528562145365248,-4415509410,1867.5656982228702,1545.6611150754277,321.9045831474425,0.7718322074128172,0.7723808181946269,-847
1084,2019-12-21,2019,219636,219636,409169406.46666676,3463598.433333338,169010,0,327,0.8384827623886798,42686070,5592145063,220695,220695,426976,647671,340364967.1666799,3458725.099999848,170076,0,327,0.2869744052149893,4466769276,-1059,-1059,68804439.29998684,4873.333333489951,-1066,0,0,0.5515083571736905,-4424083206,1862.9432627923782,1542.2414063149592,320.7018564774189,0.7695004461927917,0.7706382111058248,-1066
1085,2019-12-22,2019,217931,217931,409053596.0666672,3394891.8500000006,167484,0,237,0.8384763984931011,42629258,5597088376,218896,218896,434982,653878,340535585.43335235,3390525.0499998573,168407,0,237,0.28162134220757223,4483159106,-965,-965,68518010.63331485,4366.800000143237,-923,0,0,0.5568550562855288,-4440529848,1876.9867346392537,1555.695789020139,321.2909456191146,0.7685184760314044,0.769347087201228,-923
1086,2019-12-23,2019,217277,217277,409597348.34999996,3399756.8666666704,167509,0,87,0.8318597918785701,41972088,5610218758,218211,218211,445046,663257,341294233.6500038,3394574.9833328337,168327,0,87,0.27447580651240433,4501944897,-934,-934,68303114.69999617,5181.883333836682,-818,0,0,0.5573839853661657,-4459972809,1885.1390085006694,1564.0560450664898,321.08296343417965,0.7709467638084104,0.7713955758417311,-818
1087,2019-12-24,2019,214356,214356,409493147.6333331,3407146.58333333,165950,0,162,0.8417165836272367,42144874,5614667373,217305,217305,450290,667595,341447123.1166638,3403777.816666309,167369,0,162,0.2731086961406154,4512587186,-2949,-2949,68046024.51666927,3368.7666670214385,-1419,0,0,0.5686078874866213,-4470442312,1910.3414302997494,1571.2805647208477,339.0608655789017,0.7741794024893168,0.7702031706587515,-1419
1088,2019-12-25,2019,212450,212450,409280567.1333334,3384129.9666666663,164191,0,131,0.845384796422687,41830618,5615405430,213503,213503,458659,672162,341373142.05001235,3379239.5499998126,165236,0,131,0.269506458264522,4525759853,-1053,-1053,67907425.08332103,4890.416666853707,-1045,0,0,0.575878338158165,-4483929235,1926.479487565702,1598.9149663002972,327.56452126540466,0.7728453753824429,0.7739282352004422,-1045
1089,2019-12-26,2019,211460,211460,409735990.08333343,3354941.7166666635,163992,0,293,0.8496453229925276,42109243,5628396679,212521,212521,465129,677650,342098704.58334386,3350300.533333163,164952,0,293,0.2675894635874026,4545036930,-1061,-1061,67637285.49998957,4641.183333500754,-960,0,0,0.582055859405125,-4502927687,1937.6524642170314,1609.7171789298181,327.9352852872132,0.7755225574576752,0.7761680022209569,-960
1090,2019-12-27,2019,216139,216139,409981065.6833336,3388969.000000003,167941,0,287,0.8525162048496573,42727362,5637100685,217277,217277,471070,688347,342602776.5666759,3383691.31666651,168964,0,287,0.27018930858999624,4557693438,-1138,-1138,67378289.11665767,5277.683333492838,-1023,0,0,0.582326896259661,-4514966076,1896.8398377124608,1576.8018546218693,320.0379830905915,0.7770046127723363,0.7776432848391684,-1023
1091,2019-12-28,2019,214563,214563,410180227.816667,3395149.866666664,166726,0,453,0.8500114185577194,42608742,5644950178,215696,215696,476685,692381,343151015.63334477,3390075.5999998236,167739,0,453,0.2655849886117545,4568291828,-1133,-1133,67029212.18332225,5074.266666840296,-1013,0,0,0.5844264299459649,-4525683086,1911.7006558291366,1590.9011554843148,320.7995003448218,0.7770491650470958,0.7776639344262295,-1013
1092,2019-12-29,2019,219331,219331,410429072.63333315,3399341.399999999,167395,0,361,0.8403691224678674,43113106,5652744509,220441,220441,482614,703055,343705568.8833432,3394989.0999998217,168358,0,361,0.2643889880592562,4588055249,-1110,-1110,66723503.74998993,4352.300000177231,-963,0,0,0.5759801344086113,-4544942143,1871.277077263739,1559.1726080145854,312.1044692491537,0.763207207371507,0.7637326994524613,-963
1093,2019-12-30,2019,219617,219617,410836148.3333331,3391745.983333332,166872,0,424,0.8320485208339978,43083984,5666681198,220656,220656,491643,712299,344342644.15000725,3386619.4999996815,167775,0,424,0.25873404286682294,4606429022,-1039,-1039,66493504.18332583,5126.483333650511,-903,0,0,0.5733144779671748,-4563345038,1870.6937456268554,1560.5405887445038,310.1531568823516,0.7598318891524791,0.7603464215792909,-903
1094,2019-12-31,2019,211585,211585,410910838.4333334,3334846.316666667,164088,0,321,0.843769643405724,42466601,5676346598,220788,220788,506292,727080,344749800.8333343,3370356.749999491,167826,0,322,0.2515624140397199,4623595933,-9203,-9203,66161037.59999907,-35510.43333282415,-3738,0,-1,0.5922072293660041,-4581129332,1942.060346590417,1561.451713106393,380.60863348402404,0.775518113287804,0.7601228327626501,-3738
1095,2020-01-01,2020,208093,208093,410452598.59999985,3296424.883333337,159956,0,304,0.8287160067854276,41012553,5679755456,208893,208893,265640,474533,344090174.83334637,3291594.966666535,160822,0,307,0.36631593587801525,4574359359,-800,-800,66362423.76665348,4829.916666802019,-866,0,-3,0.4624000709074123,-4533346806,1972.4478891649399,1647.2077802192814,325.24010894565845,0.7686755441076826,0.769877401349016,-866
1096,2020-01-02,2020,213898,213898,411249725.81666666,3386058.7999999966,165128,0,73,0.8353187033071837,42341678,5695336643,214890,214890,264077,478967,345022796.61668396,3381804.9166664667,166006,0,73,0.37598832487415723,4588916598,-992,-992,66226929.1999827,4253.883333529811,-878,0,0,0.4593303784330265,-4546574920,1922.644091186765,1605.5786524113917,317.0654387753734,0.7719941280423379,0.7725161710642654,-878
1097,2020-01-03,2020,215627,215627,411978517.283333,3411316.166666667,166085,0,189,0.844068692696184,43020675,5707730815,216611,216611,266702,483313,346014799.13334435,3407188.7333331453,167017,0,188,0.37969390436425005,4598029637,-984,-984,65963718.14998865,4127.433333521709,-932,0,1,0.46437478833193396,-4555008962,1910.6072861159919,1597.4017899984042,313.2054961175877,0.7702421310874797,0.7710457917649611,-932
1098,2020-01-04,2020,211527,211527,412017171.1333333,3370108.833333336,163089,0,304,0.8475797415932723,41673752,5711960277,212438,212438,276318,488756,346343524.4166765,3365328.166666532,164015,0,304,0.3698900883058266,4611076213,-911,-911,65673646.716656804,4780.6666668038815,-926,0,0,0.4776896532874457,-4569402461,1947.823072862251,1630.3275516464876,317.49552121576335,0.7710079564310939,0.7720605541381486,-926
1099,2020-01-05,2020,209508,209508,412303927.80000067,3336189.26666667,161570,0,261,0.843552513507838,42499238,5723326295,210337,210337,287125,497462,346963254.5500062,3332342.8166664904,162400,0,261,0.35783838765574194,4629225600,-829,-829,65340673.24999446,3846.450000179466,-830,0,0,0.48571412585209606,-4586726362,1967.9626925940806,1649.558824885808,318.4038677082726,0.7711877350745556,0.7720943058044947,-830
1100,2020-01-06,2020,214961,214961,412889187.0999999,3381719.93333333,165640,0,192,0.842217890687148,42826713,5736729438,215820,215820,295263,511083,347773650.1000069,3377459.066666461,166480,0,192,0.3570594208768433,4646240440,-859,-859,65115536.999993026,4260.866666868795,-840,0,0,0.48515846981030475,-4603413727,1920.763241239108,1611.4060332684962,309.35720797061185,0.7705583803573671,0.771383560374386,-840
1101,2020-01-07,2020,216478,216478,413338980.15000015,3436054.0166666643,167190,0,74,0.8414758081652634,43425233,5746715480,217386,217386,299364,516750,348524006.6333436,3431442.949999801,167965,0,74,0.35495500725689594,4656908193,-908,-908,64814973.51665658,4611.066666863393,-775,0,0,0.4865208009083674,-4613482960,1909.3810001478219,1603.2495498023957,306.1314503454262,0.772318665176138,0.7726578528516096,-775
1102,2020-01-08,2020,217762,217762,413713720.35000044,3407415.4999999995,167716,0,54,0.8317107668004512,42824927,5755966673,218688,218688,307979,526667,349086780.66667867,3403222.883333146,168585,0,54,0.3467902868415788,4672203132,-926,-926,64626939.683321774,4192.616666853428,-869,0,0,0.4849204799588724,-4629378205,1899.8435004729954,1596.2777137596881,303.56578671330726,0.7701802885719271,0.7708927787532923,-869
1103,2020-01-09,2020,217857,217857,413860928.2666661,3405598.5166666647,166874,0,75,0.831550053475445,42519894,5760474225,218913,218913,316040,534953,349551056.9166833,3401070.633333179,167824,0,74,0.3416281430331204,4688056289,-1056,-1056,64309871.3499828,4527.8833334855735,-950,0,1,0.4899219104423246,-4645536395,1899.6907524966657,1596.757876036066,302.9328764605998,0.7659795186750942,0.7666241840365807,-950
1104,2020-01-10,2020,215156,215156,413747529.616667,3377868.6833333336,165202,0,146,0.8342133149900538,42281825,5759698598,216092,216092,324607,540699,349754329.98334336,3373499.633333155,166079,0,146,0.33473337291172506,4700559612,-936,-936,63993199.63332361,4369.050000178628,-877,0,0,0.49947994207832874,-4658277787,1923.011812901648,1618.543629488104,304.468183413544,0.7678242763390284,0.7685569109453381,-877
1105,2020-01-11,2020,206627,206627,413286891.4166663,3312167.5333333323,159331,0,144,0.8382689580742116,40958308,5760670173,207620,207619,335942,543562,349617347.11667204,3307293.699999868,160250,0,144,0.3215309385129883,4710974948,-993,-992,63669544.29999429,4873.833333464339,-919,0,0,0.5167380195612233,-4670016640,2000.1591825689109,1683.937149859464,316.2220327094469,0.7711044539193813,0.7718427897119738,-919
1106,2020-01-12,2020,201046,201046,413340806.15000004,3250716.5500000026,155216,0,122,0.836117107527632,41179184,5768292084,202005,202005,347061,549066,349902979.5500124,3246196.5999998217,156118,0,122,0.3085257510026062,4726399883,-959,-959,63437826.599987626,4519.950000180863,-902,0,0,0.5275913565250259,-4685220699,2055.951404902361,1732.1500930670647,323.80131183529625,0.7720422191936174,0.7728422563797925,-902
1107,2020-01-13,2020,207577,207577,413825947.38333267,3312343.0666666683,160696,0,153,0.838426222558376,41375238,5780762788,208642,208642,354777,563419,350610463.31667763,3307645.3166664974,161571,0,153,0.3116206588702207,4745312709,-1065,-1065,63215484.06665504,4697.750000170898,-875,0,0,0.5268055636881552,-4703937471,1993.602120578545,1680.4404832999953,313.16163727854973,0.7741512788025648,0.7743934586516616,-875
1108,2020-01-14,2020,205690,205690,414212474.03333306,3302222.4499999974,159105,0,128,0.8325441197919196,41331944,5788900097,206608,206608,357076,563684,351174077.75000536,3298634.399999827,159782,0,128,0.3059178546845374,4753444277,-918,-918,63038396.2833277,3588.0500001702458,-677,0,0,0.5266262651073821,-4712112333,2013.7705966908118,1699.7119073317847,314.0586893590271,0.7735184014779523,0.7733582436304499,-677
1109,2020-01-15,2020,207438,207438,414347742.58333343,3297956.9666666663,160123,0,186,0.8356810227634284,41033866,5797119102,208449,208449,365506,573955,351521381.566674,3294119.133333141,160839,0,185,0.3041754144488696,4769590954,-1011,-1011,62826361.01665944,3837.833333525341,-716,0,1,0.5315056083145588,-4728557088,1997.4534202187324,1686.3663609164544,311.087059302278,0.7719077507496216,0.7715988083416088,-716
1110,2020-01-16,2020,206204,206204,414548314.7833331,3303642.6333333324,160581,0,177,0.8435966324610581,41791388,5806082243,207107,207107,371634,578741,351883043.6333437,3298957.8666664716,161279,0,177,0.3026362396996316,4783544747,-903,-903,62665271.149989426,4684.766666860785,-698,0,0,0.5409603927614265,-4741753359,2010.3795987630363,1699.0398375397438,311.3397612232925,0.7787482299082462,0.7787230755116921,-698
1111,2020-01-17,2020,200588,200588,414346163.0166665,3233945.8333333363,155991,0,159,0.8399555307396266,42013713,5812662432,201680,201680,382185,583865,351884141.70001173,3229912.5833331924,156860,0,159,0.2910638589399961,4796712731,-1092,-1092,62462021.31665474,4033.2500001438893,-869,0,0,0.5488916717996305,-4754699018,2065.657781206585,1744.764685144842,320.8930960617429,0.7776686541567791,0.7777667592225307,-869
1112,2020-01-18,2020,196389,196389,413404782.13333327,3156183.8333333307,152041,0,145,0.8359022144824811,41406750,5808078512,197279,197279,394373,591652,351172774.7500131,3151424.999999804,152809,0,147,0.27951735141603906,4809244371,-890,-890,62232007.38332015,4758.833333526738,-768,0,-2,0.5563848630664421,-4767837621,2105.030231496333,1780.0818878340478,324.94834366228497,0.7741828717494361,0.7745832044971842,-768
1113,2020-01-19,2020,213094,213094,412871476.9499996,3170849.6166666658,149374,0,138,0.767557979107812,41402714,5811880858,214093,214093,403101,617194,350848350.200006,3165122.59999976,150289,0,138,0.2673891839518869,4825832551,-999,-999,62023126.74999356,5727.0166669059545,-915,0,0,0.500168795155925,-4784429837,1937.5086907655757,1638.766097910749,298.7425928548266,0.7009770336095807,0.7019799806626092,-915
1114,2020-01-20,2020,213928,213928,412956819.90000033,3169855.3666666658,150509,0,196,0.7697870311506666,41107904,5820481837,214917,214917,429295,644212,351120695.8500116,3164763.7666664766,151412,0,196,0.2577784952779492,4841374398,-989,-989,61836124.04998875,5091.600000189152,-903,0,0,0.5120085358727173,-4800266494,1930.3542308627218,1633.7502191544252,296.60401170829664,0.7035497924535358,0.7045138355737331,-903
1115,2020-01-21,2020,211364,211364,412648370.56666636,3160376.850000001,149290,0,205,0.7723595314244622,41913644,5824003610,212800,212800,452475,665275,351020916.91667116,3156557.74999984,150353,0,205,0.24780729773402407,4849068228,-1436,-1436,61627453.64999521,3819.100000161212,-1063,0,0,0.5245522336904381,-4807154584,1952.3115126827008,1649.5343840069133,302.7771286757875,0.7063170644007494,0.706546052631579,-1063
1116,2020-01-22,2020,208142,208142,412253778.74999946,3128044.816666669,148204,0,41,0.779722497141375,41008945,5823460390,209755,209755,477101,686856,350864890.4666704,3123563.566666527,149238,0,41,0.23859877470677676,4860935698,-1613,-1613,61388888.28332907,4481.250000142027,-1034,0,0,0.5411237224345982,-4819926753,1980.6371551632994,1672.7367188704459,307.90043629285356,0.7120331312277195,0.7114872112702916,-1034
1117,2020-01-23,2020,197171,197171,411452527.116667,2999982.1833333317,139883,0,100,0.7715029086427511,40245530,5822316871,198588,198588,505388,703976,350354528.23334086,2996124.3999998393,140816,0,100,0.2181750514222104,4875748189,-1417,-1417,61097998.88332611,3857.7833334924653,-933,0,0,0.5533278572205407,-4835502659,2086.7801406731564,1764.2280914926423,322.55204918051413,0.7094501726927388,0.7090861482063368,-933
1118,2020-01-24,2020,190671,190671,410975958.84999985,2919055.4999999995,133148,0,99,0.7540895049588034,39957837,5827855494,192155,192155,534966,727121,350101853.4500056,2914388.433333036,134153,0,99,0.1997810543224576,4891533330,-1484,-1484,60874105.399994254,4667.06666696351,-1005,0,0,0.5543084506363458,-4851575493,2155.419328843924,1821.976287111996,333.44304173192813,0.6983128005832036,0.6981499310452499,-1005
1119,2020-01-25,2020,186970,186970,410488205.81666684,2902463.0666666683,131246,0,162,0.7617371770872328,40438185,5832250478,188427,188427,563206,751633,349804219.1333319,2897106.3333332352,132338,0,162,0.1913593469153163,4906702607,-1457,-1457,60683986.68333495,5356.733333433047,-1092,0,0,0.5703778301719165,-4866264422,2195.476310727212,1856.4442417134057,339.0320690138062,0.7019628817457346,0.7023303454388171,-1092
1120,2020-01-26,2020,185886,185886,410716311.78333336,2906298.933333332,130801,0,131,0.76551757528808,40299110,5842357695,187186,187186,585098,772284,350198703.2499966,2901480.2833332545,131894,0,134,0.18635501965598367,4923681945,-1300,-1300,60517608.53333676,4818.650000077672,-1093,0,-3,0.5791625556320963,-4883382835,2209.5064275057475,1870.8594833480954,338.6469441576521,0.7036624597871813,0.704614661352879,-1093
1121,2020-01-27,2020,190857,190857,411122730.1499994,2934788.133333332,134994,0,213,0.7651016205850454,40143407,5852572994,192356,192356,606676,799032,350800658.41667265,2930261.1999997073,136064,0,215,0.18469598213838587,4940409076,-1499,-1499,60322071.73332673,4526.93333362462,-1070,0,-2,0.5804056384466595,-4900265669,2154.087773306713,1823.7053089930787,330.3824643136345,0.7073044216350461,0.7073551123957662,-1070
1122,2020-01-28,2020,193304,193304,411335320.4333335,2957893.5666666725,136068,0,163,0.7577287588461699,40119437,5861451915,194802,194802,625536,820338,351248959.7999976,2953356.8833332723,137014,0,162,0.18028300529781496,4945960724,-1498,-1498,60086360.63333589,4536.683333400171,-946,0,1,0.5774457535483549,-4905841287,2127.9193417277115,1803.1075646040474,324.8117771236641,0.703906799652361,0.703350068274453,-946
1123,2020-01-29,2020,194621,194621,411633020.6666676,2977062.149999999,138064,0,50,0.7609250800273357,39476710,5870117633,201913,201913,647440,849353,351814333.86666375,2978915.283333265,141573,0,50,0.17894091149380872,4956462050,-7292,-7292,59818686.80000383,-1853.133333266247,-3509,0,0,0.581984168533527,-4916985340,2115.0493557564064,1742.4055601504795,372.6437956059269,0.7093992940124653,0.701158419715422,-3509
1124,2020-01-30,2020,198789,198789,411843210.25000024,3025487.683333333,140945,0,53,0.7664709817947672,41123130,5875836277,200038,200038,670558,870596,349813320.36667114,3021406.699999611,142015,0,53,0.17674443714420085,4901515136,-1249,-1249,62029889.88332909,4080.9833337222226,-1070,0,0,0.5897265446505664,-4860392006,2071.7605614495783,1748.734342308317,323.0262191412612,0.7090181046234952,0.7099401113788381,-1070
1125,2020-01-31,2020,202022,202022,412495009.40000093,3046261.7833333327,142457,0,39,0.7663719792893839,41223656,5887436492,203342,203342,689477,892819,350651164.5166638,3040847.8666665666,143630,0,39,0.17542973435825224,4912569550,-1320,-1320,61843844.88333714,5413.916666766163,-1173,0,0,0.5909422449311317,-4871345894,2041.832124224099,1724.440423113099,317.391701111,0.7051558741127204,0.7063469425893323,-1173
1126,2020-02-01,2020,199429,199429,412819997.3333332,3029519.883333332,140272,0,38,0.7659217064719783,41557234,5896060634,200755,200755,279942,480697,351087785.4166746,3024400.4999997886,141575,0,39,0.3222861802757225,4871720771,-1326,-1326,61732211.91665858,5119.3833335433155,-1303,0,-1,0.44363552619625585,-4830163537,2070.0098648307576,1748.8370671548635,321.1727976758941,0.7033681159710975,0.7052128215984658,-1303
1127,2020-02-02,2020,198761,198761,412997092.9500004,3025328.683333336,139921,0,38,0.7667952968640728,41935157,5904426533,199945,199945,305259,505204,351411852.78334284,3020024.1833331594,141075,0,38,0.3049837293449727,4886462056,-1184,-1184,61585240.16665757,5304.500000176486,-1154,0,0,0.4618115675191001,-4844526899,2077.8577937824844,1757.5425881284496,320.3152056540348,0.703966069802426,0.705569031483658,-1154
1128,2020-02-03,2020,202193,202193,413472518.83333343,3052609.266666665,142583,0,37,0.7656496515705298,42140799,5917767012,203437,203437,328650,532087,352158348.7833427,3047975.366666535,143765,0,37,0.2945646106745704,4900903468,-1244,-1244,61314170.04999071,4633.900000130292,-1182,0,0,0.4710850408959594,-4858762669,2044.9398289423148,1731.0437569534683,313.8960719888464,0.7051826720015035,0.7066806923027767,-1182
1129,2020-02-04,2020,203690,203690,413926041.33333397,3040058.216666666,141588,0,41,0.753743433649174,41474410,5926243521,204983,204983,350530,555513,352825168.23334014,3035375.8499998692,142659,0,41,0.2795416128875527,4907551405,-1293,-1293,61100873.099993825,4682.366666796617,-1071,0,0,0.47420182076162126,-4866076995,2032.1372739620697,1721.2411186944291,310.89615526764055,0.6951151259266533,0.6959552743398233,-1071
1130,2020-02-05,2020,197606,197606,413946872.23333395,3006437.383333334,139984,0,38,0.7622086373895541,41112661,5933311629,198971,198971,379423,578394,353064297.7833394,3002329.5333331134,141195,0,38,0.26386857401702213,4919921023,-1365,-1365,60882574.449994564,4107.850000220351,-1211,0,0,0.498340063372532,-4878808362,2094.8092276212965,1774.4510395150016,320.35818810629485,0.7083995425240124,0.7096260259032723,-1211
1131,2020-02-06,2020,198283,198283,414264087.08333355,3010517.866666668,140143,0,60,0.763650943348648,41211943,5940577245,199498,199498,403424,602922,353648660.6666692,3005442.8333331756,141217,0,60,0.25396817498781527,4934869107,-1215,-1215,60615426.41666436,5075.033333492465,-1074,0,0,0.5096827683608327,-4893657164,2089.2567042224173,1772.6927621663835,316.56394205603374,0.7067827297347731,0.7078617329497038,-1074
1132,2020-02-07,2020,201894,201894,414734937.4333333,3024460.233333332,140516,0,43,0.7549803362160334,41621406,5950598787,203019,203019,426646,629665,354318889.86667407,3018749.1499998467,141626,0,43,0.24487147927866032,4950775815,-1125,-1125,60416047.56665921,5711.083333485294,-1110,0,0,0.5101088569373731,-4909154409,2054.2212122863148,1745.2499020617483,308.9713102245664,0.6959889843185038,0.697599732044784,-1110
1133,2020-02-08,2020,195645,195645,414577182.55000013,2932947.6499999985,135233,0,67,0.7463313654834014,40626858,5943141016,196721,196721,455861,652582,354432932.26666737,2928583.933333168,136195,0,67,0.2261631488456698,4962244572,-1076,-1076,60144250.283332765,4363.716666830704,-962,0,0,0.5201682166377316,-4921617714,2119.027741828312,1801.7035917195794,317.32415010873274,0.6912162334841166,0.6923256795156593,-962
1134,2020-02-09,2020,194545,194545,414684497.1166669,2958015.016666667,134960,0,37,0.7497802564959254,40111898,5948557250,230091,230091,483079,713170,354875690.0333346,2981217.883333266,150567,0,37,0.22713798953965836,4972758884,-35546,-35546,59808807.0833323,-23202.86666659871,-15607,0,0,0.522642266956267,-4932646986,2131.560806582883,1542.3275575026169,589.233249080266,0.6937212470122593,0.6543802234767984,-15607
1135,2020-02-10,2020,199458,199458,415361323.433334,3026135.3499999987,141059,0,55,0.7660108895105738,41751839,5963891344,217664,217664,507759,725423,348693570.2166601,3030695.899999637,150572,0,55,0.22453520221994636,4806945423,-18206,-18206,66667753.21667391,-4560.549999638461,-9513,0,0,0.5414756872906274,-4765193584,2082.450056820654,1601.980898157987,480.46915866266704,0.7072115432822951,0.6917634519259042,-9513
1136,2020-02-11,2020,199982,199982,416093386.41666573,3028258.2500000005,140667,0,81,0.7611985078657076,41267247,5977996263,211387,211387,526151,737538,348232168.83332586,3071620.8333329326,144697,0,82,0.21274700422215662,4781563858,-11405,-11405,67861217.58333987,-43362.58333293209,-4030,0,-1,0.548451503643551,-4740296611,2080.6541909605153,1647.367949936968,433.2862410235473,0.7033983058475263,0.6845122926196975,-4030
1137,2020-02-12,2020,202654,202654,416808058.3,3043946.0500000007,142453,0,53,0.7611396764929378,41370367,5990904894,209495,209495,550835,760330,348692582.5000021,3047761.2333332403,144540,0,53,0.20633277655754592,4793120020,-6841,-6841,68115475.79999793,-3815.183333239518,-2087,0,0,0.5548068999353919,-4751749653,2056.747255420569,1664.4434592711143,392.3037961494549,0.7029370256693674,0.6899448674192702,-2087
1138,2020-02-13,2020,205639,205639,417405589.1833332,3074936.083333334,144015,0,84,0.7581003603402078,42146497,6002431446,206765,206765,573556,780321,349014394.2166631,3070713.433333224,144962,0,83,0.20163240512558114,4801943475,-1126,-1126,68391194.9666701,4222.650000109803,-947,0,1,0.5564679552146267,-4759796978,2029.7977970294216,1687.9761768996839,341.82162012973777,0.7003292177067579,0.7010954465214132,-947
1139,2020-02-14,2020,205692,205692,418077036.38333344,3084761.58333333,145493,0,80,0.7674630029364296,42291888,6016132584,206893,206893,593099,799992,349941457.24999726,3080531.5833332343,146473,0,80,0.19914199141991284,4816461547,-1201,-1201,68135579.13333619,4230.000000095926,-980,0,0,0.5683210115165167,-4774169659,2032.539118601275,1691.412745960459,341.12637264081604,0.7073342667677888,0.7079649867322723,-980
1140,2020-02-15,2020,199251,199251,418095656.8833333,2998996.833333331,140911,0,126,0.7727941139567684,41115528,6021386876,200195,200195,619613,819808,350295380.54999673,2994735.499999956,141796,0,127,0.18947485264842004,4832378194,-944,-944,67800276.33333659,4261.333333374932,-885,0,-1,0.5833192613083484,-4791262666,2098.3365548144466,1749.7708761457416,348.565678668705,0.7072034770214453,0.7082894178176278,-885
1141,2020-02-16,2020,193153,193153,418161416.9666666,2958021.516666665,136123,0,38,0.7655589092584645,40308154,6027439488,193953,193953,648168,842121,350629922.5666713,2953718.7166662985,136849,0,38,0.17700900464422284,4852775084,-800,-800,67531494.39999527,4302.800000366755,-726,0,0,0.5885499046142416,-4812466930,2164.9232316695397,1807.8087091546474,357.1145225148923,0.70474183678224,0.7055781555325259,-726
1142,2020-02-17,2020,201125,201125,418753115.18333304,3032031.816666665,142935,0,43,0.7694319453076445,41079132,6039243290,201944,201944,670503,872447,351451095.0666707,3027696.96666635,143640,0,43,0.17877418341745688,4871718090,-819,-819,67302020.11666232,4334.85000031488,-705,0,0,0.5906577618901876,-4830638958,2082.054022042675,1740.3393765928708,341.71464544980427,0.7106774394033561,0.7112862971913005,-705
1143,2020-02-18,2020,212175,212175,419295558.20000035,3111365.716666665,149048,0,75,0.7623989631200653,41429939,6045478314,213326,213326,687600,900926,352266343.06665975,3107219.4666665853,149964,0,75,0.18130567882378965,4879596740,-1151,-1151,67029215.1333406,4146.250000079628,-916,0,0,0.5810932842962756,-4838166801,1976.1779578178407,1651.3052467428245,324.87271107501624,0.7024767291151173,0.702980414951764,-916
1144,2020-02-19,2020,216230,216230,419736356.66666675,3167568.566666666,152912,0,111,0.7699070434259822,42371019,6052835464,217369,217369,708214,925583,353046309.4666612,3162619.933333286,153882,0,111,0.1815860922251171,4893947574,-1139,-1139,66690047.20000553,4948.633333379868,-970,0,0,0.588320951200865,-4851576555,1941.1569008309057,1624.179664380207,316.9772364506987,0.7071729177264949,0.7079298336009274,-970
1145,2020-02-20,2020,214823,214823,420013769.96666616,3173893.349999996,151399,0,132,0.768009012070402,42548264,6058483637,215974,215974,731069,947043,353632421.84999657,3169521.299999955,152336,0,132,0.17576921005698848,4906584508,-1151,-1151,66381348.116669595,4372.050000040792,-937,0,0,0.5922398020134134,-4864036244,1955.1620169472828,1637.3842307407215,317.77778620656136,0.704761594428902,0.7053441617972533,-937
1146,2020-02-21,2020,221871,221871,420801003.8833333,3221342.733333336,155234,0,179,0.7716105304433662,43471033,6072995008,223052,223052,753418,976470,354663686.0833275,3216679.8833332583,156323,0,181,0.1770438415926735,4922177307,-1181,-1181,66137317.80000585,4662.850000077859,-1089,0,-2,0.5945666888506927,-4878706274,1896.60209708945,1590.0493431277346,306.5527539617153,0.699658810750391,0.7008365762243782,-1089
1147,2020-02-22,2020,216090,216090,421081622.9333333,3171622.316666667,151243,0,167,0.7697348327085933,43945744,6085163939,217128,217128,780176,997304,355121146.7833309,3167015.9833332086,152333,0,167,0.16851531729542954,4939218120,-1038,-1038,65960476.15000236,4606.333333458286,-1090,0,0,0.6012195154131638,-4895272376,1948.640024681074,1635.5382391185426,313.1017855625314,0.6999074459715859,0.7015815555801186,-1090
1148,2020-02-23,2020,218389,218389,421757853.3333336,3207678.016666666,153346,0,163,0.7751764054050342,44448586,6099783818,219445,219445,806608,1026053,355959401.1333295,3202746.9666665564,154425,0,163,0.16672822943844157,4958943987,-1056,-1056,65798452.2000041,4931.05000010971,-1079,0,0,0.6084481759665926,-4914495401,1931.2229706319165,1622.0893669636105,309.133603668306,0.70216906529175,0.7037070792225842,-1079
1149,2020-02-24,2020,226575,226575,422804373.583333,3294092.399999996,160717,0,103,0.7761712457243748,43934646,6115810367,227826,227826,825775,1053601,357233143.91666335,3289192.1999999015,161832,0,103,0.1686739097628028,4978839824,-1251,-1251,65571229.66666967,4900.2000000947155,-1115,0,0,0.607497335961572,-4934905178,1866.0680727500078,1568.0086729199625,298.0593998300453,0.7093324506234139,0.7103315688288431,-1115
1150,2020-02-25,2020,226624,226624,423568316.1166676,3312090.9333333317,161068,0,64,0.7766873764473312,43645414,6129940446,235462,235462,845013,1080475,358215529.70000374,3333849.9833332542,165234,0,63,0.16761887132973902,4991270314,-8838,-8838,65352786.416663885,-21759.049999922514,-4166,0,1,0.6090685051175921,-4947624900,1869.0355660330222,1521.330531890512,347.70503414251016,0.7107279017226772,0.7017438057945655,-4166
1151,2020-02-26,2020,204530,204530,423568331.13333344,3233591.3166666673,157185,0,227,0.8301520559331155,42123153,6134785548,205840,205840,878048,1083888,358125518.3333313,3229259.266666527,158231,0,227,0.15809936081956977,5001569469,-1310,-1310,65442812.80000216,4332.050000140443,-1046,0,0,0.6720526951135457,-4959446316,2070.9349784057763,1739.824710130836,331.1102682749404,0.7685180658094167,0.7687087057909056,-1046
1152,2020-02-27,2020,205281,205281,423404419.6166662,3240539.9666666663,158077,0,345,0.8366775298249708,43093599,6139913558,206287,206285,881705,1087992,358090109.9999992,3236317.3833332337,158941,0,349,0.15910594930845046,5012368541,-1006,-1004,65314309.61666697,4222.583333432674,-864,0,-4,0.6775715805165203,-4969274942,2062.560196105174,1735.8998957752585,326.66030032991534,0.7700517826783775,0.7704848099977216,-864
1153,2020-02-28,2020,208899,208899,424057679.64999974,3307668.2000000007,163376,0,43,0.8511577365138177,43298259,6149971320,209981,209981,887074,1097055,358913060.24999785,3302743.3833332323,164339,0,43,0.16352963160461437,5025550312,-1082,-1082,65144619.40000188,4924.816666768398,-963,0,0,0.6876281049092032,-4982252053,2029.965101077553,1709.2644584509924,320.7006426265607,0.7820812928735896,0.7826374767240846,-963
1154,2020-02-29,2020,205971,205971,423657916.1333337,3291654.8666666658,160971,0,49,0.8566982730578573,43252199,6151186720,207126,207126,894913,1102039,358888256.3333301,3286821.1166665503,161987,0,49,0.16152695140552864,5038798038,-1155,-1155,64769659.80000359,4833.750000115484,-1016,0,0,0.6951713216523286,-4995545839,2056.8813868619063,1732.7050024300672,324.1763844318391,0.7815226415369154,0.782069851201684,-1016
1155,2020-03-01,2020,205649,205649,424093898.41666627,3277032.616666668,160357,0,199,0.8543148763183865,42672311,6161119724,206828,206827,245216,452044,359620641.1166776,3272170.249999837,161496,0,199,0.3928843209953014,5015640726,-1179,-1178,64473257.29998869,4862.366666831076,-1139,0,0,0.46143055532308513,-4972968415,2062.222030822743,1738.7509421723353,323.47108865040764,0.7797606601539516,0.7808227125921056,-1139
1156,2020-03-02,2020,207812,207812,424742261.516667,3296776.1666666674,161550,0,283,0.8482570785132719,42953786,6174013229,209179,209179,257809,466988,360428094.4833455,3291821.133333197,162736,0,283,0.3816222258387752,5029360183,-1367,-1367,64314167.0333215,4955.033333470579,-1186,0,0,0.4666348526744967,-4986406397,2043.8774542214453,1723.0606059085544,320.8168483128909,0.7773853290474082,0.7779748445111603,-1186
1157,2020-03-03,2020,208502,208502,424971562.8999995,3299660.983333332,162338,0,248,0.8484427007894411,43107949,6176299864,209699,209699,265349,475048,360979423.23334014,3294680.6166665293,163365,0,248,0.3758883312844151,5044498273,-1197,-1197,63992139.666659355,4980.366666802671,-1027,0,0,0.47255436950502594,-5001390324,2038.2133643801953,1721.416998809437,316.7963655707583,0.7785920518748022,0.7790452028860414,-1027
1158,2020-03-04,2020,204781,204781,424968850.85000014,3286717.383333336,159841,0,271,0.8483794883314358,43062110,6179786010,206075,206075,277787,483862,361359699.61667395,3281913.3999998644,160947,0,271,0.36277492342857803,5057951693,-1294,-1294,63609151.2333262,4803.983333471697,-1106,0,0,0.4856045649028578,-5014889583,2075.235743794591,1753.5348762182407,321.70086757635045,0.7805460467523843,0.7810117675603543,-1106
1159,2020-03-05,2020,213042,213042,425440104.9166668,3308019.116666667,164616,0,191,0.837013358868204,43069705,6190048701,214462,214462,287505,501967,362059050.1000113,3303150.849999889,165821,0,191,0.3591869585052499,5076316111,-1420,-1420,63381054.81665552,4868.266666778363,-1205,0,0,0.47782640036295415,-5033246406,1996.9776143514744,1688.2200580989233,308.757556252551,0.772692708480018,0.7731952513732037,-1205
1160,2020-03-06,2020,219629,219629,425457837.38333374,3384937.0333333383,169311,0,172,0.839816235560878,43917689,6193137799,220989,220989,296876,517865,362367214.5166856,3379930.8999998495,170445,0,172,0.3597443349135445,5088927120,-1360,-1360,63090622.86664814,5006.133333488833,-1134,0,0,0.4800719006473335,-5045009431,1937.166027179169,1639.7522705505053,297.4137566286638,0.7708954646244348,0.7712827335297232,-1134
1161,2020-03-07,2020,214999,214999,425550219.78333306,3386994.8166666636,165378,0,93,0.8396829752696522,43696572,6200204574,216901,216901,306776,523677,362696771.1166756,3382478.333333197,166705,0,96,0.34883716489362865,5104920225,-1902,-1902,62853448.66665745,4516.483333466575,-1327,0,-3,0.49084581037602354,-5061223653,1979.3125539343582,1672.1765741821182,307.13597975224,0.7692035776910591,0.7685764473192839,-1327
1162,2020-03-08,2020,211294,211294,425678040.14999974,3359789.2666666703,164188,0,47,0.8472128882031672,43755203,6206199457,212610,212610,321195,533805,363082986.9833416,3354976.9499998596,165345,0,47,0.3389739698953735,5123825366,-1316,-1316,62595053.16665816,4812.316666810773,-1157,0,0,0.5082389183077938,-5080070163,2014.624362972918,1707.741813571053,306.88254940186516,0.7770594527057086,0.777691547904614,-1157
1163,2020-03-09,2020,214515,214515,426756382.95000035,3385891.5333333327,167850,0,77,0.8505465818241154,43520237,6226129901,215872,215872,329242,545114,364278382.88334596,3381135.3666665107,169065,0,77,0.338496167774074,5139163871,-1357,-1357,62478000.066654384,4756.166666822042,-1215,0,0,0.5120504140500414,-5095643634,1989.401127893156,1687.473979410697,301.92714848245896,0.7824627648416195,0.7831724355173436,-1215
1164,2020-03-10,2020,213269,213269,426995182.3666666,3380365.8166666673,167418,0,238,0.8542357304624678,43218012,6232134297,229509,229509,338153,567662,364746552.4500048,3400914.7166665234,174638,0,239,0.33518361278366726,5149401728,-16240,-16240,62248629.9166618,-20548.899999856018,-7220,0,-1,0.5190521176788006,-5106183716,2002.1436887999034,1589.2472733095644,412.896415490339,0.7850086041571912,0.7609200510655355,-7220
1165,2020-03-11,2020,220883,220883,427635722.08333325,3432303.4333333345,172078,0,238,0.8474758129869664,43926417,6243004996,226080,226080,347902,573982,360549862.8333477,3428534.3499998776,174868,0,238,0.33209926443686166,5040582239,-5197,-5197,67085859.249985576,3769.083333456889,-2790,0,0,0.5153765485501047,-4996655822,1936.0282234637036,1594.788848342833,341.2393751208706,0.7790459202383162,0.773478414720453,-2790
1166,2020-03-12,2020,221885,221885,428031356.88333356,3466092.116666664,172008,0,164,0.845280212722807,44161124,6251927783,223414,223414,355335,578749,360787828.0000134,3463409.9999997793,173264,0,164,0.32748393517742413,5036578746,-1529,-1529,67243528.88332015,2682.116666884627,-1256,0,0,0.5177962775453828,-4992417622,1929.0684673742414,1614.8845998908457,314.1838674833957,0.7752123847939247,0.7755288388373155,-1256
1167,2020-03-13,2020,221509,221509,428196419.2666671,3433739.8166666673,171177,0,150,0.8418077820765751,43286834,6256371757,222817,222817,364937,587754,361252941.4500138,3429750.1166664935,172243,0,152,0.32054396907549765,5055727235,-1308,-1308,66943477.81665331,3989.700000173878,-1066,0,-2,0.5212638130010775,-5012440401,1933.088133063068,1621.2988302060157,311.78930285705223,0.7727767269050017,0.7730244999259482,-1066
1168,2020-03-14,2020,214980,214980,428133154.4500003,3400874.316666671,168642,0,236,0.8574658107730955,42925434,6259798194,216521,216521,380480,597001,361506488.76667935,3397652.0666665225,169997,0,236,0.31225575836556396,5074788136,-1541,-1541,66626665.68332094,3222.250000148546,-1355,0,0,0.5452100524075315,-5031862702,1991.50225346544,1669.6139809380122,321.8882725274277,0.7844543678481719,0.7851293869878673,-1355
1169,2020-03-15,2020,215667,215667,428382652.3833332,3404546.1333333324,166867,0,64,0.8468425860238237,43084204,6269208483,217201,217201,389388,606589,361771138.01667476,3400315.566666479,168275,0,64,0.30512587600500335,5086207859,-1534,-1534,66611514.36665845,4230.5666668531485,-1408,0,0,0.5417167100188203,-5043123655,1986.315256313359,1665.6053057613674,320.7099505519916,0.7737252338095304,0.7747432102062145,-1408
1170,2020-03-16,2020,225420,225420,429060705.2833335,3478068.4833333343,171716,0,94,0.8307204329695687,43322469,6280878400,226947,226947,397520,624467,362629444.30001247,3472658.5166664473,173036,0,94,0.3033995391269696,5106626777,-1527,-1527,66431260.98332101,5409.966666887049,-1320,0,0,0.5273208938425991,-5063304308,1903.3834854198096,1597.8596073092506,305.52387811055905,0.7617602697187472,0.7624511449809868,-1320
1171,2020-03-17,2020,229346,229346,429475411.3833331,3551813.3999999994,174766,0,202,0.8392559713271656,44038072,6284935773,231718,231718,402469,634187,363312514.61667156,3547580.2666661856,176264,0,202,0.30733048769526744,5117514960,-2372,-2372,66162896.766661525,4233.133333813865,-1498,0,0,0.5319254836318981,-5073476888,1872.6091206444983,1567.9080374276991,304.70108321679913,0.7620189582552126,0.760683244288316,-1498
1172,2020-03-18,2020,227723,227723,430183877.9833335,3527533.0499999938,172033,0,186,0.8277863896049149,43994151,6297835839,229216,229216,413667,642883,364179620.6500095,3522385.0333331465,173364,0,186,0.29695294478154893,5132249220,-1493,-1493,66004257.333324015,5148.016666847281,-1331,0,0,0.530833444823366,-5088255069,1889.0664446864548,1588.8054090901574,300.26103559629746,0.7554485054210598,0.756334636325562,-1331
1173,2020-03-19,2020,221284,221284,429988251.15,3456913.4500000016,170064,0,191,0.8401104463042971,42908648,6298559045,222591,222591,428632,651223,364256380.01668096,3451674.0833331794,171167,0,191,0.28808411250830745,5144244851,-1307,-1307,65731871.13331902,5239.366666822229,-1103,0,0,0.5520263337959896,-5101336203,1943.1511141790638,1636.4380411457828,306.71307303328103,0.7685327452504473,0.768975385348015,-1103
1174,2020-03-20,2020,225462,225462,430281513.43333375,3496923.2166666607,171902,0,207,0.8347082878711277,43165633,6305315140,226945,226945,438040,664985,364753951.9500096,3491819.399999855,173116,0,207,0.2861147243922825,5158770202,-1483,-1483,65527561.48332417,5103.816666805651,-1214,0,0,0.5485935634788452,-5115604569,1908.443611044583,1607.2350214810178,301.20858956356506,0.7624433385670313,0.7628103725572275,-1214
1175,2020-03-21,2020,222560,222560,430344972.5999997,3478404.499999998,169580,0,143,0.8320767433501077,42582943,6307417269,223797,223797,446548,670345,365123984.60000527,3473299.183333167,170690,0,146,0.2788250826067166,5170822120,-1237,-1237,65220987.99999446,5105.316666831262,-1110,0,-3,0.553251660743391,-5128239177,1933.6132845075474,1631.4963319437047,302.1169525638427,0.7619518332135155,0.7627001255602175,-1110
1176,2020-03-22,2020,221351,221351,430431938.26666665,3458259.483333338,167023,0,239,0.8276673699237862,43292360,6312113257,229191,229191,456966,686157,365418856.05000776,3461507.099999861,170232,0,239,0.2732013227293394,5191935768,-7840,-7840,65013082.21665889,-3247.6166665228084,-3209,0,0,0.5544660471944468,-5148643408,1944.5673986865506,1594.385713444279,350.18168524227167,0.75456175937764,0.7427516787308402,-3209
1177,2020-03-23,2020,226199,226199,430996729.84999937,3486567.866666665,169193,0,242,0.8187038846325582,43563061,6325873136,230632,230632,468551,699183,364130834.61668164,3483378.0999998357,171327,0,244,0.268909570169764,5159027267,-4433,-4433,66865895.23331773,3189.7666668291204,-2134,0,-2,0.5497943144627941,-5115464206,1905.387423684452,1578.8391663632178,326.54825732123413,0.7479829707469972,0.742858753338652,-2134
1178,2020-03-24,2020,228913,228913,431498702.9999995,3513545.8999999934,170064,0,207,0.8155500124501442,43525040,6334996268,230258,230258,478741,708999,364272420.5500118,3508014.8166664606,171276,0,207,0.2662274558920394,5150437954,-1345,-1345,67226282.44998771,5531.083333532792,-1212,0,0,0.5493225565581048,-5106912914,1884.9899437777651,1582.0185207463446,302.9714230314205,0.742919799225033,0.7438438621025111,-1212
1179,2020-03-25,2020,226038,226038,431593073.19999945,3501574.349999994,171003,0,216,0.8276572965607558,43288015,6340405254,227236,227236,487660,714896,364634556.4333408,3496409.249999579,172119,0,216,0.26406078646405634,5166043780,-1198,-1198,66958516.766658664,5165.100000414997,-1116,0,0,0.5635965100966995,-5122755765,1909.3828170484585,1604.65135996647,304.73145708198854,0.7565232394553129,0.7574460032741291,-1116
1180,2020-03-26,2020,221587,221587,431940504.0833329,3456197.2333333306,168884,0,138,0.8329414631724777,43786851,6349583638,222603,222603,499792,722395,365224771.93333,3450458.766666628,169794,0,137,0.2572581482429986,5180819665,-1016,-1016,66715732.1500029,5738.466666702647,-910,0,1,0.5756833149294791,-5137032814,1949.3043548734036,1640.7001340203412,308.6042208530623,0.7621566247117385,0.7627660004582149,-910
1181,2020-03-27,2020,218560,218560,431994912.15000004,3414813.1500000013,166768,0,174,0.8359672401171299,43680280,6355835103,219935,219935,512918,732853,365492547.6500131,3409069.8999995594,168059,0,174,0.2518636070262386,5195406523,-1375,-1375,66502364.49998695,5743.250000441913,-1291,0,0,0.5841036330908913,-5151726243,1976.55065954429,1661.820754541174,314.7299050031161,0.7630307467057101,0.7641303112283174,-1291
1182,2020-03-28,2020,215719,215719,431831280.13333327,3408104.699999996,164813,0,150,0.8378214250946836,43361241,6359156725,216942,216942,525583,742525,365653136.1666771,3403411.1999996547,166007,0,151,0.24583010673040742,5211484024,-1223,-1223,66178143.96665615,4693.50000034133,-1194,0,-1,0.5919913183642762,-5168122783,2001.823113093113,1685.4879929505448,316.33512014256826,0.7640170777724725,0.7652137437656148,-1194
1183,2020-03-29,2020,219109,219109,432019413.88333285,3425101.883333336,167246,0,148,0.8389659940942633,43261423,6365682673,220522,220522,533560,754082,366062052.1499962,3419772.7666666266,168561,0,151,0.24624642943340422,5224832039,-1413,-1413,65957361.73333663,5329.116666709539,-1315,0,-3,0.5927195646608591,-5181570616,1971.7100341991102,1659.9797396631457,311.7302945359645,0.7633004577630312,0.7643727156474184,-1315
1184,2020-03-30,2020,225336,225336,432833732.2166669,3503881.7333333315,170428,0,133,0.8309724145276386,43723718,6377277623,226860,226860,539490,766350,367039240.149995,3499823.099999919,171809,0,133,0.24688458276244532,5243207116,-1524,-1524,65794492.06667185,4058.6333334124647,-1381,0,0,0.5840878317651933,-5199483398,1920.8370265588583,1617.9107826412546,302.92624391760364,0.7563283274754145,0.7573349202151106,-1381
1185,2020-03-31,2020,229010,229010,433412781.9666665,3488810.65,170981,0,221,0.8220427055587092,43566516,6386282693,230328,230328,546091,776419,367861545.3166616,3484543.7833333053,172179,0,221,0.2446913329014352,5253090356,-1318,-1318,65551236.65000492,4266.866666694637,-1198,0,0,0.577351372657274,-5209523840,1892.5495915753309,1597.1203905589489,295.42920101638197,0.7466093183703768,0.7475382932166302,-1198
1186,2020-04-01,2020,219005,219005,433378673.6000001,3434562.5833333354,167997,0,248,0.8432775507408493,43292066,6391199123,220566,220566,279030,499596,368116615.5166832,3429992.2666664557,169473,0,248,0.3737059544111658,5200883192,-1561,-1561,65262058.08331686,4570.316666879691,-1476,0,0,0.46957159632968354,-5157591126,1978.8528736786834,1668.963555201995,309.88931847668846,0.7670920755233899,0.768355050189059,-1476
1187,2020-04-02,2020,219417,219417,433831710.6999999,3463224.3333333326,167171,0,260,0.8365851324190928,43524212,6398926932,221134,221134,287684,508818,368765483.8833487,3459057.683333155,168697,0,260,0.3650892853633327,5215459580,-1717,-1717,65066226.816651225,4166.6500001777895,-1526,0,0,0.47149584705576014,-5171935368,1977.2019064156375,1667.6109683872617,309.59093802837583,0.7618871828527416,0.7628722855824975,-1526
1188,2020-04-03,2020,218380,218380,434391945.5166663,3418525.4500000007,166787,0,57,0.8341285832035904,43832256,6411388578,219960,219960,297071,517031,369460721.466681,3412783.833333164,168235,0,57,0.3561604623320418,5232090735,-1580,-1580,64931224.04998529,5741.616666836664,-1448,0,0,0.4779681208715486,-5188258479,1989.1562666758234,1679.672310723227,309.4839559525965,0.7637466800989101,0.7648436079287143,-1448
1189,2020-04-04,2020,207439,207439,434312389.8499998,3345209.0999999978,161456,0,59,0.8470441913044313,42752179,6415211948,208699,208699,313607,522306,369629265.7666805,3340466.883333177,162697,0,59,0.3395231913858967,5245542363,-1260,-1260,64683124.08331931,4742.216666820925,-1241,0,0,0.5075209999185346,-5202790184,2093.6872519150197,1771.111820213228,322.5754317017918,0.7783300150887731,0.7795772859477046,-1241
1190,2020-04-05,2020,213607,213607,434657674.83333355,3431138.266666663,164361,0,59,0.8404125332971303,44024288,6423381408,214836,214836,321431,536267,370143473.68334115,3425022.849999818,165545,0,59,0.33767134654938674,5266434737,-1229,-1229,64514201.14999241,6115.41666684486,-1184,0,0,0.5027411867477436,-5222410449,2034.8475229432254,1722.9117730889661,311.93574985425926,0.769455120852781,0.7705645236366344,-1184
1191,2020-04-06,2020,223763,223763,435800868.9666665,3516291.716666668,170299,0,62,0.829703749055921,44100897,6439411633,230188,230188,324632,554820,371458420.78334737,3523005.433333156,173125,0,62,0.34072672218016714,5283490697,-6425,-6425,64342448.18331915,-6713.716666487977,-2826,0,0,0.4889770268757539,-5239389800,1947.6002241955396,1613.7175733893487,333.8826508061909,0.7610686306493925,0.7521026291552991,-2826
1192,2020-04-07,2020,228798,228798,436174503.1833341,3526978.283333334,169563,0,49,0.7983985874002396,43931081,6449351569,229777,229777,336929,566706,371558512.9666778,3521845.0666665277,170654,0,49,0.3250362621888632,5283372871,-979,-979,64615990.21665633,5133.216666806489,-1091,0,0,0.4733623252113764,-5239441790,1906.373758439034,1617.0396208788425,289.3341375601915,0.7411035061495292,0.7426940033162588,-1091
1193,2020-04-08,2020,224758,224758,436175760.19999987,3532157.316666669,168064,0,73,0.8033262442271242,44147730,6460662985,225878,225878,343494,569372,371697601.9333433,3527524.199999819,169261,0,73,0.320214200909068,5303344488,-1120,-1120,64478158.26665658,4633.116666850168,-1197,0,0,0.4831120433180562,-5259196758,1940.6462070315622,1645.5679700251608,295.0782370064014,0.7477553635465701,0.749346992624337,-1197
1194,2020-04-09,2020,221781,221781,436460097.916667,3484012.5166666643,166298,0,77,0.804893115280389,43245681,6468450681,222841,222841,356950,579791,372207035.31668127,3479343.033333103,167469,0,77,0.3105343132266585,5315614671,-1060,-1060,64253062.59998572,4669.483333561104,-1171,0,0,0.4943588020537305,-5272368990,1967.9778606673565,1670.2807621428788,297.6970985244777,0.7498297870421722,0.7515178984118721,-1171
1195,2020-04-10,2020,222712,222712,437119519.35000014,3475678.4333333364,166942,0,74,0.8098306332842417,44360298,6483392148,223750,223750,369668,593418,372965606.6666759,3471724.3666664776,168037,0,75,0.30647705327441355,5335822614,-1038,-1038,64153912.68332422,3954.0666668587364,-1095,0,-1,0.5033535800098281,-5291462316,1962.712019783398,1666.8853929236914,295.8266268597067,0.7495869104493695,0.7510033519553072,-1095
1196,2020-04-11,2020,223734,223734,437463503.8666662,3480141.6999999997,168003,0,96,0.8116245184013151,44208137,6492637301,224870,224870,380524,605394,373437884.80001223,3476042.633333113,169175,0,95,0.302531904842142,5352143314,-1136,-1136,64025619.06665397,4099.066666886676,-1172,0,1,0.5090926135591731,-5307935177,1955.2839705483575,1660.6834384311478,294.6005321172097,0.7509050926546703,0.7523235647262863,-1172
1197,2020-04-12,2020,217484,217484,437823916.3999993,3419996.549999998,161789,0,149,0.8037740707362379,44412342,6506711398,218395,218395,396771,615166,373903763.36667675,3415450.983333172,162855,0,149,0.28649015062600847,5371103419,-911,-911,63920153.03332257,4545.56666682614,-1066,0,0,0.5172839201102294,-5326691077,2013.1316161188838,1712.052763875898,301.0788522429857,0.7439121958396939,0.7456901485839877,-1066
1198,2020-04-13,2020,230219,230219,438843572.2833336,3552620.3666666676,170813,0,227,0.8060889848361777,44858922,6523392152,231146,231146,405388,636534,375075070.1333438,3548181.766666511,171856,0,227,0.2939827251961533,5393673400,-927,-927,63768502.149989784,4438.600000156555,-1043,0,0,0.5121062596400244,-5348814478,1906.2004972801271,1622.6760148708775,283.5244824092497,0.7419587436310643,0.7434954530902547,-1043
1199,2020-04-14,2020,234460,234460,439623527.45000046,3634744.8000000026,174065,0,148,0.8011771730785634,45078918,6534345522,238213,238212,409636,647849,376024117.2166778,3631532.849999795,175621,0,148,0.29318714700492615,5405345881,-3753,-3752,63599410.23332268,3211.9500002074055,-1556,0,0,0.5079900260736372,-5360266963,1875.0470333958904,1578.5271825797097,296.5198508161807,0.7424080866672353,0.7372435593355526,-1556
1200,2020-04-15,2020,238544,238544,440608315.95,3661743.2166666617,175251,0,96,0.7950273324837348,45301960,6548156751,239447,239447,417448,656895,377095137.6000018,3657311.549999529,176191,0,96,0.29073748468173133,5417169210,-903,-903,63513178.349998176,4431.666667132638,-940,0,0,0.5042898478020035,-5371867250,1847.0735627389495,1574.85847640606,272.21508633288954,0.7346694949359447,0.7358246292498967,-940
1201,2020-04-16,2020,236171,236171,440676525.5666667,3608583.3500000034,173198,0,190,0.7942253706001161,44263955,6554949170,239181,239181,429110,668291,377443089.0500176,3607862.4833331117,174857,0,190,0.2838075030188939,5430935177,-3010,-3010,63233436.51664913,720.8666668916121,-1659,0,0,0.5104178675812222,-5386671222,1865.9214110397413,1578.064683440648,287.85672759909335,0.733358456372713,0.7310655946751623,-1659
1202,2020-04-17,2020,232406,232406,441252812.4833333,3558940.5666666673,173426,0,199,0.8027976902489609,44269306,6567089794,240966,240966,446258,687224,378227570.7166855,3563722.7833331516,177068,0,199,0.27726912913401985,5448448212,-8560,-8560,63025241.766647816,-4782.216666484252,-3642,0,0,0.525528561114941,-5404178906,1898.6291768858518,1569.6304487632508,328.99872812260105,0.7462199771090248,0.7348256600516255,-3642
1203,2020-04-18,2020,226049,226049,441230340.0166666,3555227.916666664,169587,0,225,0.811315245809537,45047939,6568684191,226990,226990,464236,691226,377022503.4666773,3552316.7333331886,170536,0,227,0.26710656138513866,5414955677,-941,-941,64207836.54998928,2911.1833334756084,-949,0,-2,0.5442086844243983,-5369907738,1951.9234326038452,1660.9652560318839,290.9581765719613,0.7502222969356201,0.7512930085025772,-949
1204,2020-04-19,2020,224848,224848,441712968.61666673,3530269.65,168850,0,205,0.8134295168291474,44869385,6581023062,225756,225756,467179,692935,377674628.11667544,3527239.366666463,169860,0,205,0.26574931270609203,5434935693,-908,-908,64038340.4999913,3030.283333536703,-1010,0,0,0.5476802041230554,-5390066308,1964.4958755099744,1672.9328483702557,291.56302713971877,0.7509517540738633,0.7524052516876628,-1010
1205,2020-04-20,2020,224347,224347,442202660.2999998,3499759.5666666743,168230,0,183,0.8085510392383225,44388648,6592839149,225308,225308,480305,705613,378329976.0000142,3494258.0166664748,169242,0,183,0.25895639677840776,5453347789,-961,-961,63872684.29998559,5501.550000199582,-1012,0,0,0.5495946424599147,-5408959141,1971.0656273540533,1679.167965629335,291.8976617247183,0.7498651642321938,0.7511584142595913,-1012
1206,2020-04-21,2020,218004,218004,442182528.1166671,3452548.7500000033,165734,0,185,0.8181547127575647,44605012,6598600294,219068,219068,490449,709517,378594044.2000133,3450943.1999998237,166774,0,185,0.25343437859840057,5460539895,-1064,-1064,63588483.91665381,1605.550000179559,-1040,0,0,0.5647203341591641,-5415934883,2028.323003782807,1728.2033167784125,300.11968700439456,0.7602337571787674,0.7612887322657805,-1040
1207,2020-04-22,2020,222062,222062,442636207.7333333,3484831.9000000022,168386,0,73,0.8151552269186084,44402583,6609333597,223055,223055,500114,723169,379267956.249995,3482200.1166665857,169392,0,73,0.2521139595309008,5476369597,-993,-993,63368251.4833383,2631.7833334165625,-1006,0,0,0.5630412673877077,-5431967014,1993.3001041751102,1700.3338022012283,292.96630197388185,0.7582837225639686,0.7594180807424178,-1006
1208,2020-04-23,2020,222214,222214,442629289.0833328,3528019.8833333347,169373,0,76,0.8171402341886645,44488699,6612702688,223297,223297,507235,730532,379526807.6500106,3526597.233332961,170406,0,77,0.2505051113435138,5488753080,-1083,-1083,63102481.43332219,1422.6500003738329,-1033,0,-1,0.5666351228451507,-5444264381,1991.9055013785485,1699.6502758658226,292.25522551272593,0.762206701647961,0.7631360922896412,-1033
1209,2020-04-24,2020,229340,229340,443157013.7833331,3545092.3166666646,172018,0,59,0.8043690590389811,45052979,6621587059,230475,230475,514694,745169,380270138.74999696,3542788.9666665588,173140,0,60,0.24950850075620298,5499796477,-1135,-1135,62886875.03333616,2303.3500001057982,-1122,0,-1,0.5548605582827781,-5454743498,1932.3145277026822,1649.940942618492,282.37358508419015,0.7500566843987093,0.7512311530534765,-1122
1210,2020-04-25,2020,230542,230542,442989313.38333315,3596235.516666668,172499,0,84,0.8077400213410136,45414221,6623862148,231652,231652,525788,757440,380320821.34999835,3592680.366666572,173639,0,84,0.24781896915927365,5516225668,-1110,-1110,62668492.03333479,3555.150000095833,-1140,0,0,0.5599210521817399,-5470811447,1921.512407211411,1641.7765499542345,279.7358572571766,0.7482324261956607,0.7495683179942327,-1140
1211,2020-04-26,2020,234519,234519,444007524.2833335,3665820.3666666676,174275,0,89,0.8032654070672315,45730790,6639394751,235668,235668,531517,767185,381525499.1499953,3661132.03333326,175519,0,89,0.24778638789861868,5536846360,-1149,-1149,62482025.13333815,4688.333333407529,-1244,0,0,0.5554790191686128,-5491115570,1893.2688792095032,1618.9109219325294,274.3579572769738,0.7431167623945182,0.7447723068044877,-1244
1212,2020-04-27,2020,243117,243117,445199961.4499998,3722544.849999998,179142,0,114,0.802177552371903,46238372,6656040616,244199,244199,538155,782354,382889917.71666276,3718001.216666528,180293,0,114,0.25138236655017876,5557866963,-1082,-1082,62310043.733337045,4543.633333470207,-1151,0,0,0.5507951858217243,-5511628591,1831.2169097594976,1567.9422017152517,263.2747080442459,0.7368550944606918,0.738303596656825,-1151
1213,2020-04-28,2020,233124,233124,445694258.45,3652505.450000005,175405,0,101,0.8092731765069225,45543523,6666749502,234336,234336,552664,787000,383555244.1333489,3647010.316666232,176640,0,101,0.24186658195679425,5564592320,-1212,-1212,62139014.316651106,5495.1333337728865,-1235,0,0,0.5674065945501283,-5519048797,1911.8334382131397,1636.7747342847401,275.0587039283996,0.7524107342015408,0.7537894305612454,-1235
1214,2020-04-29,2020,238328,238328,446310263.7166663,3685867.966666667,177876,0,77,0.8015340203417134,45907270,6676642083,239437,239437,561353,800790,384368285.9666617,3681145.9833332044,179075,0,77,0.2406061514254639,5582215306,-1109,-1109,61941977.75000459,4721.983333462384,-1199,0,0,0.5609278689162495,-5536308036,1872.6723830882913,1605.3002917955941,267.3720912926972,0.7463495686616763,0.7479002827466098,-1199
1215,2020-04-30,2020,238502,238502,446918945.4333337,3674055.8666666676,179448,0,48,0.80876051353867,46024345,6686527603,240805,240805,570810,811615,385156501.2166741,3670201.7499995925,180884,0,48,0.24026293254807105,5601783257,-2303,-2303,61762444.216659606,3854.1166670750827,-1436,0,0,0.5684975809905989,-5555758912,1873.8582713492285,1599.4539200459878,274.4043513032407,0.752396206321121,0.7511638047382737,-1436
1216,2020-05-01,2020,223479,223479,446615420.7499998,3521091.816666668,169839,0,61,0.8141973071295292,45204472,6693220069,225149,225149,265460,490609,385089091.88334316,3516389.749999841,171375,0,61,0.3751847193997658,5565917741,-1670,-1670,61526328.86665666,4702.066666826606,-1536,0,0,0.4390125877297634,-5520713269,1998.467062900764,1710.3744270831457,288.0926358176182,0.759977447545407,0.7611626078730085,-1536
1217,2020-05-02,2020,210757,210757,446305166.7499999,3456441.4666666626,164071,0,50,0.8276545974748174,44407249,6696702421,211966,211966,282875,494841,384991823.8833388,3451609.133333168,165207,0,50,0.35556471674740564,5582000573,-1209,-1209,61313342.86666107,4832.333333494607,-1136,0,0,0.47208988072741176,-5537593324,2117.629149921473,1816.2904611274394,301.3386887940337,0.7784842259094598,0.7794033005293302,-1136
1218,2020-05-03,2020,213841,213841,446603343.5333332,3446957.0833333326,164811,0,99,0.819117942770562,44864848,6704154669,214846,214846,292249,507095,385521222.233348,3442732.68333318,165978,0,99,0.34854810242656276,5602875256,-1005,-1005,61082121.29998517,4224.400000152644,-1167,0,0,0.4705698403439993,-5558010408,2088.4832353633456,1794.4072602391852,294.0759751241603,0.7707174957094289,0.7725440548113532,-1167
1219,2020-05-04,2020,219569,219569,447648188.9333332,3512972.333333333,168150,0,149,0.8155613952789326,45011623,6722372167,220675,220675,301276,521951,386686385.2000091,3508424.649999841,169350,0,150,0.3463965008209622,5618075825,-1106,-1106,60961803.73332411,4547.6833334919065,-1200,0,-1,0.4691648944579704,-5573064202,2038.7586086074684,1752.2890458819943,286.46956272547413,0.7658184898596796,0.7674181488614479,-1200
1220,2020-05-05,2020,220954,220954,448365414.016667,3529026.583333335,169282,0,199,0.8204648931451796,45171868,6734864328,222040,222040,308177,530217,387609775.8833406,3524771.3833331903,170496,0,201,0.34519074265819566,5630229644,-1086,-1086,60755638.13332641,4255.200000144541,-1214,0,-2,0.4752741504869839,-5585057776,2029.225151011826,1745.6754453402116,283.54970567161445,0.7661413687916941,0.7678616465501712,-1214
1221,2020-05-06,2020,224600,224600,448937803.9166662,3537599.9666666687,169905,0,123,0.8108771148708817,45644610,6742645952,225889,225889,318620,544509,388361994.4333434,3532911.0499998415,171305,0,123,0.3380403262388627,5649386766,-1289,-1289,60575809.4833228,4688.916666827165,-1400,0,0,0.47283678863201895,-5603742156,1998.8326087117819,1719.260320039238,279.5722886725439,0.7564781834372217,0.7583591941174648,-1400
1222,2020-05-07,2020,218967,218967,449512274.5833331,3487665.8833333333,167675,0,54,0.8159448684048282,45094940,6753886196,220070,220070,332390,552460,389099392.45001173,3482840.999999836,168917,0,54,0.32670238569308147,5665843523,-1103,-1103,60412882.133321345,4824.883333497215,-1242,0,0,0.4892424827117467,-5620748583,2052.8768014510547,1768.0710339892385,284.80576746181623,0.765754657094448,0.7675603217158177,-1242
1223,2020-05-08,2020,214735,214735,449528460.9666669,3423770.450000001,165377,0,52,0.8167508789903836,44965997,6759863668,215938,215938,347139,563077,389301286.83334595,3419987.833333155,166690,0,52,0.31535473833951877,5683537170,-1203,-1203,60227174.13332093,3782.6166668459773,-1313,0,0,0.5013961406508648,-5638571173,2093.41030091353,1802.8382537272084,290.5720471863217,0.7701445968286492,0.7719345367651826,-1313
1224,2020-05-09,2020,215026,215026,449619825.2833335,3420629.066666666,165113,0,54,0.8141899119176285,45104370,6767141009,216314,216314,360151,576465,389551110.20001197,3416380.2166664917,166485,0,54,0.3074132861491997,5701798901,-1288,-1288,60068715.08332151,4248.85000017425,-1372,0,0,0.5067766257684287,-5656694531,2091.002135943251,1800.859445990606,290.1426899526448,0.7678745826086147,0.7696450530247696,-1372
1225,2020-05-10,2020,214907,214907,449919567.04999954,3424885.033333333,162819,0,37,0.8092430679317094,45183247,6778568956,216241,216241,370122,586363,389994539.01667756,3420731.3999998327,164289,0,37,0.3004913338665643,5719240878,-1334,-1334,59925028.03332198,4153.633333500475,-1470,0,0,0.5087517340651451,-5674057631,2093.5547332101773,1803.5180146996988,290.0367185104785,0.7576253914483939,0.7597495387091254,-1470
1226,2020-05-11,2020,218296,218296,450995527.6666661,3491729.483333328,165397,0,49,0.8041100157584201,45058722,6797171121,219461,219461,379582,599043,391207843.6166755,3487685.2999998606,166683,0,49,0.2962258135058693,5734867736,-1165,-1165,59787684.049990594,4044.1833334672265,-1286,0,0,0.5078842022525508,-5689809014,2065.9816380816237,1782.5848037540861,283.3968343275376,0.757673067761205,0.7595108014635857,-1286
1227,2020-05-12,2020,219038,219038,451929236.7833335,3513994.5333333397,168261,0,51,0.8182507144878968,44983941,6809962635,220139,220139,385895,606034,392304344.6166741,3509374.0333331246,169451,0,51,0.29872086384592494,5744600665,-1101,-1101,59624892.166659355,4620.5000002151355,-1190,0,0,0.5195298506419719,-5699616724,2063.2458148053465,1782.0756186621823,281.1701961431643,0.7681817766780193,0.7697454789928182,-1190
1228,2020-05-13,2020,220215,220215,452753928.61666715,3517032.233333331,168955,0,47,0.8164384805757998,45033953,6822673433,221447,221447,394556,616003,393260119.1000134,3512415.7833331116,170221,0,47,0.29475018790493007,5764661049,-1232,-1232,59493809.516653776,4616.450000219513,-1266,0,0,0.5216882926708697,-5719627096,2055.9631660725527,1775.8656432465257,280.097522826027,0.7672274822332721,0.7686760263178096,-1266
1229,2020-05-14,2020,217910,217910,452830352.56666714,3488868.6333333342,170024,0,50,0.830618145105779,44291603,6826476408,219196,219195,406637,625833,393398206.91667575,3484752.8499998134,171336,0,50,0.29225208641922334,5776437613,-1286,-1285,59432145.64999139,4115.783333520871,-1312,0,0,0.5383660586865557,-5732146010,2078.0613673840903,1794.7407875027977,283.3205798812926,0.7802487265384792,0.781656599572985,-1312
1230,2020-05-15,2020,221088,221088,452015987.766666,3461288.15,171979,0,45,0.8273266753509919,43841538,6816804125,222194,222194,417427,639621,392749219.7333433,3456795.549999832,173133,0,45,0.2882300612393925,5773773825,-1106,-1106,59266768.03332269,4492.600000167731,-1154,0,0,0.5390966141115994,-5729932287,2044.5071092355352,1767.5959734886778,276.9111357468573,0.7778757779707628,0.7791974580771758,-1154
1231,2020-05-16,2020,223506,223506,449177840.7666663,3478163.650000003,172891,0,46,0.8221613737438821,44627083,6771485876,224736,224735,428146,652882,390099144.23333955,3473157.316666481,174246,0,46,0.2841692679534769,5744033301,-1230,-1229,59078696.533326745,5006.333333522081,-1355,0,0,0.5379921057904051,-5699406218,2009.6903025720396,1735.8183826877857,273.8719198842539,0.7735407550580298,0.7753363947031183,-1355
1232,2020-05-17,2020,222988,222988,445980859.93333286,3453895.183333327,173267,0,47,0.8252910470518591,43971950,6716207423,224218,224218,437165,661383,387332479.2500104,3448112.1999998223,174579,0,47,0.2807798204671136,5702852769,-1230,-1230,58648380.68332249,5782.983333504759,-1312,0,0,0.5445112265847455,-5658880819,2000.0217945958207,1727.481643980458,272.54015061536256,0.7770238757242542,0.7786127786350784,-1312
1233,2020-05-18,2020,241951,241951,443105022.6166672,3485815.933333329,175107,0,48,0.7695607788353842,44957906,6665452538,243256,243256,449665,692921,385518553.4500153,3480522.549999863,176536,0,48,0.2713888018980508,5674448308,-1305,-1305,57586469.166651905,5293.383333466016,-1429,0,0,0.4981719769373334,-5629490402,1831.3833074327745,1584.8264932828597,246.55681414991477,0.723729184834946,0.7257210510737659,-1429
1234,2020-05-19,2020,251706,251706,441058988.6833333,3540532.2666666643,179281,0,168,0.7558262417264596,45435863,6628512460,252786,252786,474127,726913,383927386.56666166,3535223.8833332723,180510,0,168,0.26406736432007655,5643656063,-1080,-1080,57131602.11667162,5308.383333391976,-1229,0,0,0.4917588774063831,-5598220200,1752.2784068847516,1518.7842149749656,233.49419190978597,0.712263513781952,0.7140822672141653,-1229
1235,2020-05-20,2020,235556,235556,438674427.26666665,3602469.2500000014,181689,0,206,0.8169182699655281,46010298,6584277594,236838,236838,499497,736335,382423508.299997,3597587.166666581,182979,0,206,0.26361099227933643,5609293985,-1282,-1282,56250918.96666968,4882.083333420567,-1290,0,0,0.5533072776861916,-5563283687,1862.2935831253149,1614.7050232648348,247.58855986048002,0.7713197710947716,0.7725913915841208,-1290
1236,2020-05-21,2020,231621,231621,436673353.91666687,3603264.9000000022,180454,0,52,0.8220454967382053,46269620,6543886822,232890,232890,505876,738766,381089565.2499991,3598306.566666523,181723,0,52,0.26004039168018767,5581194358,-1269,-1269,55583788.66666776,4958.3333334792405,-1269,0,0,0.5620051050580176,-5534924738,1885.2925853729448,1636.350059040745,248.9425263321998,0.7790917058470519,0.7802954184378891,-1269
1237,2020-05-22,2020,224547,224547,436156355.2166673,3564802.4833333394,174489,0,53,0.8200866633711431,45381345,6537748164,225465,225465,517203,742668,380857590.06667334,3560166.9833328426,175515,0,53,0.24983034141769622,5587269114,-918,-918,55298765.149993956,4635.500000496861,-1026,0,0,0.5702563219534469,-5541887769,1942.3833550066013,1689.2093676032791,253.17398740332214,0.7770711699555104,0.7784578537688777,-1026
1238,2020-05-23,2020,222027,222027,436144628.6333339,3543685.416666664,172108,0,51,0.8188013169569476,44532697,6539324748,223052,223052,527583,750635,381017360.71666443,3540174.3666666015,173103,0,52,0.2438748526247817,5597135156,-1025,-1025,55127267.91666949,3511.050000062678,-995,0,-1,0.5749264643321659,-5552602459,1964.3765336348008,1708.1997055245613,256.1768281102395,0.7751669841956158,0.7760656707852878,-995
1239,2020-05-24,2020,221006,221006,436336424.13333386,3509811.6500000022,171165,0,54,0.8237423418368732,44856205,6547365371,221912,221912,538362,760274,381385506.2999959,3505550.7999999123,172140,0,54,0.24113937869768026,5612240459,-906,-906,54950917.83333796,4260.850000089966,-975,0,0,0.5826029631391929,-5567384254,1974.3193584487926,1718.6339914019786,255.685367046814,0.7744812358035529,0.7757128952017016,-975
1240,2020-05-25,2020,225774,225774,436949217.7999997,3575937.366666668,174377,0,57,0.8219502688529229,44697676,6555408044,226745,226745,546275,773020,382224315.4499979,3570873.88333321,175399,0,57,0.242033841297763,5627881413,-971,-971,54724902.35000181,5063.483333458193,-1022,0,0,0.5799164275551598,-5583183737,1935.338957541611,1685.7011861341944,249.63777140741672,0.7723519980157149,0.7735517872499945,-1022
1241,2020-05-26,2020,223726,223726,437224178.99999976,3551322.8500000006,172372,0,54,0.8182196079132508,44667216,6558878052,224652,224652,553362,778014,382723571.23332775,3547674.866666534,173276,0,54,0.23684535239725893,5632442421,-926,-926,54500607.766672015,3647.9833334665745,-904,0,0,0.5813742555159919,-5587775205,1954.284164558432,1703.6285954869209,250.65556907151108,0.7704602951825,0.7713085127218987,-904
1242,2020-05-27,2020,227668,227668,437869747.11666733,3585523.316666665,174737,0,163,0.8166145439851012,45195731,6567042031,228610,228610,562202,790812,383593891.1666616,3581087.833333273,175694,0,163,0.23684896030915392,5643577834,-942,-942,54275855.95000571,4435.483333392069,-957,0,0,0.5797655836759473,-5598382103,1923.2819154060621,1677.9401214586485,245.34179394741363,0.7675079501730591,0.7685315602991996,-957
1243,2020-05-28,2020,232602,232602,438464257.43333334,3620195.7166666663,177981,0,52,0.81795513366179,44928286,6574473721,233502,233502,570505,804007,384236953.14999735,3615369.1166665587,178963,0,52,0.23853896794430934,5653448576,-900,-900,54227304.283335984,4826.600000107661,-982,0,0,0.5794161657174806,-5608520290,1885.0407882706654,1645.5403086483086,239.5004796223568,0.7651739881858282,0.7664302661219176,-982
1244,2020-05-29,2020,234182,234182,438941237.85,3623248.7833333374,180184,0,96,0.8239104628024343,45528385,6582227982,235021,235021,581487,816508,384876005.61667514,3618549.69999959,181108,0,96,0.23792418445379043,5668091580,-839,-839,54065232.233324885,4699.083333747461,-924,0,0,0.5859862783486438,-5622563195,1874.3594206642697,1637.6238958079284,236.73552485634127,0.7694186572836512,0.7706034779870735,-924
1245,2020-05-30,2020,227796,227796,438485404.5499999,3599745.4000000022,176398,0,87,0.8240311506786768,44973881,6576857532,228922,228922,592675,821597,384621736.29999954,3595370.3666662904,177513,0,87,0.23034163951426295,5676577629,-1126,-1126,53863668.25000036,4375.033333711792,-1115,0,0,0.5936895111644138,-5631603748,1924.90388132364,1680.143176715211,244.76070460842902,0.7743682944388839,0.7754300591467836,-1115
1246,2020-05-31,2020,228200,228200,438599486.0333334,3592291.0000000014,178078,0,102,0.8321165644171784,45028310,6579088468,229177,229177,601698,830875,384948220.0833291,3587345.983333227,179172,0,103,0.2305027832104713,5692185310,-977,-977,53651265.95000434,4945.016666774172,-1094,0,-1,0.601613781206707,-5647157000,1921.995994887526,1679.6983121488154,242.2976827387106,0.7803593339176161,0.7818062021930647,-1094
1247,2020-06-01,2020,233671,233671,439373767.78333336,3650983.6499999957,181354,0,56,0.8265595645159222,46127724,6591024496,234889,234889,261888,496777,385763376.2166696,3647658.099999535,182641,0,57,0.39224239447478576,5655899536,-1218,-1218,53610391.56666374,3325.5500004608184,-1287,0,-1,0.4343171700411364,-5609771812,1880.3093571017941,1642.3220168533633,237.98734024843088,0.7761082890046261,0.7775630191281839,-1287
1248,2020-06-02,2020,232357,232357,439815882.1166664,3626673.266666668,181018,0,81,0.8275928850863106,44788537,6598741208,233536,233536,273989,507525,386297867.216667,3622087.7666662373,182164,0,81,0.3818215851435867,5657729296,-1179,-1179,53518014.89999938,4585.500000430737,-1146,0,0,0.44577129994272385,-5612940759,1892.8454151011865,1654.1255618691207,238.71985323206582,0.7790512013840771,0.7800253494107975,-1146
1249,2020-06-03,2020,233005,233005,438524561.7166668,3630051.2666666657,181648,0,140,0.8328147464646676,46139665,6579113125,234482,234482,284357,518839,385256647.35000193,3625052.6999996738,183065,0,140,0.3778031335346743,5646642429,-1477,-1477,53267914.36666489,4998.566666991916,-1417,0,0,0.45501161292999326,-5600502764,1882.0392769110827,1643.0116057949094,239.02767111617322,0.779588420849338,0.7807209082147031,-1417
1250,2020-06-04,2020,229439,229439,436473917.93333346,3608868.466666667,179114,0,115,0.8333413238377098,46008796,6541597222,230866,230865,295919,526785,383614662.8000026,3603371.5499995584,180486,0,117,0.36651385290014166,5619071796,-1427,-1426,52859255.13333088,5496.916667108424,-1372,0,-2,0.4668274709375681,-5573063000,1902.3527732135053,1661.6406246074657,240.7121486060396,0.7806606549017386,0.7817781743522216,-1372
1251,2020-06-05,2020,227884,227884,434328703.40000045,3595937.249999998,177392,0,47,0.8282240087061835,46541598,6505361768,229316,229316,305552,534868,382176829.03334105,3591539.349999789,178779,0,47,0.356400083758983,5605472055,-1432,-1432,52151874.3666594,4397.900000208989,-1387,0,0,0.4718239249472005,-5558930457,1905.9201321725109,1666.5946948025478,239.32543736996308,0.7784311316283723,0.7796185176786617,-1387
1252,2020-06-06,2020,225194,225194,432787508.70000005,3590989.4999999977,175633,0,53,0.8283790864765495,46456555,6481387388,226570,226570,316526,543096,381173551.9333435,3585944.2666664617,177049,0,53,0.34655935598862486,5593630121,-1376,-1376,51613956.76665652,5045.233333535958,-1416,0,0,0.4818197304879246,-5547173566,1921.8429829391548,1682.3655026408771,239.47748029827767,0.7799186479213478,0.7814317870856688,-1416
1253,2020-06-07,2020,227161,227161,431599891.8166662,3583670.249999999,176480,0,55,0.8239442509937874,46855733,6458705072,228585,228585,325772,554357,380368643.5166714,3578845.983333008,177932,0,55,0.34099686664008666,5589374451,-1424,-1424,51231248.29999477,4824.2666669911705,-1452,0,0,0.48294738435370077,-5542518718,1899.9735509909983,1664.0140145533232,235.95953643767507,0.7768939210515889,0.7784062821269987,-1452
1254,2020-06-08,2020,231287,231287,431173229.9833329,3629012.566666667,179402,0,57,0.8231245162936103,46077722,6450217532,232650,232650,333711,566361,380240101.61667216,3624020.4999996573,180763,0,57,0.3391935532284236,5588133921,-1363,-1363,50933128.366660714,4992.066667009611,-1361,0,0,0.4839309630651867,-5542056199,1864.234608876992,1634.3868541443032,229.84775473268883,0.7756683255003524,0.7769739952718676,-1361
1255,2020-06-09,2020,231098,231098,430240283.3500006,3615829.666666665,180508,0,59,0.8262598551263977,45272845,6430369488,232455,232455,339148,571603,379729318.43334025,3610695.1999998507,181816,0,59,0.33713608920876675,5574965639,-1357,-1357,50510964.91666037,5134.4666668144055,-1308,0,0,0.4891237659176309,-5529692794,1861.722227583106,1633.5605533687822,228.16167421432374,0.7810885425230855,0.7821556860467618,-1308
1256,2020-06-10,2020,231205,231205,429151507.8000004,3611652.949999997,181157,0,53,0.8322873640275936,45341403,6411987393,232324,232324,347818,580142,379047767.7333451,3607006.383333193,182280,0,53,0.33412509351158354,5564287070,-1119,-1119,50103740.06665534,4646.566666803788,-1123,0,0,0.4981622705160101,-5518945667,1856.1515010488547,1631.5480438239058,224.6034572249489,0.7835340931208236,0.7845939291678862,-1123
1257,2020-06-11,2020,233913,233913,428435066.83333343,3644370.4666666663,181649,0,232,0.8276752467797861,45607499,6389684214,234985,234985,354987,589972,378707552.2166699,3639347.616666437,182698,0,235,0.33050382052028615,5548730796,-1072,-1072,49727514.616663516,5022.8500002291985,-1049,0,-3,0.49717142625949995,-5503123297,1831.6000685440033,1611.6243684348785,219.97570010912477,0.7765665012205393,0.7774879247611549,-1049
1258,2020-06-12,2020,236332,236332,427200534.0833328,3649529.6833333364,184311,0,55,0.8309708376351914,45223091,6359454283,237431,237431,363983,601414,378062364.33334404,3644116.349999802,185430,0,55,0.3291060733537919,5536372331,-1099,-1099,49138169.749988735,5413.333333534189,-1119,0,0,0.5018647642813996,-5491149240,1807.6288191329688,1592.3041402906279,215.32467884234097,0.7798816918572178,0.7809847913709668,-1119
1259,2020-06-13,2020,231393,231393,426304507.2166665,3623327.816666665,182189,0,50,0.835742654272169,45458025,6344690450,232536,232536,374334,606870,377491370.15001047,3618510.766666471,183316,0,50,0.32125166839685326,5533524503,-1143,-1143,48813137.06665605,4817.0500001939945,-1127,0,0,0.5144909858753157,-5488066478,1842.3396870979957,1623.3674362249735,218.97225087302218,0.7873574395076774,0.7883338493824612,-1127
1260,2020-06-14,2020,230933,230933,425364329.9833333,3604063.4000000013,182072,0,57,0.8364633898143612,46133088,6327998001,232121,232121,384467,616588,376971782.48334193,3599466.9999998184,183199,0,57,0.3158494813392392,5533404861,-1188,-1188,48392547.49999136,4596.400000182912,-1127,0,0,0.520613908475122,-5487271773,1841.9382677371068,1624.0313564190312,217.90691131807557,0.7884191518752193,0.7892392329862442,-1127
1261,2020-06-15,2020,231229,231229,424967222.6000003,3639671.6833333364,180637,0,60,0.8264058573967797,45443481,6318915722,232467,232467,393838,626305,376961064.28334,3634893.3499998534,181889,0,60,0.3077398392157178,5526837056,-1238,-1238,48006158.316660345,4778.333333482966,-1252,0,0,0.518666018181062,-5481393575,1837.862995558517,1621.5680689445812,216.2949266139358,0.7812039147338785,0.7824293340560166,-1252
1262,2020-06-16,2020,231627,231627,424414077.39999974,3654253.1833333336,180078,0,52,0.8234014169332592,45443226,6306344134,232803,232802,398000,630803,376737186.516683,3649081.216666431,181217,0,52,0.3046561287755498,5515649247,-1176,-1175,47676890.883316755,5171.966666902415,-1139,0,0,0.5187452881577094,-5470206021,1832.3169466426614,1618.2729809738876,214.0439656687738,0.7774482249478688,0.7784135084169878,-1139
1263,2020-06-17,2020,229961,229961,424110823.7833331,3610466.6333333254,178916,0,66,0.8239788485873695,44732973,6301871400,232777,232777,406464,639241,376770900.5833431,3606322.016666465,180229,0,66,0.29897331366418034,5516275508,-2816,-2816,47339923.199990034,4144.616666860413,-1313,0,0,0.5250055349231891,-5471542535,1844.2728279287928,1618.5916159386154,225.68121199017742,0.778027578589413,0.774256047633572,-1313
1264,2020-06-18,2020,227236,227236,422385042.4500006,3573623.1000000034,176717,0,61,0.8208470488831008,44591094,6288812106,228212,228212,419980,648192,375225318.06668115,3569065.566666475,177652,0,61,0.28952995408768106,5520371019,-976,-976,47159724.38331944,4557.533333528321,-935,0,0,0.5313170947954198,-5475779925,1858.7945679821885,1644.196265168708,214.5983028134806,0.7776804731644634,0.7784516151648467,-935
1265,2020-06-19,2020,234501,234501,421551701.3499995,3610471.516666664,180631,0,73,0.8152673122929109,44738227,6279732125,237732,237732,425876,663608,374555270.85001564,3608715.6999998153,182410,0,73,0.2912864221046175,5517982907,-3231,-3231,46996430.49998385,1755.8166668484919,-1779,0,0,0.5239808901882934,-5473244680,1797.6541735429678,1575.535774948327,222.1183985946409,0.7702781651250954,0.7672925815624316,-1779
1266,2020-06-20,2020,232814,232814,420587400.4833333,3602637.7166666635,181667,0,58,0.8253584406436024,44273527,6268125843,233774,233774,436139,669913,373699233.7833457,3597670.249999835,182625,0,58,0.28875540555266915,5510529560,-960,-960,46888166.69998759,4967.466666828375,-958,0,0,0.5366030350909332,-5466256033,1806.5382686751368,1598.5491704952035,207.9890981799333,0.7803096033743675,0.7812032133599117,-958
1267,2020-06-21,2020,229647,229647,419892794.49999994,3557498.3166666673,178634,0,63,0.8221444216558454,44920817,6258041447,179710,179710,468310,648020,356706870.3333348,2716657.566666588,99691,0,63,0.15893953890312168,5494681335,49937,49937,63185924.16666514,840840.7500000792,78943,0,0,0.6632048827527237,-5449760518,1828.4270837415684,1984.9027340344712,-156.47565029290286,0.7778634164609161,0.5547326247843748,78943
1268,2020-06-22,2020,228276,228276,419557279.81666684,3589102.1333333277,177524,0,52,0.8224386269253009,45041628,6254346429,228987,228987,470471,699458,357936051.5000074,3585652.1333328052,178282,0,52,0.269907556994121,5508266022,-711,-711,61621228.31665945,3450.000000522472,-758,0,0,0.5525310699311798,-5463224394,1837.9386348835044,1563.1282627398384,274.810372143666,0.7776726418896424,0.7785682156628979,-758
1269,2020-06-23,2020,232639,232639,419213795.5666667,3611749.7666666587,182373,0,50,0.8293450367307279,44209210,6245260438,233626,233626,453600,687226,358426064.55000734,3606471.2499997886,183323,0,51,0.2825504273703217,5423323685,-987,-987,60787731.01665938,5278.516666870099,-950,0,-1,0.5467946093604061,-5379114475,1801.9927680512155,1534.1873958806268,267.8053721705887,0.7839313270775752,0.7846857798361484,-950
1270,2020-06-24,2020,234655,234655,418777130.6333328,3648069.9166666633,186020,0,53,0.8386780592785152,44398253,6234348290,235773,235773,460689,696462,358589449.2166785,3642566.266666487,187109,0,53,0.2846587466365739,5410143027,-1118,-1118,60187681.41665429,5503.6500001763925,-1089,0,0,0.5540193126419413,-5365744774,1784.6503617367318,1520.9097276476887,263.74063408904317,0.7927382753403933,0.79359807950868,-1089
1271,2020-06-25,2020,235423,235423,418007445.6833336,3634029.8166666604,184593,0,55,0.8290948632886332,45598308,6222634487,236746,236746,469569,706315,358158145.10000664,3628985.3999995287,185750,0,55,0.27835739011631194,5403172615,-1323,-1323,59849300.583326936,5044.416667131707,-1157,0,0,0.5507374731723214,-5357574307,1775.5590816671845,1512.8371550100387,262.7219266571458,0.7840907642838635,0.7845961494597585,-1157
1272,2020-06-26,2020,238067,238067,416524564.5833339,3664840.583333332,185451,0,50,0.8217980652505377,46264339,6199030752,239131,239129,477220,716351,357350481.2166745,3658727.3166661607,186483,0,51,0.27509838054249247,5392380311,-1064,-1062,59174083.3666594,6113.266667171381,-1032,0,-1,0.5466996847080452,-5346115972,1749.6106750760664,1494.3837059356017,255.2269691404647,0.7789865878093142,0.7798361567509022,-1032
1273,2020-06-27,2020,235888,235888,415764423.33333343,3654894.866666668,183101,0,53,0.8195075629112123,46057552,6187757039,236732,236732,484120,720852,357001254.1000002,3650033.333332887,183961,0,54,0.26970723532709306,5386011010,-844,-844,58763169.23333323,4861.533333781175,-860,0,-1,0.5498003275841192,-5339953458,1762.5501226570807,1508.0396993224415,254.5104233346392,0.7762200705419521,0.777085480627883,-860
1274,2020-06-28,2020,232399,232399,415154814.6333335,3595829.516666663,180981,0,47,0.825571538603868,45038643,6179010527,233147,233147,493930,727077,356763122.5666848,3591507.3499994506,181818,0,50,0.2653694175444979,5386834999,-748,-748,58391692.06664872,4322.1666672122665,-837,0,-3,0.5602021210593702,-5341796356,1786.388128319543,1530.2067904227151,256.1813378968279,0.7787511994457808,0.7798427601470317,-837
1275,2020-06-29,2020,225834,225834,414513077.83333373,3557631.7999999947,175903,0,54,0.8234278275193281,44378674,6173485250,226866,226866,506238,733104,356711784.4833396,3552276.3166661705,176912,0,54,0.2554166939479323,5393089253,-1032,-1032,57801293.34999412,5355.483333824202,-1009,0,0,0.5680111335713958,-5348710579,1835.476845086806,1572.3457216301235,263.1311234566824,0.7789039737152067,0.7798083450142375,-1009
1276,2020-06-30,2020,228636,228636,413654617.4166669,3583354.1833333317,177619,0,55,0.8207718819433509,44493792,6159807545,229508,229507,511754,741262,356403582.1333267,3578217.416666608,178520,0,55,0.254824879732132,5384655666,-872,-871,57251035.283340216,5136.766666723881,-901,0,0,0.565947002211219,-5340161874,1809.227844331894,1552.9094194657537,256.3184248661403,0.7768636610157631,0.7778378095752654,-901
1277,2020-07-01,2020,234417,234417,413470813.23333347,3630032.283333337,181435,0,53,0.8175345644727129,45154829,6156137990,235472,235472,268014,503486,356654869.733333,3624683.5666662953,182586,0,54,0.38372268543712656,5339622188,-1055,-1055,56815943.50000048,5348.716667041648,-1151,0,-1,0.4338118790355863,-5294467359,1763.82605883248,1514.6381299404302,249.18792889204974,0.7739839687394685,0.7754042943534688,-1151
1278,2020-07-02,2020,235171,235171,412926566.2666667,3653179.2499999944,184576,0,58,0.8284694966641296,45499711,6149745389,236228,236228,275790,512018,356592128.716668,3647894.0333329528,185598,0,58,0.3832228554464889,5336934462,-1057,-1057,56334437.5499987,5285.216667041648,-1022,0,0,0.44524664121764074,-5291434751,1755.8566586299617,1509.5252413628698,246.33141726709187,0.7848586773028987,0.7856731632151989,-1022
1279,2020-07-03,2020,233204,233204,412556076.2333326,3562273.2666666647,184706,0,48,0.8369967925078464,44371828,6143507668,234013,234013,284469,518482,356712930.683333,3557268.666666322,185580,0,48,0.37894083111852783,5337603070,-809,-809,55843145.549999595,5004.60000034282,-874,0,0,0.4580559613893186,-5293231242,1769.0780442588145,1524.3295487145285,244.74849554428602,0.7920361571842679,0.7930328656954956,-874
1280,2020-07-04,2020,228977,228977,411890768.6833336,3596751.8333333298,180763,0,69,0.8356472484135967,44024635,6135038500,229831,229831,297582,527413,356478584.7500013,3591655.1666663447,181624,0,69,0.3648715522749733,5342550204,-854,-854,55412183.933332264,5096.666666985024,-861,0,0,0.4707756961386234,-5298525569,1798.8303134521527,1551.0465722639735,247.7837411881792,0.789437367071802,0.7902502273409592,-861
1281,2020-07-05,2020,227140,227140,411343758.28333324,3572546.816666665,179978,0,72,0.8386809896979847,44673340,6127104537,227897,227897,306149,534046,356353870.0666698,3567967.2999996543,180798,0,72,0.35900465502971485,5348635789,-757,-757,54989888.21666342,4579.516667010728,-820,0,0,0.4796763346682698,-5303962449,1810.9701430101843,1563.6619616171772,247.3081813930071,0.7923659417099587,0.7933320754551398,-820
1282,2020-07-06,2020,229478,229478,411203119.9666664,3605040.6833333345,181535,0,60,0.8367163736828801,44714075,6125153308,230482,230482,315368,545850,356596648.0166749,3599907.616666355,182470,0,60,0.35397087111844666,5351543083,-1004,-1004,54606471.949991524,5133.066666979343,-935,0,0,0.48274550256443344,-5306829008,1791.9065006957808,1547.177862117974,244.7286385778068,0.7910780118355573,0.791688721895853,-935
1283,2020-07-07,2020,230849,230849,410808761.7833338,3621342.6333333324,182338,0,56,0.8333066203449006,44777796,6114083856,232866,232866,320871,553737,356592019.4000099,3617022.149999686,183543,0,57,0.35024027652116085,5344140758,-2017,-2017,54216742.38332391,4320.48333364632,-1205,0,-1,0.4830663438237397,-5299362962,1779.5561678124393,1531.3185239580268,248.23764385441245,0.7898583056456818,0.7881914921027544,-1205
1284,2020-07-08,2020,232356,232356,410169370.5333331,3633587.1500000022,183428,0,60,0.8316634818984657,44625502,6103147999,233265,233265,328752,562017,356429713.26668406,3627618.483333138,184262,0,61,0.3458151621748098,5344034337,-909,-909,53739657.26664907,5968.6666668644175,-834,0,-1,0.48584831972365594,-5299408835,1765.2626595970542,1528.0034007102824,237.2592588867717,0.7894265695742739,0.7899256210747433,-834
1285,2020-07-09,2020,232414,232414,409616990.433333,3627562.200000001,185337,0,60,0.8411068180058003,43982742,6088378279,233587,233587,336642,570229,356495693.66666853,3622534.0833329074,186142,0,60,0.34467205280684954,5342708226,-1173,-1173,53121296.766664445,5028.116667093709,-805,0,0,0.4964347651989508,-5298725484,1762.4454225362197,1526.17951198769,236.26591054852975,0.7974433553916718,0.7968851006263191,-805
1286,2020-07-10,2020,235794,235794,408979413.4500003,3626385.9333333336,187803,0,47,0.8383249785830005,44545947,6077912838,236595,236595,344936,581531,356295533.9000101,3621548.24999989,188591,0,47,0.34179261294754487,5341514885,-801,-801,52683879.54999018,4837.683333443478,-788,0,0,0.4965323656354556,-5296968938,1734.4776094811584,1505.9301079904906,228.54750149066786,0.7964706481080943,0.7971047570743254,-788
1287,2020-07-11,2020,234417,234417,408225014.2833331,3632551.000000004,187150,0,48,0.8421829474824785,44467099,6065607195,235293,235293,352587,587880,355982653.86667883,3627890.833333209,188008,0,48,0.3378308498333051,5342151410,-876,-876,52242360.41665429,4660.166666795034,-858,0,0,0.5043520976491733,-5297684311,1741.447993461793,1512.9334653673454,228.51452809444754,0.7983635999095628,0.7990377954295282,-858
1288,2020-07-12,2020,234956,234956,408068134.6166664,3627135.2833333346,188641,0,47,0.8474608011712834,44494408,6061468205,235730,235730,360458,596188,356256414.5666789,3621996.999999904,189420,0,47,0.33589236952102697,5346946724,-774,-774,51811720.049987495,5138.283333430532,-779,0,0,0.5115684316502564,-5302452316,1736.7853326438412,1511.290097003686,225.49523564015522,0.8028779856654011,0.8035464302379841,-779
1289,2020-07-13,2020,235627,235627,408115168.31666636,3632723.5166666694,188346,0,54,0.8455525045941257,44148492,6060794000,236438,236438,370401,606839,356584369.7333472,3627842.0166665576,189221,0,54,0.33043855124670907,5352185472,-811,-811,51530798.58331919,4881.500000111759,-875,0,0,0.5151139533474166,-5308036980,1732.0390630813376,1508.1516919164735,223.88737116486413,0.7993396342524414,0.8002985983640531,-875
1290,2020-07-14,2020,233726,233726,407570506.21666604,3624548.96666666,184691,0,50,0.8342332474778159,44070951,6049374294,234613,234613,377093,611706,356327118.9500114,3619806.849999856,185539,0,50,0.3206262485573156,5340225871,-887,-887,51243387.26665467,4742.116666803602,-848,0,0,0.5136069989205003,-5296154920,1743.7961810695688,1518.7867635212515,225.0094175483173,0.7902030582819198,0.7908300051574295,-848
1291,2020-07-15,2020,234819,234819,407344582.3833338,3626794.8000000026,185455,0,49,0.8325007771943501,43457538,6042646721,235690,235690,384815,620505,356495501.7833419,3622436.16666649,186283,0,51,0.3169837471092064,5337564653,-871,-871,50849080.59999192,4358.633333512582,-828,0,-2,0.5155170300851437,-5294107115,1734.717303043339,1512.560998698892,222.15630434444688,0.7897785102568361,0.7903729475158047,-828
1292,2020-07-16,2020,236249,236249,406851762.89999956,3665135.5000000014,186817,0,53,0.8356352831123094,44245751,6036046869,237295,237295,392475,629770,356395341.5833436,3660450.1666664667,187870,0,53,0.31571684900836755,5338362630,-1046,-1046,50456421.316655934,4685.333333534654,-1053,0,0,0.5199184341039418,-5294116879,1722.1311535710186,1501.9083486097204,220.22280496129815,0.7907631355053355,0.7917149539602605,-1053
1293,2020-07-17,2020,239578,239578,406336137.65000045,3677220.1166666658,190072,0,46,0.8355065991034235,43633572,6025386948,241083,241081,399612,640695,356332961.45001036,3671366.5666663945,191363,0,46,0.3150578668477133,5335613033,-1505,-1503,50003176.19999009,5853.550000271294,-1291,0,0,0.5204487322557102,-5291979461,1696.0494605097315,1478.0632295784835,217.98623093124797,0.7933616609204518,0.7937639734033507,-1291
1294,2020-07-18,2020,239620,239620,405839203.883333,3679103.3000000007,190133,0,45,0.8360529171187712,44895105,6018821690,240466,240466,408171,648637,355961459.40001035,3673943.199999794,191016,0,45,0.310919666932347,5331315455,-846,-846,49877744.48332268,5160.100000206847,-883,0,0,0.5251332501864241,-5286420350,1693.6783402192348,1480.2985012434622,213.3798389757726,0.7934771721892997,0.7943576222833997,-883
1295,2020-07-19,2020,237101,237101,405441311.9333337,3640517.1166666667,188716,0,54,0.8360740781354785,44494990,6012389786,237915,237915,416582,654497,355804240.0000117,3635196.616666439,189551,0,54,0.30463546815341036,5337304488,-814,-814,49637071.93332201,5320.500000227708,-835,0,0,0.5314386099820682,-5292809498,1709.9941034973858,1495.509909001163,214.48419449622293,0.7959308480352255,0.7967173150074607,-835
1296,2020-07-20,2020,239867,239867,404444933.6666665,3705517.9500000007,189832,0,45,0.8370513659653064,44621119,5998337452,240796,240796,425970,666766,355396518.80001354,3701318.7833331004,190662,0,45,0.30266840240804943,5334761936,-929,-929,49048414.866652966,4199.166666900273,-830,0,0,0.534382963557257,-5290140817,1686.1216160066474,1475.9236814565588,210.19793455008858,0.7914052370688757,0.7917988670908155,-830
1297,2020-07-21,2020,240891,240891,404285968.29999995,3729319.6333333272,190730,0,44,0.8362039262571036,45327190,5993622240,241870,241870,428758,670628,355543953.11667067,3725259.433333137,191614,0,44,0.3022331307371533,5323305865,-979,-979,48742015.183329284,4060.200000190176,-884,0,0,0.5339707955199503,-5277978675,1678.2942006965804,1469.979547346387,208.31465335019334,0.7917688913242918,0.7922189605986687,-884
1298,2020-07-22,2020,240732,240732,404179614.56666625,3729398.1333333356,189743,0,28,0.8314806506820867,45190777,5990253785,241678,241678,436801,678479,355693836.30000865,3723307.833333169,190635,0,28,0.29665914494036616,5321588754,-946,-946,48485778.26665759,6090.3000001665205,-892,0,0,0.5348215057417205,-5276397977,1678.9608966263988,1471.7675431773214,207.19335344907745,0.7881918481963345,0.7887974908762899,-892
1299,2020-07-23,2020,238525,238525,404128758.93333334,3706872.0166666606,189079,0,24,0.8379331306990893,45229074,5989132169,239682,239682,446423,686105,355845299.41667557,3701455.516666469,190196,0,24,0.29365476129746904,5325373600,-1157,-1157,48283459.51665777,5416.500000191387,-1117,0,0,0.5442783694016202,-5280144526,1694.2826074136185,1484.6559166590548,209.6266907545637,0.7927009747405932,0.7935347668994751,-1117
1300,2020-07-24,2020,242267,242267,403846240.7000003,3705994.3333333307,191053,0,23,0.8333780498375748,44864103,5985637993,243360,243360,454474,697834,355896965.7499962,3701147.8833331643,192086,0,23,0.2918330147284292,5328928533,-1093,-1093,47949274.9500041,4846.450000166427,-1033,0,0,0.5415450351091455,-5284064430,1666.9469663635587,1462.4300039036661,204.5169624598925,0.7886051340050441,0.7893080210387903,-1033
1301,2020-07-25,2020,241331,241331,403576744.4999998,3731578.7666666647,190247,0,47,0.832043956226096,44764725,5981577573,242249,242249,462460,704709,355985974.0333387,3725905.399999544,191224,0,47,0.2871397981294421,5333873521,-918,-918,47590770.466661096,5673.3666671207175,-977,0,0,0.5449041580966538,-5289108796,1672.2954966415414,1469.5044108885434,202.79108575299801,0.7883239202588975,0.7893696155608485,-977
1302,2020-07-26,2020,238842,238842,403613028.48333305,3690064.8666666686,188114,0,50,0.8280830004773029,44978258,5980061757,239881,239881,470267,710148,356269466.8666603,3684510.216666585,189160,0,50,0.2806246021956049,5343641505,-1039,-1039,47343561.616672754,5554.650000083726,-1046,0,0,0.547458398281698,-5298663247,1689.8745969441431,1485.1925199022028,204.68207704194037,0.7876085445608394,0.7885576598396705,-1046
1303,2020-07-27,2020,238407,238407,403608583.9333336,3706598.86666667,188146,0,51,0.8312801218085041,44690624,5976603138,239482,239482,480415,719897,356470318.4666685,3701273.199999542,189162,0,52,0.2771424245412791,5347329407,-1075,-1075,47138265.46666509,5325.666667127982,-1016,0,-1,0.554137697267225,-5302638783,1692.9393177773034,1488.505685048014,204.43363272928946,0.7891798479071503,0.789879823953366,-1016
1304,2020-07-28,2020,237222,237222,403272975.7666664,3714606.133333329,187973,0,181,0.8370345077606625,44591922,5968549002,238358,238358,486217,724575,356550114.2833261,3708869.5666665724,189068,0,181,0.275943829141223,5339875266,-1136,-1136,46722861.48334032,5736.566666756757,-1095,0,0,0.5610906786194394,-5295283344,1699.9813498185936,1495.859649281023,204.12170053757063,0.7923927797590443,0.7932102132087029,-1095
1305,2020-07-29,2020,241451,241451,402986229.78333354,3757869.966666667,191042,0,187,0.8343307751883416,45452722,5962928890,242497,242497,492449,734946,356610254.1166627,3751433.9166665412,192107,0,188,0.2759767384270406,5338633400,-1046,-1046,46375975.66667086,6436.050000125542,-1065,0,-1,0.558354036761301,-5293180678,1669.0186819824044,1470.5759416267529,198.4427403556515,0.7912247205437128,0.7922036148900811,-1065
1306,2020-07-30,2020,247234,247234,403148873.26666594,3777577.1000000034,194230,0,126,0.828923206355113,45044702,5961899627,248382,248382,497595,745977,356998033.2999935,3771526.7999999328,195281,0,128,0.27635972690847044,5337436847,-1148,-1148,46150839.96667242,6050.300000070594,-1051,0,-2,0.5525634794466425,-5292392145,1630.6368592777123,1437.2943019220133,193.342557355699,0.7856120112929451,0.786212366435571,-1051
1307,2020-07-31,2020,249348,249348,402857753.9166668,3809427.9000000013,196467,0,101,0.8317492019186038,44935804,5953425665,250433,250433,507344,757777,357059439.4333271,3804338.0999998767,197494,0,101,0.2753857665249773,5333381670,-1085,-1085,45798314.48333973,5089.800000124611,-1027,0,0,0.5563634353936264,-5288445866,1615.644616827353,1425.76832699096,189.87628983639297,0.7879229029308437,0.7886101272595863,-1027
1308,2020-08-01,2020,251197,251197,402210563.13333344,3849905.2833333295,198491,0,73,0.8384295990796071,45526299,5945149770,252251,252251,105272,357523,356878121.1500138,3845397.4666663483,199557,0,48,0.5939002525711664,5219512083,-1054,-1054,45332441.98331964,4507.816666981205,-1066,0,25,0.24452934650844071,-5173985784,1601.1758226942736,1414.7738607577921,186.40196193648148,0.7901806152143537,0.7911048915564259,-1066
1309,2020-08-02,2020,241218,241218,402327543.08333313,3781852.66666667,190269,0,39,0.8403684633816709,45642260,5949708750,242009,242007,82462,324471,357196624.90001166,3776890.749999747,191133,0,38,0.6293228054279087,5214311128,-791,-789,45130918.183321476,4961.916666922625,-864,0,1,0.21104565795376218,-5168668868,1667.9001694870744,1475.9764176243318,191.92375186274262,0.7887844190732035,0.7897764132738865,-864
1310,2020-08-03,2020,237962,237962,402717483.81666714,3756817.4166666637,186514,0,40,0.8341962162025865,45144126,5961253454,238672,238672,80065,318737,357772850.3500086,3752285.499999585,187389,0,41,0.6263094651703403,5224378781,-710,-710,44944633.46665853,4531.916667078622,-875,0,-1,0.2078867510322463,-5179234655,1692.3604769529047,1499.0147581199662,193.34571883293847,0.7837974130323329,0.7851318964939331,-875
1311,2020-08-04,2020,234269,234269,402858736.7999999,3749237.3333333316,184155,0,83,0.8371615535986409,44997468,5968890788,235948,235948,74632,310580,358088215.11667866,3743036.1166663254,185055,0,83,0.6351600231824275,5233370463,-1679,-1679,44770521.68332124,6201.216667006258,-900,0,0,0.20200153041621338,-5188372995,1719.6416802906056,1517.657344485559,201.9843358050466,0.7860835193730284,0.7843041687151406,-900
1312,2020-08-05,2020,243616,243616,403497762.86666626,3770404.7833333327,190854,0,38,0.8336931892814924,44867205,5979568163,244380,244380,73175,317555,358943696.13334507,3765816.866666351,191781,0,38,0.6435452126403226,5244157381,-764,-764,44554066.73332119,4587.916666981764,-927,0,0,0.19014797664116978,-5199290176,1656.2859699964956,1468.7932569496074,187.49271304688818,0.7834214501510574,0.7847655290940339,-927
1313,2020-08-06,2020,249614,249614,403748544.76666707,3860864.299999995,195204,0,29,0.8326536171849341,44600348,5979665785,250464,250464,75866,326330,359451034.0500135,3855216.8666663216,196183,0,31,0.641157723776543,5249496594,-850,-850,44297510.716653585,5647.433333673514,-979,0,-2,0.19149589340839113,-5204896246,1617.4915860755689,1435.140515403465,182.3510706721038,0.7820234441978414,0.7832782355947362,-979
1314,2020-08-07,2020,254255,254255,404439771.6666674,3876454.233333329,197986,0,23,0.8266346777841147,44450486,5985955633,255079,255079,76386,331465,360496041.78334475,3870297.0333330245,198948,0,23,0.6388879670553377,5255773210,-824,-824,43943729.883322656,6157.200000304729,-962,0,0,0.18774671072877702,-5211322724,1590.6856174575423,1413.2721305295408,177.41348692800148,0.7786906845489764,0.7799466047773435,-962
1315,2020-08-08,2020,252173,252173,404817870.00000006,3862767.583333336,196950,0,37,0.8320557712364135,44346827,5988352826,253163,253163,81535,334698,361017821.1833463,3856561.3999996083,198030,0,37,0.6324985509324836,5262720531,-990,-990,43800048.81665379,6206.183333727531,-1080,0,0,0.19955722030392986,-5218373704,1605.3180554619253,1426.029163753575,179.28889170835032,0.7810114484897273,0.7822233106733606,-1080
1316,2020-08-09,2020,252259,252259,405184757.7333338,3831726.649999999,196783,0,29,0.8305114981031405,44595944,5995176617,253048,253048,81501,334549,361565265.5833467,3826230.2166663557,197745,0,29,0.6315636872326618,5273682667,-789,-789,43619492.1499871,5496.433333643246,-962,0,0,0.19894781087047875,-5229086723,1606.225180205003,1428.840637283625,177.38454292137794,0.7800831684895286,0.7814525307451551,-962
1317,2020-08-10,2020,245060,245060,405582966.4333335,3754436.4166666674,191817,0,196,0.8314331184199787,44943745,6006902664,246437,246437,85739,332176,362051591.9166825,3749891.1166662974,192825,0,196,0.617446775203505,5284787954,-1377,-1377,43531374.516651034,4545.3000003700145,-1008,0,0,0.2139863432164737,-5239844209,1655.035364536577,1469.1446167445736,185.89074779200337,0.7827348404472374,0.7824514987603323,-1008
1318,2020-08-11,2020,244494,244494,405306082.84999985,3767663.6166666658,192052,0,303,0.8353701931335741,45671672,6014489265,245240,245240,81589,326829,361863505.38334775,3763198.1666663047,192938,0,304,0.6290108894865517,5293073383,-746,-746,43442577.466652095,4465.450000361074,-886,0,-1,0.20635930364702237,-5247401711,1657.7342709841544,1475.54846429354,182.1858066906143,0.7855080288268833,0.78673136519328,-886
1319,2020-08-12,2020,246397,246397,405942257.8333337,3821473.8666666676,193152,0,222,0.8344906796754823,46007775,6022676140,247236,247236,76434,323670,362629366.9000075,3815529.7666663514,194135,0,224,0.6390953749189048,5302672010,-839,-839,43312890.933326185,5944.100000316277,-983,0,-2,0.19539530475657751,-5256664235,1647.5129885239417,1466.733675112069,180.77931341187264,0.7839056482018856,0.785221407885583,-983
1320,2020-08-13,2020,248763,248763,406582251.65000045,3844080.233333332,193902,0,122,0.8311324433295947,45402110,6030965326,249571,249571,77490,327061,363478537.75000834,3839198.149999676,194892,0,122,0.6359455881318709,5311999388,-808,-808,43103713.89999211,4882.083333656192,-990,0,0,0.19518685519772383,-5266597278,1634.4160974501854,1456.4133563194775,178.00274113070782,0.7794647917897758,0.7809080381935402,-990
1321,2020-08-14,2020,251964,251964,407236499.71666646,3874317.883333338,195324,0,57,0.8253440967757296,44373122,6039552045,252758,252758,77390,330148,364334695.28334415,3869794.2166662477,196194,0,57,0.6340520009208043,5319335374,-794,-794,42901804.43332231,4523.666667090263,-870,0,0,0.19129209585492535,-5274962252,1616.248748696903,1441.4368498063134,174.81189889058965,0.7752059818069248,0.7762128201679076,-870
1322,2020-08-15,2020,250240,250240,407791349.46666604,3881117.9833333334,194220,0,105,0.8255195012787715,44100754,6048060096,250960,250960,80509,331469,365026517.71667653,3875927.8999996297,195036,0,105,0.6270691980245479,5328013624,-720,-720,42764831.74998951,5190.083333703689,-816,0,0,0.19845030325422364,-5283912870,1629.6009809249763,1454.5207113351792,175.08026958979713,0.7761349104859335,0.7771597067261715,-816
1323,2020-08-16,2020,258905,258905,408584705.8166666,3959350.383333339,200762,0,243,0.8300689442073343,44853946,6055925187,259770,259770,78312,338082,366052299.48332554,3953689.4833331206,201742,0,246,0.6403091557669381,5339047388,-865,-865,42532406.33334106,5660.900000218302,-980,0,-3,0.1897597884403962,-5294193442,1578.1259760014932,1409.1400064800614,168.9859695214318,0.7754272802765493,0.7766177772645032,-980
1324,2020-08-17,2020,253417,253417,409073275.0833338,3914241.200000006,196686,0,90,0.8270597473729078,44570205,6066179358,254221,254221,86718,340939,366697073.4333478,3909499.6499996623,197603,0,90,0.6190227577367222,5352689713,-804,-804,42376201.64998597,4741.550000343472,-917,0,0,0.20803698963618555,-5308119508,1614.2298073267925,1442.4342341244344,171.79557320235813,0.7761357762107515,0.7772882649348402,-917
1325,2020-08-18,2020,251082,251082,409490804.0000001,3885768.8333333377,195137,0,39,0.8246150659943758,44228611,6074280109,251820,251820,80960,332780,367341046.183342,3881033.7999997446,195930,0,39,0.6259991586032784,5359229711,-738,-738,42149757.81665814,4735.033333593048,-793,0,0,0.19861590739109747,-5315001100,1630.904660628799,1458.7445245943213,172.16013603447777,0.7771843461498634,0.7780557541100787,-793
1326,2020-08-19,2020,254174,254174,409995737.6999996,3924081.016666663,197446,0,144,0.8263945171418008,44760217,6080793908,254958,254958,80624,335582,368017303.53334606,3919026.283332926,198369,0,144,0.6302334451788275,5370280957,-784,-784,41978434.166653514,5054.733333736658,-923,0,0,0.19616107196297328,-5325520740,1613.0514438927646,1443.4428554246035,169.6085884681611,0.7768143083084816,0.7780457957781282,-923
1327,2020-08-20,2020,254541,254541,410511379.6333332,3931762.9166666586,196883,0,83,0.8242837106792227,45258523,6091238061,255454,255454,80084,335538,368644372.66667753,3925773.083333148,197804,0,83,0.6291656980729456,5378642676,-913,-913,41867006.96665567,5989.83333351044,-921,0,0,0.19511801260627704,-5333384153,1612.7515002822067,1443.0949316380934,169.65656864411335,0.7734824645145576,0.7743233615445442,-921
1328,2020-08-21,2020,251033,251033,410423424.0333338,3923263.116666666,195144,0,38,0.8283134089940368,45192451,6090008167,251834,251834,80979,332813,368750447.683342,3917845.3833330516,195987,0,39,0.6283889150964779,5379621840,-801,-801,41672976.3499918,5417.733333614655,-843,0,-1,0.19992449389755895,-5334429389,1634.9381317728496,1464.2599795235828,170.67815224926676,0.7773639322320173,0.7782388398707085,-843
1329,2020-08-22,2020,253753,253753,410968776.3000003,3935320.35,196712,0,25,0.830532052823021,46255854,6098760195,254539,254539,79779,334318,369370343.31667566,3929135.699999664,197651,0,25,0.6344049677253442,5388022608,-786,-786,41598432.98332465,6184.650000336114,-939,0,0,0.19612708509767685,-5341766754,1619.5622368996635,1451.134573942208,168.4276629574556,0.7752105393827856,0.7765057613960925,-939
1330,2020-08-23,2020,254798,254798,411449326.13333327,3955501.8166666673,198078,0,69,0.83495553340293,45997368,6108070267,255457,255457,79659,335116,370037541.2166777,3950983.166666301,198893,0,69,0.6382864440969757,5397990527,-659,-659,41411784.91665554,4518.650000366382,-815,0,0,0.1966690893059544,-5351993159,1614.8059487646422,1448.5316167365847,166.27433202805742,0.7773922872236045,0.7785772165178484,-815
1331,2020-08-24,2020,251954,251954,411954488.83333343,3936872.6333333342,194825,0,88,0.8290005318431144,45234753,6119000359,252683,252683,82992,335675,370665519.03334546,3931419.183332977,195627,0,88,0.6257659938928983,5410136969,-729,-729,41288969.79998797,5453.4500003573485,-802,0,0,0.20323453795021607,-5364902216,1635.0384944606294,1466.9191003484423,168.11939411218714,0.7732562293116998,0.7741992931855328,-802
1332,2020-08-25,2020,245061,245061,412319008.1499996,3881496.13333333,191602,0,37,0.8384402250868153,44756217,6127766864,245756,245756,79266,325022,371141150.6166774,3876255.583332916,192416,0,37,0.6358400354437613,5419729381,-695,-695,41177857.533322215,5240.550000414252,-814,0,0,0.20260018964305393,-5374973164,1682.5158150419677,1510.2017880201395,172.31402702182822,0.781854313823905,0.7829554517488891,-814
1333,2020-08-26,2020,246619,246619,412322915.39999986,3846069.8000000007,194015,0,50,0.8405962233242374,44528075,6130886376,247350,247350,77672,325022,371213822.5333473,3840842.216666188,194905,0,50,0.6417873251656839,5428139457,-731,-731,41109092.86665255,5227.583333812654,-890,0,0,0.19880889815855352,-5383611382,1671.9024706125638,1500.7633819824027,171.13908863016104,0.7866993216256655,0.7879725085910653,-890
1334,2020-08-27,2020,246859,246859,412510543.5666664,3838305.3833333305,193381,0,26,0.8341401366772131,44171788,6136386400,247606,247606,79356,326962,371524784.6666836,3833737.3999998868,194190,0,21,0.6332570757458018,5435237335,-747,-747,40985758.89998281,4567.983333443757,-809,0,5,0.20088306093141128,-5391065547,1671.0370841924598,1500.4676165629412,170.5694676295186,0.7833662131014061,0.7842701711590188,-809
1335,2020-08-28,2020,254138,254138,413136643.83333355,3927710.88333333,196874,0,28,0.8276448228915007,44184715,6142639371,254755,254755,75573,330328,372267869.26667464,3922701.4833329944,197527,0,28,0.639412947131335,5436262081,-617,-617,40868774.566658914,5009.400000335649,-653,0,0,0.18823187576016565,-5392077366,1625.6389986280428,1461.2779700758558,164.361028552187,0.7746736025309084,0.7753606406154934,-653
1336,2020-08-29,2020,250920,250920,413157886.9833328,3939093.2833333327,194301,0,38,0.8296150167384024,43932063,6143915169,251391,251391,79877,331268,372490157.5166771,3934269.6499995925,194873,0,38,0.6307611963727222,5445506716,-471,-471,40667729.46665573,4823.63333374029,-572,0,0,0.19885382036568022,-5401574653,1646.5721623757884,1481.7163602383423,164.85580213744606,0.7743543758967002,0.775178904574945,-572
1337,2020-08-30,2020,254097,254097,413615923.16666657,3902194.5499999984,197216,0,40,0.8294273446754575,43899058,6150417099,254692,254692,79052,333744,372962256.7666778,3896979.1666662777,197999,0,40,0.6347679658660559,5449811665,-595,-595,40653666.39998877,5215.3833337207325,-783,0,0,0.19465937880940165,-5405912607,1627.7875109374238,1464.3658095530202,163.4217013844036,0.7761445432256185,0.7774056507467844,-783
1338,2020-08-31,2020,257337,257337,414033457.3500002,3957155.183333328,198720,0,63,0.8302692578214558,44064622,6156421606,257878,257878,84246,342124,373518739.3500154,3952174.6166663277,199429,0,63,0.6273982532648944,5457642959,-541,-541,40514717.9999848,4980.5666670002975,-709,0,0,0.20287100455656137,-5413578337,1608.9153808041603,1448.4319691870396,160.48341161712074,0.7722169761829818,0.7733463110463087,-709
1339,2020-09-01,2020,260362,260362,414390715.46666616,4083947.483333334,201228,0,51,0.8339619452915557,44204874,6157221195,260893,260893,81069,341962,373984722.33334506,4078843.866666509,201867,0,51,0.6376995104719277,5463156039,-531,-531,40405993.13332111,5103.616666825023,-639,0,0,0.1962624348196279,-5418951165,1591.5944548999707,1433.4793280515194,158.11512684845138,0.772877762499904,0.7737539910997996,-639
1340,2020-09-02,2020,265725,265725,415210358.99999994,4057109.3333333405,203563,0,131,0.8276300686800265,44236621,6166793125,266157,266157,81238,347395,374940167.4166821,4051478.9499996956,204212,0,131,0.6356050029505323,5468817946,-432,-432,40270191.583317816,5630.38333364483,-649,0,0,0.19202506572949418,-5424581325,1562.556624329664,1408.7180401668268,153.83858416283715,0.7660664220528742,0.7672614284050391,-649
1341,2020-09-03,2020,260914,260914,415213001.6500002,4004893.6333333333,200731,0,230,0.826483055719508,44263530,6149758299,261559,261558,89237,350796,375161372.0833458,3999793.766666335,201547,0,232,0.6180372638228563,5460298927,-645,-644,40051629.566654444,5099.866666998249,-816,0,-2,0.2084457918966517,-5416035397,1591.3787748070254,1434.3333871773975,157.04538762962784,0.7693377894631948,0.7705603707003009,-816
1342,2020-09-04,2020,269148,269148,416099946.6166667,4097490.216666669,205913,0,180,0.8187651403688667,44493114,6161179712,269595,269595,82159,351754,376133273.0666758,4093505.249999539,206448,0,180,0.6287689692228028,5465470252,-447,-447,39966673.54999089,3984.966667130124,-535,0,0,0.18999617114606393,-5420977138,1545.9893687364079,1395.1789649907298,150.81040374567806,0.7650549140249974,0.7657708785400322,-535
1343,2020-09-05,2020,270532,270532,416453925.23333347,4135720.216666665,206658,0,180,0.822368518326853,44475094,6167990713,271000,271000,86676,357676,376554404.0166798,4131169.0666662687,207308,0,180,0.6244478242878939,5476458678,-468,-468,39899521.216653645,4551.150000396185,-650,0,0,0.19792069403895907,-5431983584,1539.3887792694893,1389.4996458180067,149.88913345148262,0.7638948442328449,0.7649741697416974,-650
1344,2020-09-06,2020,268949,268949,417119126.7500001,4129140.066666664,206664,0,150,0.8283466382102183,44357207,6174935954,269457,269457,86736,356193,377380575.1166761,4124523.566666482,207399,0,150,0.6282605216834706,5485303446,-508,-508,39738551.63332403,4616.500000182074,-735,0,0,0.20008611652674768,-5440946239,1550.9227650967289,1400.5224400059233,150.4003250908056,0.7684133423065339,0.7696923813447043,-735
1345,2020-09-07,2020,267581,267581,417562776.3999997,4052377.466666666,205012,0,80,0.8218782350017378,45018209,6184277146,268210,268210,91109,359319,377911694.4166787,4047749.149999629,205778,0,79,0.6151720337638735,5497499758,-629,-629,39651081.98332095,4628.316667037085,-766,0,1,0.20670620123786432,-5452481549,1560.5098134770394,1409.0141844699256,151.49562900711385,0.766168001464977,0.7672271727377801,-766
1346,2020-09-08,2020,259682,259682,417626445.3166664,4014474.0499999933,196369,0,84,0.8132215555949194,45035099,6188571343,260247,260247,89985,350232,378117037.4666798,4009481.833332931,197090,0,84,0.6059469151876484,5502546952,-565,-565,39509407.84998661,4992.216667062137,-721,0,0,0.20727464040727095,-5457511853,1608.2225387846152,1452.916027722432,155.30651106218306,0.7561902634760976,0.7573190084804051,-721
1347,2020-09-09,2020,261137,261137,418258263.6333335,4034282.7666666666,198758,0,33,0.8175976594661034,44460015,6194211927,261572,261572,81480,343052,378805997.46667814,4030007.566666416,199315,0,26,0.6247944917971673,5507784281,-435,-435,39452266.16665536,4275.200000250712,-557,0,7,0.19280316766893613,-5463324266,1601.681353593453,1448.1901635751462,153.49119001830672,0.7611253862914868,0.7619890508158366,-557
1348,2020-09-10,2020,259324,259324,418932482.8833328,4013825.883333332,196041,0,40,0.8103569280128324,45262181,6202182226,260413,260413,81525,341938,379625591.7000109,4010069.8333329023,196693,0,40,0.6170650819739235,5516202593,-1089,-1089,39306891.18332189,3756.050000429619,-652,0,0,0.19329184603890892,-5470940412,1615.4790257875584,1457.7827977098336,157.69622807772475,0.7559693665067637,0.7553117547895074,-652
1349,2020-09-11,2020,255748,255748,419044180.8833336,3959396.3999999985,197130,0,38,0.8301374790809705,46226386,6209303121,256449,256449,84385,340834,379775588.1666749,3955015.9333328456,197905,0,33,0.62646038834154,5522453117,-701,-701,39268592.71665871,4380.466667152941,-775,0,5,0.2036770907394304,-5476226731,1638.504234181044,1480.9010297044438,157.60320447660024,0.7707978166007163,0.7717128941816892,-775
1350,2020-09-12,2020,253486,253486,418868589.91666657,3945206.833333331,196517,0,44,0.8303141001869916,46342960,6207806710,254097,254097,83986,338083,379748586.9000139,3939945.3166662324,197310,0,33,0.6258788522344991,5528637076,-611,-611,39120003.01665264,5261.516667098738,-793,0,11,0.20443524795249246,-5482294116,1652.4328361987114,1494.5024415873227,157.9303946113887,0.7752578051647823,0.776514480690445,-793
1351,2020-09-13,2020,252692,252692,419289023.71666676,3927469.100000001,195178,0,35,0.8277863960869358,46306071,6219973094,253456,253456,81062,334518,380221025.56667423,3923137.949999485,196066,0,35,0.6291948415332006,5536335510,-764,-764,39067998.149992526,4331.15000051586,-888,0,0,0.19859155455373523,-5490029439,1659.28887228985,1500.1460828178233,159.1427894720266,0.7723948522311747,0.7735701660248722,-888
1352,2020-09-14,2020,257956,257956,419956982.983333,3988588.5000000005,196325,0,27,0.8176743320566302,46243513,6232723496,265153,265153,81708,346861,380973591.3500196,3989332.8499994827,199595,0,25,0.6187608292658956,5548614437,-7197,-7197,38983391.63331342,-744.3499994822778,-3270,0,2,0.1989135027907346,-5502370924,1628.0178905834057,1436.8066412600256,191.21124932338012,0.7610794088914389,0.7527540702914921,-3270
1353,2020-09-15,2020,260448,260448,420389001.16666704,3992888.1999999997,196635,0,30,0.8154871605848376,46565974,6239412323,261016,261016,86855,347871,379888060.51667655,3988587.699999565,197335,0,30,0.6133969201226903,5507711413,-568,-568,40500940.6499905,4300.500000434928,-700,0,0,0.2020902404621473,-5461145439,1614.099556021421,1455.4205892231762,158.6789667982448,0.7549875598967932,0.756026450485794,-700
1354,2020-09-16,2020,262362,262362,421038654.38333344,3992684.916666673,199951,0,29,0.8206447580061142,46335024,6251150541,262852,262852,84018,346870,380558214.9166775,3988100.4499995233,200594,0,31,0.6233026782368075,5510119014,-490,-490,40480439.46665597,4584.466667149682,-643,0,-2,0.19734207976930673,-5463783990,1604.8004451228967,1447.8041442206165,156.99630090228015,0.7621187519534078,0.7631442789098047,-643
1355,2020-09-17,2020,254798,254798,421399692.88333356,3981613.5666666646,195291,0,101,0.8254421149302599,46882858,6258517111,255248,255248,87021,342269,381045568.66667736,3977349.1166661372,195851,0,101,0.6167634229217354,5520271331,-450,-450,40354124.21665621,4264.450000527315,-560,0,0,0.2086786920085245,-5473388473,1653.8579301381235,1492.8444832738253,161.0134468642982,0.7664542107865839,0.7672969034037486,-560
1356,2020-09-18,2020,253834,253834,421636469.63333327,3969218.416666669,195194,0,29,0.8251179904977269,47243212,6266733993,254429,254429,82094,336523,381400468.35001004,3964955.7999994582,195924,0,31,0.6253539876917797,5530549661,-595,-595,40236001.28332323,4262.61666721059,-730,0,-2,0.1997640028059472,-5483306449,1661.0716831997813,1499.0447957976883,162.02688740209305,0.7689828785741862,0.7700537281520582,-730
1357,2020-09-19,2020,257564,257564,422071033.51666665,4031454.7333333343,197010,0,32,0.8193109285459157,47269975,6274838622,258077,258077,79358,337435,381942316.26667595,4026484.0999994054,197676,0,32,0.6280765184405886,5539714765,-513,-513,40128717.2499907,4970.633333928883,-666,0,0,0.19123441010532705,-5492444790,1638.7035203548114,1479.9548827159178,158.74863763889357,0.7648972682517743,0.7659574468085106,-666
1358,2020-09-20,2020,255154,255154,422558073.4333331,3941337.883333331,195606,0,133,0.8203359539728944,47207424,6285081892,255538,255538,81111,336649,382517773.71667767,3937225.299999469,196155,0,133,0.624190180276789,5550663588,-384,-384,40040299.71665543,4112.583333862014,-549,0,0,0.19614577369610542,-5503456164,1656.0903353791557,1496.9115110734124,159.17882430574332,0.766619374965707,0.7676157753445672,-549
1359,2020-09-21,2020,254103,254103,423157503.4166671,3940057.2500000037,193124,0,219,0.822544401286093,47019877,6298243500,254481,254481,86474,340955,383143973.0166798,3935731.049999778,193677,0,219,0.6151750230968953,5561548313,-378,-378,40013530.39998728,4326.200000225566,-553,0,0,0.20736937818919765,-5514528436,1665.299124436418,1505.5897022437032,159.70942219271478,0.7600225105567427,0.7610666415174414,-553
1360,2020-09-22,2020,257370,257370,423867133.6999999,3971738.6833333317,195724,0,48,0.8220305396899398,47728715,6309503930,257928,257928,79894,337822,384014200.3000171,3967181.2833330836,196262,0,48,0.6284789030909796,5576258318,-558,-558,39852933.39998281,4557.400000248104,-538,0,0,0.19355163659896013,-5528529603,1646.9174095659941,1488.842623910615,158.07478565537917,0.7604771340871119,0.7609177755032412,-538
1361,2020-09-23,2020,252524,252524,424528607.8999996,3969348.316666668,194168,0,32,0.8294459140517328,48324942,6319430392,252986,252986,81115,334101,384656211.6833401,3965927.7833328415,194600,0,32,0.6287230508139796,5586004440,-462,-462,39872396.216659546,3420.5333338263445,-432,0,0,0.20072286323775324,-5537679498,1681.1416257464623,1520.4644197044108,160.67720604205147,0.7689090937891052,0.7692125255943016,-432
1362,2020-09-24,2020,252014,252014,424858957.6166665,3959741.766666669,195403,0,27,0.8382232733102133,47798493,6325897879,252473,252473,79212,331685,385132974.4333449,3955958.766666272,195939,0,27,0.6392299923119863,5599236365,-459,-459,39725983.183321595,3783.0000003967434,-536,0,0,0.198993280998227,-5551437872,1685.8545859224746,1525.4422232608829,160.41236266159171,0.7753656542890475,0.7760790262721162,-536
1363,2020-09-25,2020,249174,249174,425410958.99999994,3922613.5500000003,192755,0,130,0.83427644938878,47236681,6336122473,249548,249548,79247,328795,385832844.7500139,3918470.3666662117,193271,0,130,0.6346629358718918,5611192003,-374,-374,39578114.24998605,4143.183333788533,-516,0,0,0.19961351351688816,-5563955322,1707.2847046642103,1546.1267762114458,161.1579284527645,0.7735758947562748,0.7744842675557407,-516
1364,2020-09-26,2020,246688,246688,425309822.01666653,3901247.0666666655,191145,0,36,0.8322496432740951,47608983,6339260613,247138,247138,78987,326125,385794514.86667717,3896358.816666135,191726,0,36,0.6322177079340753,5620709904,-450,-450,39515307.14998937,4888.250000530388,-581,0,0,0.20003193534001984,-5573100921,1724.0798985628264,1561.0489478213676,163.0309507414588,0.7748451485276949,0.7757851888418617,-581
1365,2020-09-27,2020,247608,247608,425836018.3833337,3889786.150000003,191291,0,32,0.8292300733417338,47437000,6351337999,248091,248091,78119,326210,386472741.7666811,3885658.3333328036,191898,0,30,0.6319947273228816,5627548134,-483,-483,39363276.61665261,4127.8166671996005,-607,0,2,0.19723534601885218,-5580111134,1719.7991114315114,1557.7862226629788,162.01288876853255,0.7725558140286259,0.7734984340423474,-607
1366,2020-09-28,2020,251848,251848,426544537.2666667,3933707.6000000024,193329,0,39,0.8262602839808136,47444063,6365030022,252303,252303,78291,330594,387270818.5500108,3928990.8999997526,193997,0,41,0.6322256302292226,5641547043,-455,-455,39273718.71665591,4716.700000249781,-668,0,-2,0.194034653751591,-5594102980,1693.6586245142576,1534.9433758219711,158.71524869228642,0.7676415933420159,0.7689048485352928,-668
1367,2020-09-29,2020,249810,249810,426655485.5000002,3905638.2500000075,193647,0,39,0.8358072134822457,47217176,6371751720,250418,250418,78889,329307,387469360.8333424,3900839.816666212,194351,0,39,0.6369983024958414,5652587271,-608,-608,39186124.666657805,4798.433333795518,-704,0,0,0.1988089109864043,-5605370095,1707.9199611704903,1547.2903738283285,160.6295873421618,0.775177134622313,0.7761063501824949,-704
1368,2020-09-30,2020,244628,244628,426555274.1166667,3837067.449999999,190259,0,26,0.841453145183708,47465341,6378207040,245283,245283,80892,326175,387489496.4000147,3832503.3999994583,191071,0,26,0.6347819422089355,5663694176,-655,-655,39065777.716651976,4564.0500005404465,-812,0,0,0.20667120297477248,-5616228835,1743.6894963645482,1579.7649914589053,163.92450490564283,0.7777482544925356,0.7789818291524484,-812
1369,2020-10-01,2020,237785,237785,426565377.56666654,3777975.6,184684,0,40,0.8376768929915676,47798015,6387034863,238275,238275,79241,317516,387569716.5166839,3773545.2999995025,185306,0,40,0.6302013126897563,5671105609,-490,-490,38995661.04998267,4430.300000497606,-622,0,0,0.20747558030181124,-5623307594,1793.9120531853,1626.5647529815712,167.34730020372876,0.7766848203208782,0.7776980379813241,-622
1370,2020-10-02,2020,246511,246511,426864634.7833335,3859004.5000000033,189541,0,33,0.8336382554936691,48166117,6395758132,247071,247071,74706,321777,388019990.71667695,3854895.8499994967,190227,0,33,0.6418793139348137,5680350871,-560,-560,38844644.06665653,4108.650000506546,-686,0,0,0.19175894155885542,-5632184754,1731.62509901519,1570.4797030678508,161.14539594733924,0.7688946943544102,0.7699284820962395,-686
1371,2020-10-03,2020,250609,250609,427227881.8333334,3900206.6833333317,191077,0,32,0.8288449337414051,48982865,6408005981,251147,251147,75862,327009,388390643.5500116,3895027.266666177,191733,0,33,0.6380344271870279,5689069943,-538,-538,38837238.2833218,5179.4166671545245,-656,0,-1,0.19081050655437726,-5640087078,1704.75873505474,1546.467381852109,158.29135320263117,0.762450670167472,0.7634293859771369,-656
1372,2020-10-04,2020,248922,248922,427406811.7000004,3839366.483333332,190174,0,255,0.8308626798756235,49728174,6416619305,249448,249448,81443,330891,388690182.2500117,3833684.6999997026,190900,0,255,0.628282425330406,5703636009,-526,-526,38716629.44998872,5681.78333362937,-726,0,0,0.20258025454521744,-5653907835,1717.0310848378224,1558.201237332076,158.82984750574633,0.7639903262869493,0.7652897597896154,-726
1373,2020-10-05,2020,244774,244774,427623412.68333346,3835706.1166666728,189103,0,77,0.8338794152973767,49472376,6430719217,245481,245481,87469,332950,388959006.5333413,3830908.4999995716,189829,0,77,0.6162486859888909,5717726374,-707,-707,38664406.14999217,4797.61666710116,-726,0,0,0.21763072930848582,-5668253998,1747.0132149792603,1584.4770329815394,162.53618199772086,0.7725616282775132,0.7732940634916755,-726
1374,2020-10-06,2020,241809,241809,428075334.38333344,3870662.799999998,186227,0,80,0.8312924663680835,49778589,6438705284,242362,242362,75827,318189,389577707.1833435,3866319.249999516,186966,0,81,0.6349245259892682,5731456058,-553,-553,38497627.199989915,4343.550000481773,-739,0,-1,0.19636794037881533,-5681677469,1770.3035634874361,1607.420747408189,162.88281607924705,0.7701408963272666,0.7714328153753476,-739
1375,2020-10-07,2020,246697,246697,428940643.9166665,3906336.2333333306,191143,0,88,0.8419599751922396,49710588,6453169201,247358,247358,73110,320468,390449815.916677,3901526.0999996504,191904,0,88,0.651634484566326,5739675380,-661,-661,38490827.99998951,4810.13333368022,-761,0,0,0.19032549062591364,-5689964792,1738.7347390388472,1578.4806471457441,160.25409189310312,0.7748087735156893,0.7758148109218218,-761
1376,2020-10-08,2020,243374,243374,429531556.0166669,3908079.7666666713,188245,0,107,0.8395391455126673,49696247,6464635753,243992,243992,75376,319368,391157773.0000155,3903061.749999502,188982,0,108,0.6434865108589403,5753781731,-618,-618,38373783.01665139,5018.016667169053,-737,0,-1,0.19605263465372702,-5704085484,1764.9032189825818,1603.1581896128378,161.7450293697441,0.7734803224666562,0.7745417882553526,-737
1377,2020-10-09,2020,253948,253948,429890182.4000002,3922791.2833333327,196538,0,252,0.8400263045977919,49763625,6473067964,254593,254593,75287,329880,391652723.56667805,3917749.349999548,197304,0,254,0.6503182975627438,5767005816,-645,-645,38237458.83332217,5041.9333337848075,-766,0,-2,0.1897080070350481,-5717242191,1692.8275962007979,1538.3483582293231,154.47923797147473,0.77393009592515,0.7749781023044624,-766
1378,2020-10-10,2020,245908,245908,429700059.0666659,3862197.1166666676,189805,0,187,0.832860256681361,48378359,6475766505,246368,246368,84128,330496,391427555.03334427,3858725.5999995586,190479,0,187,0.6226338594113111,5776099624,-460,-460,38272504.03332162,3471.516667108983,-674,0,0,0.21022639727004988,-5727721265,1747.4017074136095,1588.792193114951,158.6095142986585,0.7718537013842576,0.7731482984803221,-674
1379,2020-10-11,2020,248804,248804,429827809.216666,3810419.6999999997,191596,0,77,0.8322052700117365,49886156,6487672413,249212,249212,78624,327836,391600495.9500128,3805629.6999995005,192163,0,77,0.6344666235556794,5783307700,-408,-408,38227313.26665318,4790.000000499189,-567,0,0,0.1977386464560571,-5733421544,1727.5759602605503,1571.3548944272861,156.22106583326422,0.7700680053375347,0.7710824518883521,-567
1380,2020-10-12,2020,242814,242814,429428679.01666725,3780000.016666662,186337,0,52,0.8309982126236549,49721445,6472087210,243582,243582,83785,327367,391543385.36667395,3776396.8333328785,187218,0,52,0.6203252007685549,5773005801,-768,-768,37885293.6499933,3603.1833337834105,-881,0,0,0.2106730118551,-5723284356,1768.5499148182034,1607.439734326321,161.11018049188237,0.7674063274769989,0.7686035913983792,-881
1381,2020-10-13,2020,239210,239210,429554636.5500001,3756789.4333333285,183833,0,61,0.8347142677981688,50223615,6483833745,239921,239921,78248,318169,391709512.98334455,3752567.1333328937,184564,0,61,0.6310011346171436,5783489660,-711,-711,37845123.56665552,4222.300000434741,-731,0,0,0.20371313318102524,-5733266045,1795.7219035575438,1632.660388141699,163.06151541584472,0.7685004807491326,0.7692698846703707,-731
1382,2020-10-14,2020,241439,241439,430017874.36666685,3788435.3833333375,186349,0,77,0.8368780520131375,50707738,6496262943,242137,242137,76131,318268,392224011.6333431,3783577.833332918,187201,0,78,0.6385216232860396,5795706514,-698,-698,37793862.73332375,4857.550000419375,-852,0,-1,0.1983564287270979,-5744998776,1781.0621911400679,1619.8433598885883,161.21883125147951,0.771826424065706,0.7731201757682634,-852
1383,2020-10-15,2020,244717,244717,430671723.5666666,3828230.366666668,189410,0,86,0.8391407217316331,50404415,6510425000,245570,245570,75869,321439,392886105.8500146,3824024.966666205,190219,0,86,0.6425200426830687,5809097676,-853,-853,37785617.716651976,4205.40000046324,-809,0,0,0.1966206790485644,-5758693261,1759.8766067198708,1599.894554913119,159.98205180675177,0.7739960852740104,0.7746019464918353,-809
1384,2020-10-16,2020,247249,247249,431069404.16666675,3847432.033333331,191508,0,77,0.8404078479589399,50673803,6519006837,247960,247960,76729,324689,393318326.6833389,3842347.0166662266,192354,0,77,0.6438099227260542,5818107582,-711,-711,37751077.483327866,5085.016667104326,-846,0,0,0.19659792523288566,-5767433779,1743.462679997358,1586.2168361160625,157.2458438812955,0.7745552054811142,0.7757460880787224,-846
1385,2020-10-17,2020,243647,243647,431250769.7333344,3836987.3833333342,188800,0,73,0.838151095642466,51172322,6530525964,243988,243988,79702,323690,393628680.8666754,3830986.9333328176,189430,0,73,0.6337792332169623,5830885687,-341,-341,37622088.866659045,6000.450000516605,-630,0,0,0.20437186242550376,-5779713365,1769.9818579064565,1613.3116418294153,156.67021607704123,0.7748915439139411,0.7763906421627293,-630
1386,2020-10-18,2020,241395,241395,431442475.54999995,3808289.683333334,187476,0,219,0.8394912902089936,50939992,6537379466,242013,242013,77058,319071,393955799.3666768,3804674.9999995106,188270,0,221,0.6392370350172814,5843603156,-618,-618,37486676.183323145,3614.6833338234574,-794,0,-2,0.20025425519171225,-5792663164,1787.2883678203773,1627.8290809447294,159.45928687564788,0.7766358043870005,0.777933416799924,-794
1387,2020-10-19,2020,244564,244564,432090869.55000025,3841481.483333333,188222,0,105,0.8316350730279191,51315360,6549859806,248645,248645,76360,325005,394719001.383348,3838794.549999523,189585,0,109,0.6313041337825619,5853694629,-4081,-4081,37371868.16665226,2686.933333809953,-1363,0,-4,0.20033093924535716,-5802379269,1766.7803501332994,1587.4801479352006,179.30020219809876,0.7696226754550956,0.7624726015001307,-1363
1388,2020-10-20,2020,246103,246103,432535446.74999976,3833994.783333335,188755,0,37,0.8295307249403706,51130472,6562084911,246898,246898,78781,325679,395175040.5333462,3829109.399999504,189628,0,37,0.6304981285253172,5863564063,-795,-795,37360406.216653585,4885.383333831094,-873,0,0,0.19903259641505344,-5812433591,1757.538293925713,1600.559909490341,156.97838443537216,0.7669756159006594,0.7680418634415832,-873
1389,2020-10-21,2020,245467,245467,432733196.4000003,3835132.5166666657,188565,0,61,0.8323970228177313,50786092,6572951954,246034,246034,78773,324807,395418964.3166821,3830330.9666662556,189308,0,61,0.6324740538227333,5874526428,-567,-567,37314232.083318174,4801.550000410061,-743,0,0,0.19992296899499806,-5823740336,1762.897645712052,1607.1720344207797,155.72561129127234,0.7681887993090721,0.769438370306543,-743
1390,2020-10-22,2020,240306,240306,432881267.10000056,3804346.483333333,185618,0,126,0.8325842883656668,51069163,6582578999,240914,240914,79104,320018,395684327.6333437,3800083.866666235,186347,0,125,0.6283677793124152,5887220218,-608,-608,37196939.46665686,4262.6166670979,-729,0,1,0.20421650905325162,-5836151055,1801.3751928790814,1642.429778399527,158.9454144795543,0.7724234933792747,0.7735000871680351,-729
1391,2020-10-23,2020,245377,245377,433139604.28333354,3817777.2666666703,189993,0,134,0.8359748468682889,50556955,6592639847,246054,246054,77351,323405,396039470.90001523,3813516.9666661704,190734,0,136,0.6375473477528099,5897865212,-677,-677,37100133.383318305,4260.300000499934,-741,0,-2,0.19842749911547908,-5847308257,1765.2005048693786,1609.563229616325,155.63727525305353,0.7742901738956789,0.7751713038601282,-741
1392,2020-10-24,2020,246281,246281,433144959.5666661,3827193.0500000026,189562,0,61,0.82811097892245,50354298,6599454894,246880,246880,79906,326786,396049044.8666793,3823174.016666171,190349,0,61,0.6275789048490442,5906826026,-599,-599,37095914.699986815,4019.0333338314667,-787,0,0,0.20053207407340579,-5856471728,1758.7428976115336,1604.2168051955578,154.52609241597588,0.7696980278624823,0.7710183084899547,-787
1393,2020-10-25,2020,247693,247693,433775367.0000002,3872216.6333333296,189926,0,86,0.8244480062012246,50708152,6614016125,248414,248414,78774,327188,396694544.9666765,3867303.1333328616,190743,0,87,0.6275046762106182,5912286283,-721,-721,37080822.033323705,4913.50000046799,-817,0,-1,0.19694332999060638,-5861578131,1751.262114795332,1596.9089703747634,154.3531444205687,0.7667798444041616,0.7678431972433115,-817
1394,2020-10-26,2020,251649,251649,434785836.2333331,3904222.600000003,192168,0,87,0.8244578758508873,50451073,6630230951,252571,252571,77558,330129,397756797.0666784,3902805.366666163,193262,0,88,0.6327465929985036,5927220944,-922,-922,37029039.166654706,1417.233333840035,-1094,0,-1,0.1917112828523837,-5876769871,1727.7471248975085,1574.8316198877876,152.91550500972085,0.7636350631236365,0.7651789001904415,-1094
1395,2020-10-27,2020,250881,250881,435494942.2333332,3853192.733333337,190965,0,114,0.8228323388379346,50096189,6645147921,251369,251369,80513,331882,398469540.4666804,3848967.0166661595,191583,0,114,0.624468937754976,5937358798,-488,-488,37025401.76665276,4225.716667177621,-618,0,0,0.19836340108295858,-5887262609,1735.8625891691008,1585.1976197012377,150.6649694678631,0.7611776101020006,0.7621584204894001,-618
1396,2020-10-28,2020,244863,244863,435543995.9666675,3817340.716666668,187626,0,78,0.8270543120030391,49296369,6651123804,245394,245394,82163,327557,398573645.0166818,3812952.666666221,188294,0,78,0.6209789441227073,5951118247,-531,-531,36970350.94998568,4388.050000447314,-668,0,0,0.20607536788033187,-5901821878,1778.725229890459,1624.2191945063114,154.5060353841477,0.7662488820279095,0.7673129742373489,-668
1397,2020-10-29,2020,247005,247005,436168889.1333331,3863570.4666666663,189750,0,88,0.8282544887755308,49833543,6663997461,247546,247546,77641,325187,399222975.10001093,3859528.9499995233,190408,0,88,0.6321900936999373,5957312356,-541,-541,36945914.033322155,4041.516667142976,-658,0,0,0.19606439507559348,-5907478813,1765.8302023575761,1612.7223833146604,153.1078190429157,0.7682030728122913,0.7691822933919352,-658
1398,2020-10-30,2020,250896,250896,436436928.9333336,3860495.283333338,193270,0,143,0.8372313627957396,50948365,6671024560,251444,251444,77643,329087,399549867.1166805,3856307.649999546,193927,0,145,0.6414473984083264,5972239607,-548,-548,36887061.81665307,4187.633333791979,-657,0,-2,0.1957839643874132,-5921291242,1739.5133000658982,1589.021281544521,150.4920185213773,0.7703191760729545,0.7712532412783761,-657
1399,2020-10-31,2020,248316,248316,435092924.95000005,3793438.6666666614,188582,0,49,0.8187833244736551,50990859,6670121631,248919,248919,85146,334065,398455986.3333411,3788442.3833328965,189375,0,50,0.6119437833954411,5981791305,-603,-603,36636938.616658926,4996.283333764877,-793,0,-1,0.206839541078214,-5930800446,1752.1743461959763,1600.745569174475,151.42877702150145,0.7594436121715878,0.7607896544659106,-793
1400,2020-11-01,2020,245979,245979,434581591.4333334,3789402.649999999,184715,0,43,0.81202866911403,51142939,6672369787,246740,246740,83433,330173,398115488.8833451,3785880.6166661736,185657,0,44,0.6091352109348734,5983825036,-761,-761,36466102.54998827,3522.033333825413,-942,0,-1,0.2028934581791566,-5932682097,1766.7426545897551,1613.5020218989428,153.2406326908124,0.7509380882107822,0.7524398151900786,-942
1401,2020-11-02,2020,244889,244889,434642293.31666666,3733008.3999999966,183071,0,105,0.8097015382479407,50888379,6686186499,245456,245456,83270,328726,398267837.48334086,3729101.483332929,183833,0,105,0.6066663421816371,5987176334,-567,-567,36374455.8333258,3906.916667067446,-762,0,0,0.2030351960663036,-5936287955,1774.8542944626613,1622.5630560399454,152.29123842271588,0.7475672651691174,0.748944821067727,-762
1402,2020-11-03,2020,239489,239489,433928515.71666694,3712600.7999999993,179470,0,246,0.8086676214773963,49710404,6686839248,240163,240163,84560,324723,397666555.8833456,3707989.2833328815,180198,0,248,0.5995602405742702,5997059692,-674,-674,36261959.83332133,4611.51666711783,-728,0,-2,0.2091073809031262,-5947349288,1811.8933049813015,1655.8194055010372,156.07389948026434,0.7493872369920956,0.7503154107835095,-728
1403,2020-11-04,2020,245911,245911,434102976.49999964,3742992.9500000044,182210,0,232,0.7955154507118416,49807265,6694559542,246643,246643,78551,325194,397907735.43334985,3738403.4666661043,183029,0,228,0.6051649169418838,5999490532,-732,-732,36195241.066649795,4589.483333900105,-819,0,4,0.1903505337699578,-5949683267,1765.2849059212465,1613.2942570166185,151.99064890462796,0.7409591274892136,0.7420806590902641,-819
1404,2020-11-05,2020,243323,243323,434133604.43333316,3740636.5999999954,179706,0,226,0.7946186755875929,49825431,6701687732,243944,243944,80975,324919,398014471.3666795,3736924.8333328334,180440,0,226,0.5983614377737241,6006676389,-621,-621,36119133.06665367,3711.766667162068,-734,0,0,0.19625723781386883,-5956850958,1784.1864699733817,1631.5813111479663,152.6051588254154,0.738549171266177,0.7396779588758076,-734
1405,2020-11-06,2020,248679,248679,434385205.93333375,3766156.399999999,181430,0,99,0.7837412889709221,49857111,6712385526,249340,249340,80775,330115,398230413.6500102,3762024.099999558,182225,0,100,0.5941384063129602,6017957286,-661,-661,36154792.28332353,4132.300000440795,-795,0,-1,0.18960288265796188,-5968100175,1746.7707604314548,1597.138099181881,149.63266124957386,0.7295750746946867,0.7308293895885136,-795
1406,2020-11-07,2020,236291,236291,434216892.8166673,3654254.566666666,174732,0,27,0.7929967709307589,49224068,6720258717,236733,236733,85956,322689,398146095.23334247,3650459.1833328633,175377,0,27,0.5837974024525161,6024592397,-442,-442,36070797.58332485,3795.383333802689,-645,0,0,0.20919936847824283,-5975368329,1837.636189345626,1681.8360567953875,155.80013255023846,0.7394780165135363,0.7408219386397333,-645
1407,2020-11-08,2020,233345,233345,434054337.4833333,3613956.0166666694,172355,0,29,0.7914632839786581,49084002,6726501877,233778,233778,82514,316292,398106475.3333417,3609160.749999525,173002,0,30,0.5868817421875987,6034474368,-433,-433,35947862.14999157,4795.266667144373,-647,0,-1,0.20458154179105936,-5985390366,1860.1398679351744,1702.92531946266,157.21454847251448,0.7386273543465683,0.7400268630923355,-647
1408,2020-11-09,2020,237664,237664,434738234.99999964,3697007.6833333345,175704,0,61,0.7900523428032858,49597087,6742416371,238198,238198,77641,315839,398825717.5500081,3693280.899999514,176374,0,61,0.5975766134011419,6046034710,-534,-534,35912517.449991524,3726.783333820291,-670,0,0,0.19247572940214397,-5996437623,1829.2136587787786,1674.3453662499605,154.86829252881807,0.7392958125757372,0.7404512212529073,-670
1409,2020-11-10,2020,245371,245371,435300122.0166665,3820357.950000001,187551,0,56,0.8176434868016195,50206141,6749937108,245856,245856,74557,320413,399435523.76668334,3816185.983332889,188170,0,57,0.6289632443128108,6058324482,-485,-485,35864598.24998313,4171.966667111963,-619,0,-1,0.18868024248880866,-6008118341,1774.0487751880478,1624.6726692319216,149.37610595612614,0.7643568310843579,0.7653667187296629,-619
1410,2020-11-11,2020,244775,244775,435914318.5333338,3813636.299999996,185444,0,52,0.8114145643958734,50225443,6756723610,245358,245358,75602,320960,400138689.4666784,3809487.4333328735,186205,0,52,0.6218936939182432,6069527274,-583,-583,35775629.0666554,4148.86666712258,-761,0,0,0.18952087047763022,-6019301831,1780.877616314304,1630.8361229985505,150.04149331575354,0.7576100500459606,0.7589114681404315,-761
1411,2020-11-12,2020,244607,244607,436266539.51666623,3793248.9666666663,183345,0,27,0.8053898702817174,50270780,6769124072,245203,245203,78316,323519,400634544.6500106,3788757.6666661967,184068,0,28,0.6121804283519714,6077797094,-596,-596,35631994.86665565,4491.300000469666,-723,0,-1,0.19320944192974598,-6027526314,1783.5406980040075,1633.8892454415752,149.65145256243227,0.7495492770035199,0.7506759705223834,-723
1412,2020-11-13,2020,244160,244160,436461778.66666687,3764848.1833333303,181905,0,34,0.799172673656618,51270961,6780464469,244705,244705,79373,324078,400928459.83334386,3760359.3999995347,182574,0,34,0.6049778139830491,6090718960,-545,-545,35533318.833323,4488.783333795611,-669,0,0,0.19419485967356898,-6039447999,1787.605581039756,1638.4154791824599,149.1901018572962,0.74502375491481,0.7460983633354448,-669
1413,2020-11-14,2020,243981,243981,436230339.98333335,3742832.3999999966,178941,0,33,0.7888892987568704,51903006,6786922958,244734,244733,80927,325661,400800536.7333467,3738620.1166661265,179847,0,33,0.5949990941500459,6101184405,-753,-752,35429803.24998665,4212.283333870117,-906,0,0,0.1938902046068245,-6049281399,1787.9684892812693,1637.7053226714283,150.26316660984094,0.7334218648173423,0.7348672436196033,-906
1414,2020-11-15,2020,246366,246366,436626732.63333344,3764534.8999999976,180453,0,42,0.7912008962275635,51840647,6800978080,247051,247051,80926,327977,401170867.5500145,3761881.549999491,181231,0,43,0.5986273427709888,6110008825,-685,-685,35455865.08331895,2653.3500005067326,-778,0,-1,0.19257355345657468,-6058168178,1772.2686272997632,1623.8382663903992,148.43036090936403,0.7324590243783639,0.7335772775661705,-778
1415,2020-11-16,2020,250015,250015,436913733.9666661,3779502.900000003,182137,0,31,0.7871567705937644,51457326,6810081143,250645,250645,82092,332737,401454632.2000117,3774827.2166661266,182894,0,30,0.5955033555030002,6118646183,-630,-630,35459101.76665443,4675.683333876543,-757,0,1,0.19165341509076428,-6067188857,1747.5500828616928,1601.6861784596208,145.86390440207197,0.7285042897426155,0.7296933910510882,-757
1416,2020-11-17,2020,247323,247323,436998000.63333344,3773187.566666668,182130,0,35,0.7956073636499639,51147029,6818601879,247710,247710,83814,331524,401564891.9166794,3767713.2333327993,182631,0,35,0.596412326106104,6127199554,-387,-387,35433108.71665406,5474.333333868533,-501,0,0,0.19919503754385992,-6076052525,1766.9120972709106,1621.1089254235976,145.80317184731302,0.7364054293373443,0.7372774615477776,-501
1417,2020-11-18,2020,242615,242615,437149515.06666636,3737336.3499999945,178258,0,59,0.7951280835892262,51441461,6829504609,243074,243074,82162,325236,401780548.5500102,3732641.2333328743,178911,0,59,0.5972524566776135,6134633811,-459,-459,35368966.51665616,4695.116667120252,-653,0,0,0.19787562691161265,-6083192350,1801.8239394376537,1652.9145385767717,148.909400860882,0.7347361045277497,0.7360351168779877,-653
1418,2020-11-19,2020,241928,241928,437060984.79999983,3709797.333333332,176635,0,83,0.7948025858933234,50749823,6833249532,242532,242532,79701,322233,401756645.8500101,3705748.8999994732,177416,0,83,0.6011674781912517,6147404037,-604,-604,35304338.949989736,4048.4333338588476,-781,0,0,0.1936351077020717,-6096654214,1806.5746205482617,1656.5098455049647,150.064775043297,0.7301139181905361,0.7315158412085828,-781
1419,2020-11-20,2020,242501,242501,437247784.5333331,3654485.949999999,177446,0,79,0.789501898961242,50480982,6844224474,248982,248982,82006,330988,402028647.3666799,3657527.649999608,180309,0,79,0.5896739458832356,6156721509,-6481,-6481,35219137.166653216,-3041.699999609031,-2863,0,0,0.19982795307800638,-6106240527,1803.076212194313,1614.6896055404804,188.3866066538326,0.7317330650182886,0.7241848808347592,-2863
1420,2020-11-21,2020,238723,238723,437113108.56666654,3643909.949999996,173451,0,47,0.7859192453177947,51228121,6847259293,248120,248120,87210,335330,401180206.75001997,3651356.9166661887,179281,0,48,0.5791250410043794,6137302729,-9397,-9397,35932901.816646576,-7446.966666192748,-5830,0,-1,0.20679420431341522,-6086074608,1831.047316624986,1616.8797628164596,214.16755380852646,0.7265785031186773,0.722557633403192,-5830
1421,2020-11-22,2020,234568,234568,437158033.5166671,3602369.6333333347,170985,0,81,0.7949805600081854,52088904,6856075167,235271,235271,89432,324703,398289570.83334494,3597740.4666661303,171909,0,81,0.5799884817818144,6045599082,-703,-703,38868462.68332219,4629.16666720435,-924,0,0,0.214992078226371,-5993510178,1863.672937129818,1692.8970031722777,170.77593395754025,0.728935745711265,0.7306850398051609,-924
1422,2020-11-23,2020,238540,238540,437453562.6499997,3622264.4,172311,0,176,0.7819988261926726,51995768,6873060772,239060,239060,82024,321084,398589714.050009,3618277.5833328045,172992,0,176,0.5851833165153061,6052379586,-520,-520,38863848.599990666,3986.8166671954095,-681,0,0,0.1968155096773665,-6000383818,1833.8792766412328,1667.3208150673847,166.55846157384804,0.7223568374276851,0.7236342340834937,-681
1423,2020-11-24,2020,237368,237368,438047700.8000002,3658984.833333335,172496,0,201,0.7825738937009203,50404538,6887646907,238889,238889,80358,319247,399205659.45001614,3653936.099999503,173314,0,204,0.5861762209198551,6063948343,-1521,-1521,38842041.34998405,5048.733333831653,-818,0,-3,0.19639767278106524,-6013543805,1845.4370462741406,1671.0926809104485,174.34436536369208,0.7267028411580331,0.7255001276743592,-818
1424,2020-11-25,2020,238916,238916,438540038.2499993,3678865.866666667,173775,0,204,0.7866070083209167,52680110,6899160222,239636,239636,78044,317680,399761365.7666773,3674157.2499995376,174731,0,204,0.5978217073784957,6078927939,-720,-720,38778672.483321965,4708.616667129565,-956,0,0,0.18878530094242096,-6026247829,1835.5406848013497,1668.202464432211,167.33822036913875,0.7273476870531902,0.7291517134320386,-956
1425,2020-11-26,2020,243667,243667,439080836.1166669,3682651.1333333324,175567,0,136,0.7831425675204273,53548163,6915632529,244345,244345,77930,322275,400285140.43333876,3677325.633332778,176437,0,136,0.5973376774493871,6092643572,-678,-678,38795695.68332815,5325.500000554603,-870,0,0,0.18580489007104017,-6039095409,1801.9708705596856,1638.1965681038644,163.77430245582127,0.7205202181665962,0.7220814831488265,-870
1426,2020-11-27,2020,232980,232980,439141150.1999999,3597878.1500000004,169373,0,39,0.7874366898446222,52103768,6924248574,233710,233710,85081,318791,400378685.4500128,3593743.9499994586,170280,0,41,0.5805465022538293,6106402804,-730,-730,38762464.749987125,4134.20000054175,-907,0,-2,0.20689018759079292,-6054299036,1884.8877594643313,1713.1431494159976,171.7446100483337,0.7269851489398231,0.7285952676393821,-907
1427,2020-11-28,2020,228891,228891,438802682.5500001,3556747.7833333374,165730,0,91,0.7775578768933691,51179567,6927373550,229475,229475,81137,310612,400137178.266681,3552890.1999995443,166476,0,91,0.5774374460742017,6109634396,-584,-584,38665504.283319056,3857.5833337930962,-746,0,0,0.20012043081916742,-6058454829,1917.0814167005258,1743.7070629335701,173.37435376695566,0.7240564286057556,0.7254646475650942,-746
1428,2020-11-29,2020,222078,222078,439282887.7666663,3521911.6000000034,162472,0,124,0.784310017201163,50754310,6943022976,222623,222622,75985,298608,400715656.1833341,3517708.8166661304,163246,0,127,0.5880251031452668,6115142158,-545,-544,38567231.58333218,4202.783333872911,-774,0,-3,0.1962849140558962,-6064387848,1978.0567537832037,1799.9822846948375,178.0744690883662,0.7315988076261494,0.733284521365717,-774
1429,2020-11-30,2020,235850,235850,440258245.5500004,3678715.000000003,180019,0,134,0.8236294254822986,52343015,6962664893,236516,236516,71604,308120,401744914.7666808,3674401.049999561,180807,0,137,0.6353888095547141,6136133002,-666,-666,38513330.78331965,4313.950000441633,-788,0,-3,0.18824061592758445,-6083789987,1866.6874943820244,1698.5950834898306,168.0924108921938,0.7632775068899724,0.7644599096889851,-788
1430,2020-12-01,2020,240495,240495,441063603.8499999,3744298.333333332,183583,0,129,0.8253310879644071,52863198,6979135433,241358,241358,71920,313278,402610672.18334323,3741970.316666216,184491,0,130,0.6391192487183885,6151348053,-863,-863,38452931.66665667,2328.0166671159677,-908,0,-1,0.18621183924601858,-6098484855,1833.9824272853903,1668.1057689545953,165.87665833079495,0.763354747499948,0.7643873416253035,-908
1431,2020-12-02,2020,232407,232407,441494944.0333334,3588366.149999998,176289,0,88,0.8135168045712909,45002967,6985526858,236855,236855,77339,314194,403309981.7500105,3683634.2166662146,179274,0,89,0.6171155400803329,6165207379,-4448,-4448,38184962.28332293,-95268.06666621659,-2985,0,-1,0.19640126449095807,-6120204412,1899.662850229698,1702.771660931838,196.89118929786014,0.7585356723334495,0.756893458022841,-2985
1432,2020-12-03,2020,228006,228006,441528480.20000035,3585262.983333335,172855,0,85,0.8162679929475547,47003314,6992688491,231692,231692,77569,309261,403667652.8833414,3645775.5499994736,175155,0,86,0.6139894781430576,6183168402,-3686,-3686,37860827.31665897,-60512.566666138824,-2300,0,-1,0.2022785148044971,-6136165088,1936.4774619966156,1742.2597797219644,194.21768227465122,0.7581160144908468,0.7559820796574763,-2300
1433,2020-12-04,2020,234549,234549,442144151.88333344,3644944.0833333335,176390,0,89,0.8107474344380058,52068551,7004774624,235103,235103,74596,309699,404225224.71667945,3639546.1166662215,177130,0,90,0.6182325419197374,6192532338,-554,-554,37918927.16665399,5397.966667111963,-740,0,-1,0.19251489251826837,-6140463787,1885.0822296549268,1719.3537501294304,165.72847952549637,0.7520390195652081,0.7534144608958626,-740
1434,2020-12-05,2020,237200,237200,442412489.38333327,3644609.550000002,175745,0,69,0.7948145025295102,51387286,7013074524,238140,238140,76896,315036,404513515.9666699,3642241.1499995077,176844,0,69,0.604219835193435,6208074720,-940,-940,37898973.41666335,2368.400000494439,-1099,0,0,0.19059466733607522,-6156687434,1865.1454021219783,1698.6374232244475,166.50797889753085,0.7409148397976392,0.7426051902242379,-1099
1435,2020-12-06,2020,231212,231212,442361125.2000001,3599249.8333333298,172260,0,27,0.801424666539799,52208152,7020720769,232034,232034,79686,311720,404535302.3000136,3595120.666666416,173238,0,29,0.600359296804816,6218717087,-822,-822,37825822.899986506,4129.166666913778,-978,0,-2,0.201065369734983,-6166508935,1913.2273636316459,1743.43114500467,169.79621862697581,0.7450305347473315,0.7466061008300507,-978
1436,2020-12-07,2020,230796,230796,443087546.13333285,3588288.250000003,170923,0,49,0.7975224873914627,51567444,7039456995,231666,231666,77344,309010,405317395.3166769,3584031.5333328694,171928,0,49,0.6020646581016796,6229895939,-870,-870,37770150.816655934,4256.716667133383,-1005,0,0,0.19545782928978306,-6178328495,1919.8233337377287,1749.5765253281747,170.24680840955398,0.7405804260039168,0.7421373874457192,-1005
1437,2020-12-08,2020,230538,230538,443300048.0666675,3536338.4666666677,170139,0,29,0.7951574143958912,51704372,7049645047,231345,231345,75274,306619,405599090.38334614,3532521.099999568,171107,0,29,0.6037558011734374,6242109934,-807,-807,37700957.68332136,3817.3666670997627,-968,0,0,0.19140161322245375,-6190405562,1922.893614357145,1753.2217700116541,169.67184434549085,0.7380084845014705,0.7396183189608593,-968
1438,2020-12-09,2020,247230,247230,444288414.56666654,3774965.08333333,188107,0,30,0.8269789265056829,53648077,7066904260,248213,248213,74381,322594,406520755.5333463,3771865.0666662804,189200,0,31,0.6400615014538421,6254956107,-983,-983,37767659.03332025,3100.016667049844,-1093,0,-1,0.18691742505184084,-6201308030,1797.0651400180664,1637.7899446577992,159.27519536026716,0.7608583100756381,0.7622485526543734,-1093
1439,2020-12-10,2020,244160,244160,445106734.4166672,3802939.35,184182,0,93,0.8202408256880737,54057664,7081556436,245065,245065,76849,321914,407406027.9500104,3798671.5833328133,185233,0,93,0.6286306280559353,6267839013,-905,-905,37700706.466656804,4267.766667186748,-1051,0,0,0.19161019763213838,-6213781349,1823.0125098978835,1662.440691041195,160.57181885668865,0.7543496068152031,0.7558525289208985,-1051
1440,2020-12-11,2020,242425,242425,445791779.850001,3735737.1333333347,181281,0,235,0.8130555842012994,54221294,7091545172,244380,244380,77562,321942,408055216.80000424,3731741.483332843,182628,0,235,0.6192854613563942,6283906784,-1955,-1955,37736563.04999673,3995.650000491645,-1347,0,0,0.19377012284490525,-6229685490,1838.8853453645497,1669.7570046648837,169.12834069966607,0.7477817881819119,0.7473115639577707,-1347
1441,2020-12-12,2020,240077,240077,445913155.1666668,3663281.9833333376,179570,0,147,0.8116937482557675,52976824,7103876518,240722,240722,82126,322848,408160122.63334143,3658446.366666189,180429,0,147,0.608509267519085,6293251131,-645,-645,37753032.533325374,4835.616667148657,-859,0,0,0.2031844807366825,-6240274307,1857.3755718651382,1695.5663488727305,161.80922299240774,0.7479683601511182,0.7495326559267537,-859
1442,2020-12-13,2020,229580,229580,445912964.94999963,3582246.800000004,171622,0,47,0.8105322763306918,52117949,7116499515,230098,230098,82447,312545,408154723.90001273,3577674.4666661834,172407,0,48,0.5999648050680731,6304713276,-518,-518,37758241.0499869,4572.33333382057,-785,0,-1,0.21056747126261866,-6252595327,1942.298828077357,1773.8299502821092,168.46887779524786,0.7475476957923164,0.7492763952750567,-785
1443,2020-12-14,2020,225443,225443,446010135.2166668,3550963.46666667,169097,0,45,0.8085192265894263,51883869,7131765602,225864,225864,78999,304863,408244199.4500097,3546569.54999952,169747,0,47,0.6015095305104267,6318832764,-421,-421,37765935.766657114,4393.916667149868,-650,0,-2,0.20700969607899966,-6266948895,1978.3720728373328,1807.477948898495,170.89412393883777,0.7500654267375789,0.7515451776290157,-650
1444,2020-12-15,2020,227368,227368,446267309.66666716,3565590.816666664,169315,0,60,0.7993737025438935,51902897,7144518293,227433,227433,71030,298463,408602812.03332883,3560905.3499998627,169845,0,59,0.6120457142091306,6329239967,-65,-65,37664497.63333833,4685.466666801367,-530,0,1,0.18732798833476294,-6277337070,1962.753376317983,1796.5854209078227,166.1679554101604,0.7446738327293199,0.7467913627310021,-530
1445,2020-12-16,2020,229396,229396,446708207.89999974,3573540.6500000004,170168,0,52,0.7970452841374738,52355249,7156046873,229936,229936,72311,302247,409069552.4500102,3570011.849999511,170961,0,51,0.6093294557100711,6342279212,-540,-540,37638655.44998956,3528.8000004892237,-793,0,1,0.18771582842740264,-6289923963,1947.3234402517905,1779.0583138351983,168.26512641659224,0.7418089243055677,0.7435155869459328,-793
1446,2020-12-17,2020,231559,231559,447091261.74999994,3600025.2500000005,171342,0,112,0.7940524877029186,52738676,7170085375,233739,233739,72817,306556,409600210.2333419,3595912.649999506,172146,0,112,0.6043985438223304,6356585214,-2180,-2180,37491051.51665807,4112.600000494625,-804,0,0,0.1896539438805882,-6303846538,1930.7876685855438,1752.382829708957,178.40483887658684,0.7399496456626605,0.7364881342009677,-804
1447,2020-12-18,2020,227515,227515,447303740.6500007,3539012.816666666,168828,0,183,0.8020921697470486,51727754,7180464992,227969,227969,76767,304736,409858492.15000933,3534529.849999577,169486,0,182,0.6025149637719162,6368328257,-454,-454,37445248.49999136,4482.966667089146,-658,0,1,0.1995772059751324,-6316600503,1966.040659516958,1797.86941272721,168.171246789748,0.7420521723842384,0.7434607336962482,-658
1448,2020-12-19,2020,219710,219710,447265957.03333354,3490600.7166666663,162995,0,205,0.7992854216922307,50837977,7188638581,220096,220096,77001,297097,409804671.63332856,3486542.666666464,163661,0,196,0.5949605684338837,6378596517,-386,-386,37461285.40000498,4058.0500002023764,-666,0,9,0.20432485325834704,-6327758540,2035.710514010894,1861.9360262491302,173.7744877617638,0.7418642756360657,0.7435891610933411,-666
1449,2020-12-20,2020,218999,218999,447620667.8833337,3507025.2000000025,161722,0,89,0.7941451787451083,51162207,7202026301,219651,219651,69503,289154,410201182.56667626,3503305.083332793,162565,0,86,0.6065591345788046,6384479101,-652,-652,37419485.316657424,3720.1166672096588,-843,0,3,0.18758604416630364,-6333316894,2043.9393233911283,1867.5133851731896,176.42593821793866,0.7384599929680045,0.7401058952611188,-843
1450,2020-12-21,2020,226222,226222,448350810.31666714,3556750.800000003,167276,0,25,0.7931589323761611,51223244,7218382403,226087,226087,68100,294187,410956032.86666137,3551601.7833330464,167901,0,25,0.6141127922035949,6397681065,135,135,37394777.45000577,5149.016666956712,-625,0,0,0.17904614017256615,-6346457821,1981.9063146673052,1817.6897958160414,164.2165188512638,0.7394329463977862,0.7426388956463662,-625
1451,2020-12-22,2020,232902,232902,448810276.06666684,3610574.949999997,171015,0,38,0.7860001202222401,51993107,7228946891,233700,233700,69310,303010,411434638.75001186,3606725.683332828,171843,0,38,0.6093132239860061,6412934592,-798,-798,37375637.31665498,3849.266667169053,-828,0,0,0.17668689623623401,-6360941485,1927.034873322972,1760.5247700043296,166.51010331864245,0.7342787953731612,0.7353145057766367,-828
1452,2020-12-23,2020,232121,232121,449315678.0333329,3611792.8666666676,170626,0,70,0.7923582958887819,53537595,7242424194,232770,232770,74033,306803,411967456.5000106,3609121.3333328534,171315,0,70,0.6035469014318545,6425767748,-649,-649,37348221.533322275,2671.5333338142373,-689,0,0,0.1888113944569274,-6372230153,1935.695943207779,1769.8477316664973,165.84821154128167,0.7350735176912041,0.7359840185590927,-689
1453,2020-12-24,2020,221429,221429,449438874.56666714,3518488.9666666654,162653,0,45,0.7922358859950595,53336428,7248248356,222150,222150,77836,299986,412218073.9666779,3515482.2999994904,163548,0,45,0.5901742081297111,6437865213,-721,-721,37220800.599989235,3006.6666671750136,-895,0,0,0.20206167786534834,-6384528785,2029.7200211655527,1855.5843977793288,174.13562338622387,0.7345605137538443,0.7362052667116813,-895
1454,2020-12-25,2020,219693,219693,449156968.8333336,3468990.3500000047,159510,0,53,0.7828606282403181,52598851,7252204409,220353,220353,73959,294312,411998708.38333726,3465607.1499994327,160394,0,54,0.5911175894968658,6447893931,-660,-660,37158260.44999635,3383.2000005720183,-884,0,-1,0.19174303874345233,-6395295080,2044.475558316986,1869.721348850877,174.75420946610916,0.7260586363698434,0.7278956946354259,-884
1455,2020-12-26,2020,223553,223553,449936418.7166665,3544841.299999999,162160,0,26,0.7814567462749323,52680809,7271214313,224422,224422,69299,293721,412807526.19999605,3539562.516666407,163126,0,25,0.602360743698949,6459073903,-869,-869,37128892.516670465,5278.783333591651,-966,0,1,0.17909600257598335,-6406393094,2012.6610634465496,1839.4253959059097,173.23566754063995,0.7253760853131025,0.7268716970706972,-966
1456,2020-12-27,2020,229660,229660,450584591.8000007,3573985.8499999996,165995,0,22,0.7787816772620391,53465370,7288082534,230242,230242,69245,299487,413439624.5499971,3566247.299999815,166881,0,22,0.6044035300363678,6471815063,-582,-582,37144967.250003636,7738.550000184681,-886,0,0,0.17437814722567124,-6418349693,1961.9637368283582,1795.6742234257742,166.2895134025839,0.7227858573543499,0.7248069422607517,-886
1457,2020-12-28,2020,234247,234247,451579139.59999996,3575686.966666663,169601,0,221,0.783531912895363,53263696,7311224207,235101,235101,73759,308860,414387413.1333419,3571041.4499994842,170604,0,221,0.601447257657192,6489502302,-854,-854,37191726.466658056,4645.516667178832,-1003,0,0,0.18208465523817097,-6436238606,1927.7904929412114,1762.5931541479702,165.19733879324122,0.7240263482563277,0.725662587568747,-1003
1458,2020-12-29,2020,220832,220832,451871095.48333347,3481072.36666666,161330,0,257,0.7951972540211558,52886297,7328446373,221707,221707,76752,298459,414768575.61666507,3477082.199999647,162418,0,258,0.5962963087057208,6502720420,-875,-875,37102519.8666684,3990.1666670129634,-1088,0,-1,0.198900945315435,-6449834123,2046.2210888065745,1870.7960308725708,175.4250579340037,0.7305553542964788,0.7325794855372181,-1088
1459,2020-12-30,2020,204743,204743,451237149.2499994,3390644.883333333,150765,0,187,0.7989577177241712,53024528,7339282429,205664,205664,74085,279749,414159878.70000577,3386409.8166661295,151777,0,188,0.5928135578679478,6520330418,-921,-921,37077270.549993634,4235.066667203326,-1012,0,-1,0.20614415985622347,-6467305890,2203.9197884665136,2013.7694428777315,190.1503455887821,0.7363621711120771,0.7379852575073907,-1012
1460,2020-12-31,2020,213261,213261,451570772.90000004,3438632.4499999993,154630,0,143,0.7819104290048354,53287446,7356819346,214094,214094,63625,277719,414514853.93334126,3434699.2166661574,155640,0,144,0.6076249734443872,6533528899,-833,-833,37055918.96665877,3933.2333338418975,-1010,0,-1,0.17428545556044828,-6480241453,2117.455947876077,1936.1348469987074,181.32110087736964,0.7250739703930864,0.7269703961811167,-1010
1461,2021-01-01,2021,221597,221597,451574291.31666684,3414480.25,158426,0,146,0.7670591208364743,50661817,7362097304,222260,222260,64742,287002,414504785.4166758,3410447.499999448,159302,0,148,0.5976752775242001,6542448520,-663,-663,37069505.899991035,4032.7500005518086,-876,0,-2,0.16938384331227418,-6491786703,2037.8177110550541,1864.9544921113823,172.86321894367188,0.714928451197444,0.7167371546837038,-876
1462,2021-01-02,2021,217606,217606,451862683.88333327,3432008.3500000015,158254,0,185,0.7830896206906054,52829969,7377937372,223569,223569,74296,297865,414873880.4666581,3434666.233333211,162042,0,188,0.5872660433417813,6553171649,-5963,-5963,36988803.41667515,-2657.8833332094364,-3788,0,-3,0.19582357734882405,-6500341680,2076.517577104185,1855.68607663253,220.83150047165486,0.7272501677343456,0.7247963715899789,-3788
1463,2021-01-03,2021,215365,215365,452414306.16666657,3419412.8666666723,156888,0,153,0.7849371996378243,52736751,7395013469,220140,220140,72877,293017,415154798.1333426,3419235.0999994697,159882,0,154,0.5894913946972288,6558512496,-4775,-4775,37259508.03332394,177.76666720258072,-2994,0,-1,0.1954458049405955,-6505775745,2100.6863054194814,1885.8671669544046,214.81913846507678,0.7284749146797298,0.7262741891523576,-2994
1464,2021-01-04,2021,222157,222157,453306053.6833334,3491109.5000000023,162680,0,97,0.7882983655702949,53524329,7415788963,222699,222699,70474,293173,415304422.816666,3487487.483333063,163435,0,97,0.6022723784250129,6550494649,-542,-542,38001630.86666739,3622.016666939482,-755,0,0,0.18602598714528196,-6496970320,2040.4761213166066,1864.8688266075105,175.6072947090961,0.7322749226898094,0.7338829541219314,-755
1465,2021-01-05,2021,222266,222266,453796429.4333333,3484121.416666669,161502,0,113,0.7848568831940107,53590342,7428257440,225056,225056,68996,294052,415837343.56667703,3480845.733332806,162905,0,113,0.6008563111286408,6561109043,-2790,-2790,37959085.866656244,3275.6833338630386,-1403,0,0,0.1840005720653699,-6507518701,2041.681721150933,1847.7060978897564,193.97562326117668,0.7266158566762347,0.7238420659746907,-1403
1466,2021-01-06,2021,213372,213372,454092162.08333325,3416394.383333327,156908,0,110,0.795479256884689,53050378,7440408372,214144,214144,72381,286525,416133483.4000101,3412536.9333328274,157855,0,110,0.5991728470465054,6571628319,-772,-772,37958678.683323145,3857.450000499375,-947,0,0,0.1963064098381836,-6518577941,2128.1712787213564,1943.241386170101,184.92989255125553,0.7353729636503383,0.7371441646742379,-947
1467,2021-01-07,2021,213455,213455,454437442.74999976,3475953.3000000017,166188,0,120,0.8431378979175945,53061060,7452718983,214077,214077,67979,282056,416533696.916676,3471154.099999545,166929,0,121,0.6433686927418703,6585279264,-622,-622,37903745.83332378,4799.200000456534,-741,0,-1,0.19976920517572427,-6532218204,2128.961339626618,1945.7190492985046,183.24229032811354,0.778562226230353,0.7797614876890091,-741
1468,2021-01-08,2021,220607,220607,455628980.25,3577172.8333333344,171125,0,105,0.8379924481090806,54383149,7472803111,221195,221195,60275,281470,417726941.7833425,3572727.5333328573,171829,0,105,0.6608341919209898,6596802922,-588,-588,37902038.46665752,4445.300000477117,-704,0,0,0.17715825618809078,-6542419773,2065.342352010589,1888.500833126167,176.84151888442193,0.7757006803954544,0.7768213567214449,-704
1469,2021-01-09,2021,225252,225252,456147289.9499997,3520919.816666662,172459,0,102,0.8249338518636904,54335341,7486057099,225811,225811,65115,290926,418277624.0166635,3517063.0333331497,173199,0,102,0.6435347820407963,6613944705,-559,-559,37869665.9333362,3856.7833335124888,-740,0,0,0.1813990698228941,-6559609364,2025.0532290501292,1852.3350236111771,172.71820543895205,0.765626942269103,0.7670086931106102,-740
1470,2021-01-10,2021,220044,220044,456552626.2500005,3489525.866666668,166835,0,118,0.8115422370071435,53346967,7499712998,220608,220608,73368,293976,418687961.83334494,3486065.6999995094,167634,0,118,0.6118322584156504,6624992302,-564,-564,37864664.41665554,3460.1666671587154,-799,0,0,0.1997099785914931,-6571645335,2074.824245378199,1897.8820434134072,176.94220196479182,0.7581892712366618,0.7598727154046997,-799
1471,2021-01-11,2021,224419,224419,457557723.8833336,3544716.766666671,169615,0,110,0.8096105944683838,52815687,7524883130,224921,224921,69644,294565,419643137.3999924,3540716.3166663833,170287,0,110,0.6210140376487372,6639354699,-502,-502,37914586.48334122,4000.4500002874993,-672,0,0,0.1885965568196466,-6586539012,2038.8546597361792,1865.7356911982092,173.11896853796998,0.7557960778721944,0.7570969362576193,-672
1472,2021-01-12,2021,236674,236674,458144306.9666674,3668567.5500000007,181892,0,115,0.8318826740579868,54986947,7532943098,245215,245215,68924,314139,420353566.7166905,3676587.2499995716,186636,0,115,0.6441352394958937,6658341761,-8541,-8541,37790740.24997693,-8019.699999570847,-4744,0,0,0.18774743456209309,-6603354814,1935.761034024301,1714.2245242611198,221.53650976318113,0.7685339327513795,0.7611116775074934,-4744
1473,2021-01-13,2021,237122,237122,458892880.1666659,3709782.4333333294,179139,0,93,0.8116750027412043,54665996,7544995570,247773,247773,75853,323626,420018118.8166782,3718842.5666662464,183958,0,93,0.610448480653589,6627628300,-10651,-10651,38874761.349987686,-9060.133332917001,-4819,0,0,0.20122652208761527,-6572962304,1935.2606682073613,1695.1730770369581,240.08759117040313,0.7554718668027429,0.7424457063521853,-4819
1474,2021-01-14,2021,236941,236941,459724638.04999965,3682679.2666666666,177540,0,180,0.8060361018143759,55449223,7564252564,238706,238706,82037,320743,418403647.9666747,3678925.8999994686,178370,0,181,0.5989218782639004,6549223829,-1765,-1765,41320990.08332497,3753.3666671980172,-830,0,-1,0.20711422355047548,-6493774606,1940.249420952894,1752.7990413591392,187.45037959375486,0.7493004587639961,0.747237187167478,-830
1475,2021-01-15,2021,238501,238501,460249385.0500004,3648393.949999997,178802,0,240,0.8127261520916056,55093780,7582825238,239158,239158,76763,315921,418717716.0333396,3644556.2499994845,179470,0,247,0.6170624934714681,6557392491,-657,-657,41531669.01666081,3837.7000005124137,-668,0,-7,0.19566365862013746,-6502298711,1929.7587223952958,1750.799538519889,178.95918387540678,0.7496907769778743,0.7504244056230609,-668
1476,2021-01-16,2021,219481,219481,459898968.10000026,3507747.9666666724,165947,0,66,0.81511383673302,54158017,7588745413,219939,219939,82512,302451,418477374.04999727,3503089.566666443,166513,0,66,0.5947409663052688,6573291349,-458,-458,41421594.05000299,4658.400000229478,-566,0,0,0.2203728704277511,-6519133332,2095.3930777607184,1902.6974481560671,192.69562960465123,0.7560882263157175,0.757087192357881,-566
1477,2021-01-17,2021,215917,215917,459863132.0166666,3457367.649999999,162286,0,61,0.804887989366284,53439638,7596457112,216374,216374,72597,288971,418566608.8333434,3454417.3499995223,162743,0,61,0.603673032934095,6583773777,-457,-457,41296523.183323205,2950.300000476651,-457,0,0,0.201214956432189,-6530334139,2129.8143824556037,1934.4588944759694,195.3554879796343,0.7516128882857764,0.7521375026574357,-457
1478,2021-01-18,2021,224567,224567,460591334.4833326,3507837.7333333325,167723,0,36,0.8026201534508616,53809128,7614490172,225020,225020,68880,293900,419362547.5666783,3503703.533332834,168239,0,36,0.6157298400816661,6599558075,-453,-453,41228786.91665429,4134.200000498444,-516,0,0,0.18689031336919548,-6545748947,2051.0196711152244,1863.6678853732037,187.35178574202064,0.7468728709026705,0.7476624300062217,-516
1479,2021-01-19,2021,226733,226733,460820598.3833333,3525879.4833333325,168068,0,79,0.8061376156095499,53543681,7621092205,227246,227246,70536,297782,419681833.6833292,3521913.5333330957,168665,0,79,0.616941252325525,6612301314,-513,-513,41138764.7000041,3965.950000236742,-597,0,0,0.1891963632840249,-6558757633,2032.4372649033592,1846.817253915709,185.62001098765018,0.7412595431631037,0.7422132842822315,-597
1480,2021-01-20,2021,225525,225525,460988597.8833336,3553942.66666667,168239,0,86,0.8175368584414143,53427955,7631431900,226038,226038,71341,297379,419943999.35000646,3550286.233332849,168877,0,86,0.6231475659007523,6622208793,-513,-513,41044598.53332716,3656.4333338206634,-638,0,0,0.19438929254066206,-6568780838,2044.0687191368302,1857.8469078208375,186.22181131599268,0.7459882496397295,0.7471177412647431,-638
1481,2021-01-21,2021,224491,224491,461428053.98333305,3552141.4166666665,166486,0,109,0.818447064693016,53455061,7644518187,227703,227703,70035,297738,420551357.24999714,3549000.5333331716,168076,0,109,0.6242804076066814,6633973161,-3212,-3212,40876696.73333591,3140.8833334948868,-1590,0,0,0.19416665708633463,-6580518100,2055.4412158319624,1846.929365225742,208.51185060622038,0.7416154767897154,0.7381369591090148,-1590
1482,2021-01-22,2021,221676,221676,461813095.14999986,3491777.799999999,164068,0,35,0.821942835489635,53678309,7660256101,222111,222111,73389,295500,420764085.6666599,3487473.4166665045,164681,0,35,0.620209813874778,6646036526,-435,-435,41049009.483339965,4304.383333494421,-613,0,0,0.20173302161485696,-6592358217,2083.279629504321,1894.3865259562106,188.89310354811028,0.7401252278099568,0.7414355885120503,-613
1483,2021-01-23,2021,216334,216334,461719333.2333332,3460388.9000000013,160653,0,40,0.8221176514093946,54042343,7669523766,216773,216773,70219,286992,420889876.00000954,3457233.933332829,161258,0,40,0.6229825221608967,6660790416,-439,-439,40829457.23332363,3154.966667172499,-605,0,0,0.19913512924849797,-6606748073,2134.2892621286214,1941.6157731821286,192.67348894649285,0.742615585159984,0.7439026077970965,-605
1484,2021-01-24,2021,214155,214155,461877822.56666666,3395685.7333333315,159089,0,31,0.8205645443720664,54109763,7684928331,214807,214807,68608,283415,421086261.8333248,3392678.149999666,159841,0,32,0.6237108127657441,6676970036,-652,-652,40791560.73334187,3007.583333665505,-752,0,-1,0.19685373160632225,-6622860273,2156.7454533710006,1960.300464292713,196.44498907828756,0.7428684831080292,0.7441144841648549,-752
1485,2021-01-25,2021,218002,218002,462341171.00000036,3446244.1833333327,162961,0,85,0.8259878349739903,54609003,7703832453,218877,218877,67735,286612,421619209.26667297,3443318.099999475,163842,0,85,0.6326706488214003,6695876467,-875,-875,40721961.73332739,2926.083333857823,-881,0,0,0.19331718615258997,-6641267464,2120.811602645849,1926.2837541937845,194.5278484520643,0.747520664948028,0.7485574089557149,-881
1486,2021-01-26,2021,218952,218952,462496443.89999956,3431417.850000006,163473,0,99,0.8286565091892286,54624902,7716637609,219500,219500,66888,286388,421884378.46667814,3428037.3499994874,164119,0,97,0.6370797659119802,6711061122,-548,-548,40612065.43332142,3380.5000005187467,-646,0,2,0.19157674327724838,-6656436220,2112.3188822207585,1922.0245032650485,190.29437895571004,0.7466156965910337,0.7476947608200456,-646
1487,2021-01-27,2021,219913,219913,462829586.3499998,3442511.6333333366,164497,0,58,0.8403686912551789,54882496,7729702907,220455,220455,68765,289220,422311397.83332604,3438263.533333059,165139,0,58,0.6422930641034579,6729315464,-542,-542,40518188.51667374,4248.100000277627,-642,0,0,0.198075627151721,-6674432968,2104.6031219163933,1915.6353806143024,188.96774130209087,0.7480094400967655,0.7490825792111769,-642
1488,2021-01-28,2021,209931,209931,462929518.3666662,3409640.283333336,158117,0,188,0.8453968208601882,54877005,7742447001,210471,210471,68967,279438,422514884.3833406,3405488.0999994995,158784,0,189,0.6388859067127552,6744052608,-540,-540,40414633.9833256,4152.183333836496,-667,0,-1,0.20651091414743294,-6689175603,2205.150827494111,2007.4731643948126,197.67766309929857,0.7531855704969728,0.7544222244394715,-667
1489,2021-01-29,2021,211142,211142,463321130.4666663,3363898.133333333,159231,0,142,0.8486042568508391,54709581,7760717318,211777,211777,65614,277391,422972539.60000485,3359629.099999452,160007,0,145,0.650814193683282,6761482573,-635,-635,40348590.86666143,4269.033333880827,-776,0,-3,0.1977900631675571,-6706772992,2194.357969833886,1997.2543741766333,197.10359565725253,0.754141762415815,0.7555447475410455,-776
1490,2021-01-30,2021,208620,208620,463412942.1500004,3361132.9333333327,156926,0,151,0.8441616335921776,54321897,7773323134,209227,209227,66864,276091,423109358.55000675,3358524.933332744,157633,0,151,0.6423824029034009,6778501900,-607,-607,40303583.599993646,2608.000000588596,-707,0,0,0.20177923068877668,-6724180003,2221.3255783242275,2022.2502762550089,199.07530206921865,0.7522097593711053,0.7534065871039589,-707
1491,2021-01-31,2021,207033,207033,463843084.9333331,3360987.6500000055,155625,0,110,0.8434838890418435,54218171,7786085198,207589,207589,63079,270668,423611268.41667277,3356656.6666661324,156344,0,111,0.6498071438071777,6796625591,-556,-556,40231816.51666033,4330.983333873097,-719,0,-1,0.19367674523466571,-6742407420,2240.430679811108,2040.6248328026666,199.80584700844133,0.7516917592847517,0.753142025829885,-719
1492,2021-02-01,2021,210688,210688,464334860.83333284,3365726.700000004,157747,0,107,0.8419843560145803,53873898,7797757148,211291,211291,61181,272472,424218306.3499909,3362203.016666384,158461,0,107,0.6558031650958694,6813577551,-603,-603,40116554.48334193,3523.6833336199634,-714,0,0,0.18618119091871088,-6759703653,2203.897995297942,2007.7443258349429,196.15366946299923,0.7487232305589308,0.7499656871329115,-714
1493,2021-02-02,2021,204621,204621,464301834.83333313,3300579.716666666,154623,0,143,0.8498003626216274,53559473,7808339596,205162,205162,66252,271414,424256178.03333765,3296152.43333286,155339,0,145,0.6452062163337079,6827432812,-541,-541,40045656.79999548,4427.283333805855,-716,0,-2,0.2045941462879195,-6773873339,2269.0820337762652,2067.9081800398594,201.17385373640582,0.7556555778732388,0.7571528840623507,-716
1494,2021-02-03,2021,206006,206006,464112947.6999995,3344529.749999999,157674,0,52,0.8632661184625694,53717966,7815728098,206677,206677,62669,269346,424031088.68333834,3340105.6666661757,158402,0,54,0.6649922404639331,6838035059,-671,-671,40081859.01666117,4424.083333823364,-728,0,-2,0.19827387799863627,-6784317093,2252.9098555381856,2051.660749301269,201.24910623691676,0.765385474209489,0.7664229691741219,-728
1495,2021-02-04,2021,206769,206769,464314596.48333347,3366180.016666666,157387,0,73,0.8574109271699341,53139449,7826747043,207248,207248,58894,266142,424310795.0500071,3362178.5499994243,157980,0,73,0.6696725808027238,6847100038,-479,-479,40003801.43332636,4001.4666672418825,-593,0,0,0.1877383463672102,-6793960589,2245.5716112344376,2047.357731075847,198.21388015859065,0.7611730965473548,0.7622751486142206,-593
1496,2021-02-05,2021,205202,205202,464616816.73333365,3337648.8000000045,155982,0,36,0.8555179774076275,53202361,7842560222,205640,205640,60665,266305,424677251.2833354,3334097.3333328217,156496,0,36,0.6627626218058211,6859439834,-438,-438,39939565.44999826,3551.4666671827435,-514,0,0,0.19275535560180634,-6806237473,2264.192438345307,2065.1490531187287,199.04338522657827,0.7601387900702722,0.7610192569539,-514
1497,2021-02-06,2021,200897,200897,464737535.46666634,3312361.183333326,151878,0,76,0.8523870441071788,53814528,7855462339,201541,201541,60777,262318,424851300.6166599,3308786.7333331564,152622,0,76,0.6579571359952421,6877450618,-644,-644,39886234.85000646,3574.450000169687,-744,0,0,0.19442990811193672,-6823636090,2313.312470901339,2108.014253261916,205.298217639423,0.7559993429468832,0.7572751946254112,-744
1498,2021-02-07,2021,192992,192992,464830543.73333335,3202248.283333335,147127,0,39,0.8595434007627252,53097620,7867012908,193775,193774,59556,253331,425074811.7166686,3200522.599999488,147990,0,39,0.6606534533870698,6889567178,-783,-782,39755732.01666474,1725.683333847206,-863,0,0,0.19888994737565535,-6836469558,2408.548249322943,2193.6627809544552,214.88546836848764,0.7623476620792572,0.7637208102180364,-863
1499,2021-02-08,2021,183363,183363,464827918.0333333,3133273.1166666634,140989,0,43,0.8622841031178591,52960516,7880429525,183980,183980,58554,242534,425100632.93333125,3131478.2999997903,141683,0,44,0.6564316755588913,6909401970,-617,-617,39727285.10000205,1794.816666873172,-694,0,-1,0.20585242755896782,-6856441454,2535.0147959693795,2310.5806768851576,224.43411908422195,0.7689064860413497,0.7701000108707469,-694
1500,2021-02-09,2021,179430,179430,464538317.93333346,3105831.5666666636,139135,0,59,0.8678258931059466,53230410,7887890235,180011,180011,48770,228781,424971266.8500019,3102329.499999549,139803,0,61,0.6858174411336789,6924371444,-581,-581,39567051.083331585,3502.06666711485,-668,0,-2,0.18200845197226767,-6871141034,2588.9668279180373,2360.80721094823,228.1596169698073,0.7754277434096862,0.7766358722522513,-668
1501,2021-02-10,2021,176093,176093,464429726.60000026,3070446.2499999953,137992,0,82,0.8690521485805798,52610061,7899126650,176679,176679,45615,222294,424961870.11666995,3067736.6499995594,138637,0,83,0.6933610443826697,6931613205,-586,-586,39467856.48333031,2709.600000435952,-645,0,-1,0.17569110419791012,-6879003144,2637.4116324896518,2405.2766322917264,232.13500019792536,0.7836313766021363,0.7846829560955179,-645
1502,2021-02-11,2021,170169,170169,463959562.1999998,3017194.1166666667,133991,0,77,0.8699469351056875,53005587,7905926977,170823,170823,44539,215362,424627435.7333416,3014296.6166662583,134673,0,77,0.6924480641895929,6945346384,-654,-654,39332126.466658235,2897.500000408385,-682,0,0,0.17749887091609462,-6892340797,2726.4634698446825,2485.774373084079,240.68909676060366,0.7873995851183235,0.7883774433185227,-682
1503,2021-02-12,2021,172047,172047,463994273.76666653,3033490.9499999997,135099,0,119,0.8727092015553901,53169459,7917102016,172679,172679,41433,214112,424718866.0500003,3030565.5999996923,135704,0,119,0.7065881407861243,6959355076,-632,-632,39275407.71666622,2925.3500003074296,-605,0,0,0.1661210607692658,-6906185617,2696.9041818030337,2459.586087769794,237.3180940332395,0.7852447296378315,0.78587436804707,-605
1504,2021-02-13,2021,178982,178982,464356636.4666672,3084283.900000002,139069,0,198,0.8686013118637631,54567998,7930139011,190154,190154,40711,230865,425154183.3333229,3108294.233332986,146011,0,198,0.7064561540294237,6972958241,-11172,-11172,39202453.13334429,-24010.333332984243,-6942,0,0,0.16214515783433936,-6918390243,2594.432046053051,2235.841388208099,358.59065784495215,0.7769999217798438,0.7678565794040619,-6942
1505,2021-02-14,2021,184270,184270,464767684.8333329,3140283.433333337,141418,0,132,0.8614533022195695,54272725,7942180151,185173,185173,49409,234582,418582415.0333305,3137669.9333329964,142302,0,118,0.6827633833797878,6756553806,-903,-903,46185269.800002396,2613.5000003403984,-884,0,14,0.1786899188397817,-6702281081,2522.210261210902,2260.493781670819,261.7164795400831,0.7674499375915775,0.7684813660738876,-884
1506,2021-02-15,2021,188414,188414,465545287.96666723,3154342.133333331,144202,0,47,0.8575212033076105,52180839,7961151148,189104,189104,48495,237599,419357451.4999929,3150490.9666663054,144910,0,47,0.6850155093245325,6752094856,-690,-690,46187836.46667433,3851.1666670255363,-708,0,0,0.17250569398307802,-6699914017,2470.863566224735,2217.602226816952,253.261339407783,0.7653465241436411,0.7662979101446823,-708
1507,2021-02-16,2021,189928,189928,465894444.35,3176250.566666666,145876,0,43,0.8667653005349388,53552690,7973476170,190691,190691,50643,241334,419720421.366665,3172601.116666459,146677,0,43,0.6878019673978812,6771328887,-763,-763,46174022.98333502,3649.45000020694,-801,0,0,0.1789633331370576,-6717776197,2453.005582905101,2201.0499780622317,251.95560484286943,0.7680594751695379,0.7691867995867661,-801
1508,2021-02-17,2021,187495,187495,466390784.93333334,3196263.9999999995,144942,0,41,0.8685618283154218,55455723,7992316125,188215,188215,52467,240682,420399040.9000162,3193250.1166662234,145693,0,41,0.6818125161000833,6789027698,-720,-720,45991744.03331715,3013.883333776146,-751,0,0,0.18674931221533853,-6733571975,2487.483852547179,2233.610715936648,253.87313661053122,0.773044614523054,0.7740775177323805,-751
1509,2021-02-18,2021,199185,199185,467241649.2666666,3267842.5499999975,151497,0,41,0.8512488390190015,55486059,8012461328,200100,200100,49905,250005,421380628.09999907,3264054.8833330953,152505,0,41,0.6847023059538786,6808331316,-915,-915,45861021.16666752,3787.666666902136,-1008,0,0,0.1665465330651229,-6752845257,2345.7672478683967,2105.850215392299,239.91703247609757,0.7605843813540176,0.762143928035982,-1008
1510,2021-02-19,2021,212212,212212,467855419.5833331,3364523.1833333317,158606,0,49,0.8354004486079963,55963210,8031765467,213203,213203,54430,267633,422149889.8666642,3361499.266666719,159616,0,51,0.6682247704879414,6832931987,-991,-991,45705529.716668904,3023.9166666124947,-1010,0,-2,0.16717567812005496,-6776968777,2204.6605261876475,1980.0372877804916,224.6232384071559,0.7473941153186436,0.7486573828698471,-1010
1511,2021-02-20,2021,213953,213953,468301070.6999996,3451390.4333333285,159341,0,236,0.8352675587629054,56378982,8047900629,214785,214785,63085,277870,422670842.3833279,3447913.6333331433,160281,0,236,0.6484867024147966,6857059690,-832,-832,45630228.31667167,3476.800000185147,-940,0,0,0.18678085634810881,-6800680708,2188.803478801417,1967.878773579756,220.92470522166104,0.7447476782283959,0.7462392625183323,-940
1512,2021-02-21,2021,211441,211441,468758400.06666666,3412505.249999995,158179,0,100,0.8381250561622392,55883068,8062191800,212213,212213,63056,275269,423295051.76666474,3408932.299999826,159044,0,101,0.6492776157140848,6873575965,-772,-772,45463348.30000192,3572.9500001687557,-865,0,-1,0.18884744044815438,-6817692897,2216.9702189578497,1994.6706929672769,222.29952599057287,0.7480999427736342,0.7494545574493551,-865
1513,2021-02-22,2021,215611,215611,469507116.6166664,3411552.9,161476,0,36,0.8393542073456361,54558754,8083140462,229436,229436,64520,293956,424264985.43332815,3469560.449999808,169635,0,36,0.6466682088475891,6894246998,-13825,-13825,45242131.183338225,-58007.54999980796,-8159,0,0,0.19268599849804702,-6839688244,2177.5656929222832,1849.1648452436764,328.40084767860685,0.7489228286126404,0.7393565090046897,-8159
1514,2021-02-23,2021,212404,212404,469854535.2666665,3404501.7166666714,159437,0,43,0.8411658914144726,55240168,8096527677,217019,217019,75109,292128,422429918.66666365,3402019.099999692,162326,0,43,0.6241544802278469,6851115800,-4615,-4615,47424616.600002825,2482.616666979622,-2889,0,0,0.2170114111866257,-6795875632,2212.079505407932,1946.5112209837096,265.5682844242226,0.7506308732415585,0.7479805915611075,-2889
1515,2021-02-24,2021,217225,217225,470498192.7333328,3428889.333333336,162966,0,54,0.8455288295546095,55495971,8114284036,217904,217904,67787,285691,422075842.8333295,3424876.533333007,163789,0,54,0.6479693094987365,6825724060,-679,-679,48422349.900003314,4012.8000003290363,-823,0,0,0.19755952005587296,-6770228089,2165.948637280851,1936.9807017463172,228.9679355345338,0.7502175164000461,0.7516566928555695,-823
1516,2021-02-25,2021,220531,220531,470983773.6833335,3457546.13333333,166369,0,41,0.8503158286136638,55491896,8125117599,221312,221312,66495,287807,422722181.8500017,3453388.9833329543,167330,0,41,0.6578088788667592,6844008202,-781,-781,48261591.83333182,4157.1500003756955,-961,0,0,0.19250694974690463,-6788516306,2135.6805786185773,1910.0734792962048,225.6070993223725,0.7544018754732895,0.7560819115095431,-961
1517,2021-02-26,2021,212159,212159,469352336.51666635,3419385.033333332,160270,0,41,0.8459504428282558,55989614,8107447460,212915,212915,68643,281558,421350823.86666065,3415448.6333330926,161101,0,41,0.6433878632466369,6838977479,-756,-756,48001512.6500057,3936.4000002392568,-831,0,0,0.20256257958161894,-6782987865,2212.266915458059,1978.9626088657947,233.3043065922643,0.7554239980392065,0.7566446704083789,-831
1518,2021-02-27,2021,211792,211792,469421250.1333325,3432047.883333331,159813,0,58,0.8448005590390576,57027222,8119091762,215565,215565,65824,281389,421627417.4666634,3427895.649999787,161702,0,58,0.645789281030878,6852234303,-3773,-3773,47793832.66666907,4152.233333543874,-1889,0,0,0.19901127800817964,-6795207081,2216.4257863060575,1955.9177856640151,260.50800064204236,0.7545752436352647,0.7501310509591075,-1889
1519,2021-02-28,2021,215385,215385,469790375.9499996,3448951.8666666658,161973,0,35,0.8417484968776844,56912240,8134958397,216093,216093,66158,282251,422064671.8500063,3445956.883333197,162891,0,37,0.648004790062756,6870897816,-708,-708,47725704.09999329,2994.983333468903,-918,0,-2,0.19374370681492836,-6813985576,2181.1657076862343,1953.1621655953977,228.00354209083662,0.7520161571140052,0.7538004470297511,-918
1520,2021-03-01,2021,217494,217494,470411924.41666573,3443780.7999999984,163010,0,41,0.8434347614187061,56466212,8153102643,218131,218131,66327,284458,422837774.0499979,3440580.599999759,163717,0,42,0.6495756842837886,6891974131,-637,-637,47574150.36666781,3200.200000239536,-707,0,-1,0.19385907713491746,-6835507919,2162.873111058998,1938.4579635631703,224.41514749582757,0.7494919400075405,0.7505443976326153,-707
1521,2021-03-02,2021,217614,217614,470529409.0333335,3441613.0499999966,161640,0,42,0.8349049233964726,56410347,8165789738,218142,218142,69514,287656,423076735.59999734,3437790.8833331466,162298,0,42,0.6360618238451586,6913836904,-528,-528,47452673.43333614,3822.166666849982,-658,0,0,0.19884309955131396,-6857426557,2162.220303074864,1939.4556554904482,222.76464758441602,0.7427830929995313,0.7440016136278204,-658
1522,2021-03-03,2021,235420,235420,471163953.53333324,3590108.9166666674,180911,0,34,0.8604366663834846,57215877,8178227672,236013,236013,69450,305463,423921095.39999205,3586725.783333162,181633,0,36,0.6675767605242072,6930167139,-593,-593,47242858.13334119,3383.133333505597,-722,0,-2,0.19285990585927737,-6872951262,2001.3760663211845,1796.1768860189568,205.19918030222766,0.768460623566392,0.7695889633198171,-722
1523,2021-03-04,2021,237163,237163,472109213.8166668,3713964.916666667,183471,0,40,0.8684491257067934,57625748,8193632954,237849,237849,72698,310547,424926559.1499991,3710604.016666385,184313,0,40,0.6677185740000621,6947711569,-686,-686,47182654.6666677,3360.9000002820976,-842,0,0,0.20073055170673137,-6890085821,1990.6529003962119,1786.5391872574578,204.11371313875406,0.7736071815586748,0.7749160181459666,-842
1524,2021-03-05,2021,234194,234194,472837779.45000005,3644415.6666666684,180892,0,105,0.8700649888553926,57645426,8209353745,234933,234933,74789,309722,425786353.81666,3640099.6666664695,181712,0,105,0.6622939281032644,6966465223,-739,-739,47051425.63334006,4316.000000198837,-820,0,0,0.20777106075212826,-6908819797,2019.0003990281564,1812.3735440174858,206.62685501067062,0.7724023672681622,0.7734630724504433,-820
1525,2021-03-06,2021,222808,222808,472954385.61666673,3554195.633333334,173806,0,169,0.8832537431331021,56167323,8223068808,223480,223480,79135,302615,426046808.2000024,3550453.949999901,174633,0,169,0.6557209655833401,6986828546,-672,-672,46907577.41666436,3741.6833334327675,-827,0,0,0.22753277754976198,-6930661223,2122.69929992041,1906.4202980132557,216.27900190715422,0.7800707335463718,0.7814256309289422,-827
1526,2021-03-07,2021,223874,223874,473482053.50000036,3597329.1000000047,173271,0,140,0.87679230281319,57201152,8240945067,224475,224475,72711,297186,426664300.999994,3593351.6499998653,174052,0,142,0.6656605627451999,7006483692,-601,-601,46817752.50000638,3977.450000139419,-781,0,-2,0.21113174006799007,-6949282540,2114.9488261254114,1900.7207974161665,214.22802870924488,0.7739666062159964,0.7753736496269072,-781
1527,2021-03-08,2021,232992,232992,474701083.20000046,3690263.9500000025,178169,0,147,0.8589307787391849,57728949,8262670608,233691,233691,69255,302946,427953824.06666297,3687082.4333331147,178990,0,148,0.6654123177067817,7030351775,-699,-699,46747259.1333375,3181.5166668877937,-821,0,-1,0.19351846103240322,-6972622826,2037.4136588380736,1831.2807256876088,206.13293315046485,0.7647000755390743,0.7659259449443924,-821
1528,2021-03-09,2021,237634,237634,475656177.89999956,3756531.6,185241,0,173,0.8775932736897922,57929426,8279613287,238300,238300,70523,308823,429052554.5333312,3752750.516666272,186072,0,174,0.6801695469573155,7051279174,-666,-666,46603623.36666834,3781.0833337279037,-831,0,-1,0.19742372673247677,-6993349748,2001.6335116187058,1800.4723228423468,201.16118877635904,0.7795222905813142,0.7808308854385229,-831
1529,2021-03-10,2021,235838,235838,476563622.4666667,3741701.2333333334,182575,0,167,0.8695502845173378,57165151,8298786998,236414,236414,73910,310324,430081124.26666105,3738652.5833332255,183373,0,169,0.6659716941003571,7071684030,-576,-576,46482498.20000565,3048.6500001079403,-798,0,-2,0.2035785904169808,-7014518879,2020.7244908227965,1819.1863606497968,201.53813017299967,0.7741542923532255,0.775643574407607,-798
1530,2021-03-11,2021,239414,239414,477383276.6499999,3746140.7166666714,183971,0,167,0.8662108314467833,56879642,8313716853,240182,240182,73021,313203,430989799.56666994,3742087.483333118,184960,0,168,0.667420171582014,7095222181,-768,-768,46393477.083329976,4053.233333553653,-989,0,-1,0.1987906598647693,-7038342539,1993.9655853458858,1794.4300554024446,199.53552994344113,0.7684220638726224,0.7700826872954676,-989
1531,2021-03-12,2021,235567,235567,477802568.0166661,3703494.516666667,180255,0,130,0.8633552237792228,55792980,8329054397,236100,236100,76383,312483,431533523.3833318,3699056.21666637,180976,0,130,0.655027633503259,7115058021,-533,-533,46269044.63333434,4438.300000296906,-721,0,0,0.20832759027596381,-7059265041,2028.3085831914748,1827.7574052661237,200.5511779253511,0.765196313575331,0.7665226598898772,-721
1532,2021-03-13,2021,229197,229197,477872734.2833331,3652492.6666666637,174899,0,142,0.8599676261033087,55623950,8339605196,229699,229699,76131,305830,431720576.08332753,3648341.8166664015,175638,0,142,0.6486773697805958,7131996026,-502,-502,46152158.20000559,4150.85000026226,-739,0,0,0.21129025632271292,-7076372076,2084.986864065992,1879.5056838877292,205.48118017826278,0.7630946303834693,0.7646441647547443,-739
1533,2021-03-14,2021,230788,230788,478348466.5833329,3649863.1166666667,176626,0,70,0.8612709499627365,56209657,8357094724,231453,231453,72612,304065,432273501.94999504,3645417.3999997154,177506,0,72,0.6586157564994309,7150259543,-665,-665,46074964.633337855,4445.71666695131,-880,0,-2,0.20265519346330552,-7094049886,2072.6747776458606,1867.6513242429135,205.0234534029471,0.7653170875435464,0.7669202818714814,-880
1534,2021-03-15,2021,237808,237808,479125596.2833331,3717177.6500000036,180335,0,174,0.853171466056651,56695229,8376963610,238493,238493,72205,310698,433173450.51666623,3713601.3666663594,181208,0,175,0.6577770053234886,7167720100,-685,-685,45952145.76666689,3576.283333644271,-873,0,-1,0.19539446073316236,-7111024871,2014.7581085721806,1816.294191094356,198.46391747782468,0.7583218394671332,0.7598042709848927,-873
1535,2021-03-16,2021,238943,238943,479661433.23333293,3699013.316666665,181158,0,225,0.8542246477193308,55727249,8390725520,239549,239549,74604,314153,433830633.3666639,3694798.633333075,181934,0,228,0.6543117525536912,7187748553,-606,-606,45830799.86666906,4214.683333590161,-776,0,-3,0.1999128951656396,-7132021304,2007.430363029396,1811.0308678669662,196.39949516242973,0.7581640809732865,0.7594855332311969,-776
1536,2021-03-17,2021,243473,243473,480454544.0833339,3757895.3000000007,182366,0,120,0.8434816180849619,57157323,8408028576,244244,244244,75482,319726,434801625.4833279,3753960.133333101,183276,0,120,0.6480893014643788,7208062829,-771,-771,45652918.600005984,3935.1666668998078,-910,0,0,0.1953923166205831,-7150905506,1973.3380871116465,1780.1936812504214,193.1444058612251,0.7490193984548594,0.7503807667742094,-910
1537,2021-03-18,2021,237964,237964,481055166.53333354,3550212.1499999925,179022,0,130,0.847346657477601,56359410,8425664310,238606,238606,77597,316203,435529116.76666087,3546457.9499999373,179834,0,131,0.6425524109512082,7227373209,-642,-642,45526049.76667267,3754.2000000551343,-812,0,-1,0.20479424652639278,-7171013799,2021.5459755817415,1825.3066426102482,196.23933297149324,0.7523070716578978,0.7536859928082278,-812
1538,2021-03-19,2021,237863,237863,481583936.38333374,3710624.5833333298,178567,0,129,0.8457305255546261,55040619,8438556060,238526,238526,78527,317053,436183758.4666575,3706278.216666569,179361,0,130,0.6390666544710261,7250211967,-663,-663,45400177.91667622,4346.366666760761,-794,0,-1,0.20666387108360007,-7195171348,2024.6273543314167,1828.663367794947,195.96398653646975,0.7507136460903966,0.751955761636048,-794
1539,2021-03-20,2021,230466,230466,481756010.5333334,3622509.133333333,174177,0,128,0.8486457872310881,57162036,8454492722,231011,231011,77867,308878,436401806.48332024,3618239.9166664924,174889,0,129,0.6377242794890082,7269043501,-545,-545,45354204.050013185,4269.2166668404825,-712,0,-1,0.21092150774207985,-7211881465,2090.3561069022476,1889.0953525300538,201.2607543721938,0.7557600687303117,0.7570591876577306,-712
1540,2021-03-21,2021,218149,218149,481726577.55000055,3547345.9500000034,165807,0,134,0.8570014072950132,56648615,8468408099,218677,218677,77254,295931,436498665.1166635,3543594.966666406,166517,0,135,0.637391824445564,7287161430,-528,-528,45227912.43333703,3750.9833335974254,-710,0,-1,0.2196095828494492,-7230512815,2208.2456373854593,1996.0885923835772,212.15704500188212,0.7600630761543715,0.7614746864096361,-710
1541,2021-03-22,2021,234387,234387,482483198.4999997,3674283.2833333304,176229,0,138,0.8478499234172543,56734379,8486800776,234758,234758,67838,302596,437362446.74999547,3670343.2333331127,176810,0,138,0.6609505743631856,7310275325,-371,-371,45120751.75000423,3940.050000217743,-581,0,0,0.1868993490540687,-7253540946,2058.4895855998825,1863.0353246747522,195.45426092513026,0.7518719041585071,0.7531585718058597,-581
1542,2021-03-23,2021,239506,239506,483259726.4499992,3701752.3500000057,179247,0,127,0.8400290598147864,56507097,8503548615,239995,239995,70656,310651,438223172.0999972,3697766.166666246,179882,0,129,0.6516959546243214,7325626961,-489,-489,45036554.35000199,3986.1833337596618,-635,0,-2,0.18833310519046498,-7269119864,2017.7353655023223,1825.9679247484207,191.7674407539016,0.7484029627650247,0.749523948415592,-635
1543,2021-03-24,2021,241792,241792,483859264.5333336,3778075.9166666716,180114,0,58,0.8406233456855479,57534750,8516341571,246858,246858,75645,322503,438944816.7333281,3778688.016666549,182630,0,59,0.6403196249337195,7344147088,-5066,-5066,44914447.800005496,-612.0999998771586,-2516,0,-1,0.20030372075182834,-7286612338,2001.1384352391046,1778.1267641045788,223.01167113452584,0.74491298305982,0.7398180330392371,-2516
1544,2021-03-25,2021,246021,246021,484961391.7166669,3808545.5000000014,181540,0,160,0.8292909954841258,57863565,8535072773,246754,246754,80333,327087,439835132.51665896,3804029.883333093,182411,0,160,0.6287837792391687,7359840887,-733,-733,45126259.200007915,4515.616666908376,-871,0,0,0.20050721624495704,-7301977322,1971.2194963709069,1782.4843062996301,188.73519007127675,0.7379044878282748,0.7392423223129109,-871
1545,2021-03-26,2021,245237,245237,485104172.0999999,3759229.2500000023,180433,0,80,0.82064696599616,57797216,8540620683,245759,245759,79099,324858,439991925.3166687,3755223.0333332643,181135,0,80,0.6233338874215903,7368880355,-522,-522,45112246.783331215,4006.216666738037,-702,0,0,0.1973130785745697,-7311083139,1978.1035165982291,1790.3390122708372,187.76450432739193,0.735749499463784,0.7370432008593785,-702
1546,2021-03-27,2021,234717,234717,485084683.06666726,3695013.8666666592,175544,0,77,0.8348607045931906,56908907,8547571849,235217,235217,82164,317381,440084094.7166669,3691041.283333342,176206,0,78,0.6210989315680419,7382204625,-500,-500,45000588.35000038,3972.5833333171904,-662,0,-1,0.21376177302514876,-7325295718,2066.6789498275252,1870.9706131642988,195.70833666322642,0.7478964029022184,0.7491210244157522,-662
1547,2021-03-28,2021,237001,237001,485928033.33333254,3698548.733333337,174001,0,82,0.8240302783532554,56964436,8569085817,237518,237518,76242,313760,441001012.6333289,3695058.6500000237,174710,0,82,0.626239801121883,7398474102,-517,-517,44927020.700003624,3490.083333313465,-709,0,0,0.19779047723137233,-7341509666,2050.3206034292366,1856.7056502384194,193.61495319081723,0.7341783368002667,0.7355653045242887,-709
1548,2021-03-29,2021,246468,246468,486909328.86666673,3795741.716666672,180546,0,87,0.8232427739097975,57523195,8587816937,246878,246878,74597,321475,442182231.7666641,3791213.1833331813,181134,0,87,0.6344008087720657,7422762315,-410,-410,44727097.10000265,4528.533333490603,-588,0,0,0.18884196513773177,-7365239120,1975.5478555701623,1791.0961356081307,184.45171996203158,0.7325332294658942,0.7336984259431785,-588
1549,2021-03-30,2021,253151,253151,487560522.53333366,3891438.3666666625,184931,0,104,0.8220350699779982,58728205,8599992401,253874,253874,76044,329918,442997568.28332996,3887305.749999835,185676,0,104,0.6346516407107045,7445587302,-723,-723,44562954.250003695,4132.616666827351,-745,0,0,0.1873834292672938,-7386859097,1925.9671995502038,1744.9505198773013,181.01667967290246,0.7305165691622787,0.7313706799435941,-745
1550,2021-03-31,2021,252200,252200,488461058.183334,3880635.7833333323,185830,0,146,0.8289770023790636,58391430,8617233519,252843,252843,80230,333073,443973447.13332623,3876612.4166665664,186642,0,147,0.6321256901640391,7462265879,-643,-643,44487611.05000776,4023.3666667658836,-812,0,-1,0.1968513122150245,-7403874449,1936.8003893074306,1755.925404829583,180.87498447784765,0.7368358445678034,0.7381734910596695,-812
1551,2021-04-01,2021,242976,242976,488693438.3166668,3794234.3,180277,0,127,0.8343787040695387,57504421,8630822893,243614,243614,82667,326281,444322451.18332356,3789536.2833333393,181103,0,128,0.6257397764503541,7482581540,-638,-638,44370987.13334322,4698.016666660551,-826,0,-1,0.20863892761918468,-7425077119,2011.2827535092633,1823.8789691205086,187.40378438875473,0.7419539378374819,0.7434014465506908,-826
1552,2021-04-02,2021,237948,237948,488667547.833333,3728331.516666667,178635,0,124,0.842137778001917,57103951,8639621533,238555,238555,78816,317371,444411907.516657,3723743.966666475,179386,0,124,0.6353479051331107,7498734178,-607,-607,44255640.31667602,4587.550000192132,-751,0,0,0.20678987286880635,-7441630227,2053.6736927115717,1862.9326885483724,190.74100416319925,0.7507312522063644,0.7519691475760307,-751
1553,2021-04-03,2021,227477,227477,488339695.9999997,3617192.6166666644,172290,0,142,0.8499057047525689,57084780,8647944323,228002,228002,76772,304774,444136975.3666639,3613430.9333332023,173000,0,143,0.6381023315637196,7509190492,-525,-525,44202720.63333583,3761.683333462104,-710,0,-1,0.21180337318884923,-7452105712,2146.765149883284,1947.952102905518,198.8130469777659,0.7573952531464719,0.7587652739888247,-710
1554,2021-04-04,2021,221212,221212,488118428.5666665,3583696.5500000017,167292,0,150,0.8494204654358712,56934821,8656194967,221736,221736,74517,296253,444051694.9333292,3579920.4499998824,167972,0,151,0.6384542941337273,7523695308,-524,-524,44066733.63333726,3776.1000001193024,-680,0,-1,0.2109661713021439,-7466760487,2206.563968350119,2002.6143473920754,203.94962095804362,0.7562519212339295,0.7575314788757802,-680
1555,2021-04-05,2021,231361,231361,488969918.03333366,3665325.5333333346,172475,0,134,0.8354044112879878,57499613,8676655968,231983,231983,67314,299297,444967894.3333268,3661313.633333197,173245,0,136,0.6503306080582003,7535844486,-622,-622,44002023.70000684,4011.9000001377426,-770,0,-2,0.1850738032297875,-7478344873,2113.4500543883096,1918.1056126238855,195.34444176442412,0.7454800074342693,0.7468004120991625,-770
1556,2021-04-06,2021,236055,236055,489485713.2166663,3710683.45,174939,0,119,0.829573616318231,57996118,8692465126,236876,236876,68985,305861,445605137.4166527,3707243.5666663954,175854,0,121,0.6451231114787378,7556286031,-821,-821,43880575.8000136,3439.883333604783,-915,0,-2,0.1844505048394932,-7498289913,2073.6087488791436,1881.1746965359625,192.43405234318107,0.7410942365126771,0.7423884226346275,-915
1557,2021-04-07,2021,239442,239442,489520316.49999994,3747109.1333333342,176961,0,163,0.8281838608097158,58365204,8705051530,240241,240241,71954,312195,445764986.249987,3742737.416666673,177792,0,164,0.6396547029901085,7576585352,-799,-799,43755330.250012934,4371.716666661203,-831,0,-1,0.18852915781960733,-7518220148,2044.42126485746,1855.4908872756398,188.93037758182027,0.7390558047460345,0.7400568595701816,-831
1558,2021-04-08,2021,238015,238015,489918067.0333325,3730253.333333331,176616,0,131,0.8354431443396426,58059865,8717265445,238862,238862,75101,313963,446270745.4166582,3726806.183333254,177501,0,132,0.6385975417485481,7594044475,-847,-847,43647321.616674304,3447.1500000772066,-885,0,-1,0.19684560259109452,-7535984610,2058.349545336775,1868.3203917603396,190.02915357643542,0.7420372665588303,0.7431110850616675,-885
1559,2021-04-09,2021,248752,248752,490624401.71666676,3863180.3833333296,192770,0,164,0.8746020132501449,58889798,8732011707,249540,249540,74592,324132,447125179.33331966,3858904.5499997013,193659,0,165,0.6753112929300481,7613059690,-788,-788,43499222.383347094,4275.833333628252,-889,0,-1,0.19929072032009676,-7554169892,1972.343545847538,1791.7976249632109,180.5459208843272,0.7749485431272914,0.7760639576821351,-889
1560,2021-04-10,2021,249296,249296,491182173.61666673,3874599.966666664,191711,0,243,0.8612813683332264,58137612,8746928659,249825,249825,78368,328193,447826210.6333278,3870325.4333332395,192380,0,244,0.6570889689908138,7627430426,-529,-529,43355962.98333895,4274.533333424479,-669,0,-1,0.20419239934241262,-7569292814,1970.2769944831314,1792.5596342773053,177.71736020582603,0.7690095308388422,0.7700590413289302,-669
1561,2021-04-11,2021,246963,246963,491789703.2499994,3851618.1833333317,189084,0,165,0.8642023299036701,57464613,8762619240,260201,260201,80023,340224,448501841.8499876,3858224.016666547,194942,0,166,0.6463859104589987,7644454828,-13238,-13238,43287861.40001178,-6605.833333215211,-5858,0,-1,0.21781641944467134,-7586990215,1991.3497295141353,1723.6745510201254,267.67517849400997,0.7656369577629037,0.7491977355967118,-5858
1562,2021-04-12,2021,245237,245237,492312706.90000004,3855078.6500000022,189094,0,370,0.868543490582579,57128383,8777297359,261426,261426,86454,347880,447923901.56665176,3913175.3333331216,196551,0,374,0.6359865470852201,7644044334,-16189,-16189,44388805.333348274,-58096.68333311938,-7457,0,-4,0.2325569434973589,-7586915951,2007.4976732711623,1713.3869682688476,294.1107050023147,0.7710663562186783,0.7518418213949646,-7457
1563,2021-04-13,2021,248214,248214,492601730.18333316,3805069.233333334,188459,0,164,0.8497224169466674,57304385,8788278961,248809,248809,89526,338335,442784839.51666045,3801094.5333331143,189151,0,165,0.6266924793474079,7460631388,-595,-595,49816890.66667271,3974.7000002195127,-692,0,-1,0.2230299375992595,-7403327003,1984.5847945052783,1779.6174556252404,204.96733888003791,0.7592601545440628,0.760225715307726,-692
1564,2021-04-14,2021,246109,246109,493054435.45000017,3820139.7166666645,185725,0,160,0.840481250177766,58028979,8801604462,246702,246702,81286,327988,443334885.86666244,3816182.133333026,186408,0,161,0.6341116138395309,7461512403,-593,-593,49719549.583337724,3957.5833336384967,-683,0,-1,0.20636963633823513,-7403483424,2003.3986382050236,1797.046176628736,206.35246157628762,0.7546452994404919,0.7555998735316293,-683
1565,2021-04-15,2021,249061,249061,493385977.2833341,3847645.016666665,187911,0,164,0.8386058033975622,58590300,8813162068,249604,249604,79067,328671,443866352.5999944,3843556.2333330647,188482,0,165,0.6388881282498363,7482185562,-543,-543,49519624.683339655,4088.7833336004987,-571,0,-1,0.19971767514772587,-7423595262,1980.984486866005,1778.2822094196986,202.70227744630643,0.7544778186869884,0.7551241166006954,-571
1566,2021-04-16,2021,265129,265129,493823519.0833337,3896425.8499999987,193010,0,159,0.8148976535950427,59785049,8829446293,266386,266386,81514,347900,444459687.1166651,3892067.516666385,193896,0,160,0.6249094567404392,7497623456,-1257,-1257,49363831.966668546,4358.333333613817,-886,0,-1,0.18998819685460355,-7437838407,1862.5782886192521,1668.479901784122,194.0983868351302,0.7279852449185114,0.7278760895842875,-886
1567,2021-04-17,2021,245034,245034,493612460.6166667,3790301.233333336,185127,0,161,0.8443807798101486,59775586,8836448184,245507,245507,95421,340928,444379793.5499886,3786187.8166664904,185766,0,161,0.6100818941242782,7514447854,-473,-473,49232667.06667805,4113.416666845791,-639,0,0,0.23429888568587043,-7454672268,2014.4651787779112,1810.0493816876449,204.41579709026632,0.7555155611058058,0.7566627428138505,-639
1568,2021-04-18,2021,244833,244833,494189123.5000003,3806422.5666666655,184171,0,165,0.8409323906499534,59503567,8853272978,245364,245364,82865,328229,445047556.5999914,3802490.583333036,184817,0,166,0.6305049218685684,7529219772,-531,-531,49141566.90000892,3931.983333629556,-646,0,-1,0.21042746878138496,-7469716205,2018.474321272052,1813.8258122625625,204.64850900948954,0.75223111263596,0.7532360085424105,-646
1569,2021-04-19,2021,246417,246417,494969932.1500003,3830434.2000000016,183640,0,158,0.8274023301963749,60404750,8872575759,246950,246950,79533,326483,446046145.46666145,3826835.116666315,184326,0,159,0.628066392430837,7548617772,-533,-533,48923786.68333882,3599.08333368646,-686,0,-1,0.19933593776553793,-7488213022,2008.6679577707719,1806.2204716204149,202.447486150357,0.7452407910168536,0.746410204494837,-686
1570,2021-04-20,2021,253321,253321,495595573.71666646,3905492.2333333334,186606,0,122,0.8197978059458155,60032268,8888958201,253805,253805,77208,331013,446843902.28332824,3901617.6166663556,187245,0,123,0.6306247790872319,7574096512,-484,-484,48751671.433338225,3874.6166669777595,-639,0,-1,0.18917302685858361,-7514064244,1956.3935627787134,1760.579587806892,195.81397497182138,0.7366384942424828,0.7377514233368136,-639
1571,2021-04-21,2021,250641,250641,496151142.9166661,3889972.6499999966,185290,0,42,0.8236202377105108,59020657,8898704114,251257,251257,79632,330889,447558663.66666675,3885940.949999693,185983,0,42,0.6274218846803737,7588674068,-616,-616,48592479.249999344,4031.7000003037974,-693,0,0,0.1961983530301371,-7529653411,1979.5290591589808,1781.278386937147,198.25067222183384,0.7392645257559617,0.7402102229987623,-693
1572,2021-04-22,2021,244239,244239,496592464.1000004,3810877.583333334,182079,0,36,0.8307927890304172,58731966,8915887958,244807,244807,81659,326466,448054006.79998755,3807161.933333064,182787,0,36,0.6250053604356974,7607275419,-568,-568,48538457.30001283,3715.6500002699904,-708,0,0,0.20578742859471977,-7548543453,2033.2234577606378,1830.2336403778795,202.98981738275825,0.7454951911856829,0.7466575710661868,-708
1573,2021-04-23,2021,247369,247369,496915796.29999983,3799515.3500000024,183814,0,37,0.8286689116259509,59064261,8928493767,248500,248500,78027,326527,448507543.06667054,3797296.7999999,184802,0,37,0.6322662444453361,7626673625,-1131,-1131,48408253.233329296,2218.550000102259,-988,0,0,0.19640266718061483,-7567609364,2008.8038367782538,1804.8593282360987,203.94450854215506,0.7430761332260711,0.7436700201207244,-988
1574,2021-04-24,2021,245514,245514,497089509.0833328,3823842.183333333,183500,0,46,0.8327590279984025,59505549,8940491426,245915,245915,82333,328248,448616996.88332325,3819201.483333151,184143,0,46,0.6265811215909954,7637467389,-401,-401,48472512.200009525,4640.70000018226,-643,0,0,0.20617790640740707,-7577961840,2024.6890567679757,1824.276668293204,200.41238847477166,0.7474115529053333,0.7488075147916963,-643
1575,2021-04-25,2021,245177,245177,497671505.8166667,3834913.916666666,183069,0,38,0.8363019369679863,59780603,8958079909,245683,245683,78651,324334,449311142.6666647,3830809.1499999706,183759,0,38,0.6358414473968259,7654050131,-506,-506,48360363.150002,4104.766666695476,-690,0,0,0.20046048957116036,-7594269528,2029.8458086062997,1828.8247158601316,201.02109274616805,0.7466809692589436,0.7479516287248202,-690
1576,2021-04-26,2021,248768,248768,498542305.45000005,3873760.066666669,185359,0,33,0.8288485657319278,59894360,8974635592,249422,249422,78987,328409,450313711.60000074,3869277.5666666026,186154,0,33,0.6324613515464037,7675157047,-654,-654,48228593.84999931,4482.50000006659,-795,0,0,0.19638721418552407,-7615262687,2004.0451563303964,1805.428998243943,198.61615808645342,0.7451078916902496,0.7463415416442816,-795
1577,2021-04-27,2021,255758,255758,499392779.15000004,3958048.7999999966,188431,0,96,0.8244004097623535,60648400,8988971169,256769,256769,76811,333580,451310593.2999958,3953080.6166665303,189524,0,96,0.6372714191498119,7695040107,-1011,-1011,48082185.850004256,4968.183333466295,-1093,0,0,0.18712899061254162,-7634391707,1952.598859664214,1757.6521827011663,194.9466769630476,0.7367550575153075,0.73811090902718,-1093
1578,2021-04-28,2021,265952,265952,500361901.93333346,4090520.5333333286,203622,0,40,0.8585383828660801,61111324,9002852370,266639,266639,79858,346497,452352608.7166592,4085833.733333168,204445,0,40,0.6633592787238975,7715958396,-687,-687,48009293.21667427,4686.800000160467,-823,0,0,0.19517910414218254,-7654847072,1881.3992823266358,1696.4982943855146,184.90098794112123,0.7656344001925159,0.7667483001361391,-823
1579,2021-04-29,2021,268066,268066,501204510.66666687,4111281.833333331,204405,0,41,0.8544425626524802,60305887,9019321596,268727,268727,83261,351988,453367543.3833263,4105852.8166661463,205289,0,41,0.6554541632101268,7736100754,-661,-661,47836967.28334057,5429.016667184886,-884,0,0,0.19898839944235336,-7675794867,1869.7056346820068,1687.0933824413858,182.61225224062105,0.7625174397349906,0.7639314248289156,-884
1580,2021-04-30,2021,272808,272808,501910361.5666665,4138069.150000006,212105,0,54,0.8716130025512451,61913310,9040644083,273398,273398,85843,359241,454150522.73332816,4132211.5333330203,213029,0,54,0.667292987159046,7758157882,-590,-590,47759838.83333832,5857.616666985676,-924,0,0,0.20432001539219913,-7696244572,1839.7934135606965,1661.1333028527208,178.66011070797572,0.7774881968270725,0.7791900452819699,-924
1581,2021-05-01,2021,254206,254206,501112276.51666594,3945075.383333329,197602,0,44,0.8644327828611433,60729731,9047444914,257285,257285,94685,351970,453504347.5999952,3940126.8333330466,199504,0,44,0.6325652754496202,7775013024,-3079,-3079,47607928.91667074,4948.55000028247,-1902,0,0,0.23186750741152318,-7714283293,1971.284220343603,1762.6536626697832,208.6305576738198,0.7773301967695491,0.7754202538041471,-1902
1582,2021-05-02,2021,241310,241310,501094604.2833328,3851493.7166666687,188437,0,48,0.8660768306327962,60130120,9059855717,241676,241676,88505,330181,453584975.8666706,3846262.8833329375,189268,0,51,0.6380227814441091,7788750990,-366,-366,47509628.416662216,5230.833333731163,-831,0,-3,0.2280540491886871,-7728620870,2076.5596298675264,1876.8308639114791,199.72876595604725,0.7808917989308358,0.7831476853307734,-831
1583,2021-05-03,2021,231615,231615,501514582.4666664,3775194.8166666687,180471,0,48,0.8632083414286633,59033490,9078140708,232277,232277,76923,309200,454089297.883333,3770879.0833330234,181296,0,48,0.6522703751617105,7806522378,-662,-662,47425284.58333337,4315.7333336453885,-825,0,0,0.21093796626695283,-7747488888,2165.2940546452796,1954.947316709502,210.34673793577758,0.7791852859270773,0.7805163662351416,-825
1584,2021-05-04,2021,231210,231210,501737877.3000005,3773377.2166666677,179746,0,57,0.860693741620172,59130220,9090091104,232059,232059,68787,300846,454460991.69999915,3769170.716666454,180691,0,57,0.6680328141307995,7825582595,-849,-849,47276885.600001335,4206.5000002137385,-945,0,0,0.19266092748937247,-7766452375,2170.052667704686,1958.385547209973,211.6671204947129,0.7774144716924009,0.7786425003986055,-945
1585,2021-05-05,2021,236079,236079,502449810.983333,3820185.7666666727,182448,0,63,0.8527357367660818,60444414,9104407395,236790,236790,66944,303734,455237682.6499957,3815604.999999689,183322,0,56,0.6684566100601164,7843882426,-711,-711,47212128.33333731,4580.76666698372,-874,0,7,0.18427912670596547,-7783438012,2128.312179326975,1922.5376183537974,205.7745609731778,0.7728260455186611,0.7741965454622239,-874
1586,2021-05-06,2021,238113,238113,503287396.36666644,3838631.33333334,184749,0,55,0.8570258658704059,60081171,9123019264,238878,238878,68774,307652,456243992.11667293,3833655.2499996666,185657,0,57,0.6702670549841897,7863169977,-765,-765,47043404.2499935,4976.083333673421,-908,0,-2,0.18675881088621615,-7803088806,2113.6493864957665,1909.9456296380283,203.7037568577382,0.7758879187612604,0.777204263264093,-908
1587,2021-05-07,2021,239496,239496,503923114.7333337,3829095.0833333307,186376,0,93,0.8626824665130111,60303054,9138034535,240324,240324,70956,311280,456996306.93333143,3824441.549999757,187376,0,93,0.6701747622718927,7879933880,-828,-828,46926807.80000228,4653.53333357349,-1000,0,0,0.1925077042411184,-7819630826,2104.0982510494277,1901.5841402994768,202.514110749951,0.7782008885325851,0.7796807643015262,-1000
1588,2021-05-08,2021,241780,241780,504267116.8000001,3839251.933333332,186806,0,76,0.8578583836545625,61355857,9145767847,242414,242414,72567,314981,457491974.15000266,3834255.0499995886,187622,0,78,0.6641352970496697,7900589646,-634,-634,46775142.64999741,4996.88333374355,-816,0,-2,0.1937230866048928,-7839233789,2085.6444569443297,1887.2341290107117,198.41032793361796,0.7726280089337414,0.7739734503782785,-816
1589,2021-05-09,2021,239096,239096,504877306.98333246,3816128.3499999973,184515,0,93,0.8582284939940442,60993743,9165086918,239677,239677,74170,313847,458177612.61666346,3811540.1833329946,185317,0,93,0.6592065560607497,7920870887,-581,-581,46699694.366669,4588.166667002719,-802,0,0,0.19902193793329448,-7859877144,2111.6091736513054,1911.6461430035567,199.9630306477486,0.7717193093987352,0.7731947579450678,-802
1590,2021-05-10,2021,237352,237352,505616894.68333316,3782117.8666666728,183077,0,57,0.8534370892177028,59895669,9186985117,238184,238184,75947,314131,458960939.3333374,3778162.799999701,184050,0,57,0.651190108585279,7941278216,-832,-832,46655955.34999573,3955.066666971892,-973,0,0,0.20224698063242375,-7881382547,2130.2407170924753,1926.917590322345,203.32312677013033,0.7713311874346962,0.7727219292647701,-973
1591,2021-05-11,2021,241716,241716,505206454.43333364,3871900.9333333313,191063,0,45,0.8741250062056295,61458841,9181156368,242523,242523,71366,313889,458711385.18333054,3867980.149999784,191986,0,47,0.6795555116617714,7947921669,-807,-807,46495069.2500031,3920.7833335474133,-923,0,-2,0.19456949454385808,-7886462828,2090.082801441914,1891.4139491237142,198.6688523181997,0.7904441576064473,0.7916197638986818,-923
1592,2021-05-12,2021,245082,245082,505553756.4166665,3912147.8999999976,194183,0,64,0.8744257024179657,60976104,9190297330,245774,245774,70220,315994,459115393.1166662,3908270.166666288,195046,0,64,0.6842914738887621,7962330194,-692,-692,46438363.30000031,3877.7333337096497,-863,0,0,0.19013422852920359,-7901354090,2062.794315440002,1868.038902067209,194.75541337279287,0.7923184893219413,0.7935989974529446,-863
1593,2021-05-13,2021,246870,246870,505989213.94999933,3931835.583333328,193875,0,123,0.864398266293999,61364680,9208675480,247616,247616,73261,320877,459644258.350008,3927927.533333131,194798,0,124,0.6710016610726467,7976769761,-746,-746,46344955.59999132,3908.0500001967885,-923,0,-1,0.19339660522135227,-7915405081,2049.618074087574,1856.278505225866,193.3395688617079,0.7853323611617451,0.7866939131558542,-923
1594,2021-05-14,2021,246556,246556,506416763.0333332,3902771.1499999985,192910,0,82,0.8608348610457653,60488854,9221740517,247214,247214,74643,321857,460271999.53333795,3898459.116666497,193736,0,82,0.6654725545817073,7996619038,-658,-658,46144763.49999523,4312.033333501313,-826,0,0,0.19536230646405806,-7936130184,2053.9624386887085,1861.8363018815194,192.12613680718914,0.7824185986145136,0.7836772998292977,-826
1595,2021-05-15,2021,240429,240429,506550889.73333323,3844881.4499999955,187943,0,73,0.8624417187610474,60582349,9233126451,240986,240986,76767,317753,460462319.93332684,3840767.2499998156,188718,0,75,0.6580110966694284,8014960386,-557,-557,46088569.80000639,4114.2000001799315,-775,0,-2,0.204430622091619,-7954378037,2106.8626901635544,1910.743030438809,196.11965972474536,0.7816985471802487,0.7831077323993925,-775
1596,2021-05-16,2021,237073,237073,506622305.2999999,3783254.7999999975,184987,0,102,0.8582672847603899,59548254,9240815579,237584,237584,74925,312509,460665529.9500066,3779265.516666437,185691,0,103,0.6565058926302858,8027558337,-511,-511,45956775.34999329,3989.283333560452,-704,0,-1,0.20176139213010413,-7968010083,2136.988629240782,1938.958557604917,198.03007163586494,0.7802955207889553,0.7815804094551821,-704
1597,2021-05-17,2021,239825,239825,507220003.1333326,3851913.233333333,186293,0,37,0.8569373501511519,60011762,9255541285,240353,240353,73515,313868,461374137.749997,3847960.8499996467,187028,0,38,0.6590764270330269,8042341352,-528,-528,45845865.38333559,3952.3833336862735,-735,0,-1,0.19786092311812498,-7982329590,2114.9588372076832,1919.568874738393,195.38996246929014,0.7767872406963411,0.7781388208177139,-735
1598,2021-05-18,2021,241223,241223,507709742.5499999,3863592.7166666663,186384,0,174,0.8517554296232112,59319984,9265539740,241636,241636,69215,310851,461995757.28333324,3859697.549999729,186950,0,175,0.6649713206648902,8057046121,-413,-413,45713985.26666665,3895.1666669375263,-566,0,-1,0.18678410895832098,-7997726137,2104.7318976631577,1911.9492016228262,192.78269604033153,0.7726626399638509,0.7736843847771028,-566
1599,2021-05-19,2021,240876,240876,508562423.3000001,3843835.7499999963,185662,0,155,0.8508029027383384,59532247,9285978365,241420,241420,71134,312554,462927134.54999596,3840151.2166663986,186198,0,157,0.6590925088144535,8075270249,-544,-544,45635288.75000411,3684.5333335977048,-536,0,-2,0.1917103939238849,-8015738002,2111.3038380743624,1917.5177472868693,193.7860907874931,0.7707783257775785,0.7712617015988733,-536
1600,2021-05-20,2021,235101,235101,508856169.11666644,3792422.4833333297,182885,0,156,0.8577122173023504,59131885,9297860130,235441,235441,73811,309252,463337363.6833349,3788620.6499996167,183348,0,158,0.6551032814662332,8094688031,-340,-340,45518805.43333155,3801.8333337130025,-463,0,-2,0.20260893583611717,-8035556146,2164.415162490446,1967.955299558424,196.45986293202213,0.7778997111879575,0.7787428697635501,-463
1601,2021-05-21,2021,241841,241841,509258147.1666664,3891028.166666669,192781,0,150,0.8780397037723126,59303193,9310617302,242229,242229,71271,313500,463852689.5333331,3887652.1166663514,193260,0,151,0.6810558213716189,8112540988,-388,-388,45405457.633333266,3376.0500003173947,-479,0,-1,0.19698388240069364,-8053237795,2105.756042882168,1914.9345847662053,190.82145811596274,0.7971394428570838,0.7978400604386758,-479
1602,2021-05-22,2021,244948,244948,509686423.9166671,4013828.0666666646,192561,0,159,0.8704418897072034,59449607,9315417767,245378,245378,67796,313174,464454527.8999996,4010231.9333331236,193109,0,159,0.6850313244394393,8125098204,-430,-430,45231896.016667485,3596.133333540987,-548,0,0,0.18541056526776412,-8065648597,2080.7943886729718,1892.8124277645088,187.98196090846295,0.7861301174126754,0.7869857933474068,-548
1603,2021-05-23,2021,244611,244611,510700710.04999995,3998955.9500000016,192790,0,154,0.8756719853154604,60688265,9334482305,245115,245115,69873,314988,465617842.81665707,3995262.149999864,193447,0,155,0.6846927502000095,8141178182,-504,-504,45082867.233342886,3693.8000001376495,-657,0,-1,0.1909792351154509,-8080489917,2087.8076212844067,1899.5893471091408,188.21827417526583,0.7881493473310686,0.7892091467270465,-657
1604,2021-05-24,2021,246461,246461,511860034.95000076,3997201.2333333334,194401,0,155,0.8741545315486026,60157531,9357297285,247055,247055,71812,318867,466881773.48333865,3993735.1333329966,195070,0,156,0.6798414385935234,8164689664,-594,-594,44978261.46666211,3466.1000003367662,-669,0,-1,0.19431309295507915,-8104532133,2076.839885215108,1889.7888060688456,187.0510791462625,0.7887698256519287,0.7895812673291372,-669
1605,2021-05-25,2021,245318,245318,512542565.04999983,4007345.5000000056,194130,0,47,0.8860132562632991,60062544,9373332919,245990,245990,71265,317255,467648606.44999653,4003524.733332603,194987,0,49,0.6915352003908538,8188460777,-672,-672,44893958.6000033,3820.766667402815,-857,0,-2,0.19447805587244527,-8128398233,2089.298645227826,1901.087875320121,188.21076990770507,0.7913402196332923,0.7926623033456645,-857
1606,2021-05-26,2021,243092,243092,513421059.71666664,3988240.2833333365,192724,0,287,0.8815921544106753,59591061,9392216127,243673,243673,69650,313323,468547107.25000286,3984215.649999725,193412,0,287,0.6890429365223725,8205054645,-581,-581,44873952.46666378,4024.633333611302,-688,0,0,0.19254921788830281,-8145463584,2112.044245457138,1922.8519665699641,189.19227888717387,0.7928027248942787,0.7937358673303977,-688
1607,2021-05-27,2021,247862,247862,514114380.31666684,4026773.4166666623,196479,0,261,0.8802922594024088,60044284,9405393528,248372,248372,68543,316915,469387417.2499983,4023446.7166662687,197054,0,261,0.692040452487256,8223899544,-510,-510,44726963.06666857,3326.70000039367,-575,0,0,0.18825180691515286,-8163855260,2074.1960458507833,1889.856413967751,184.33963188303233,0.792695128740993,0.793382506884834,-575
1608,2021-05-28,2021,253766,253766,514829802.46666616,4056199.4499999993,201678,0,50,0.8821512732202114,60407363,9418423348,254305,254305,70584,324889,470230459.78333056,4052600.6666654195,202328,0,50,0.6929074237662644,8241458967,-539,-539,44599342.6833356,3598.7833345797844,-650,0,0,0.189243849453947,-8181051604,2028.7579993642416,1849.0806699959912,179.6773293682504,0.7947400360962461,0.7956115687855134,-650
1609,2021-05-29,2021,255821,255821,515433239.9499996,4113697.2999999975,204209,0,42,0.8891334175067722,61300021,9426789204,256353,256353,74119,330472,470948948.9333347,4109732.7166663795,204799,0,42,0.6929089302573234,8256616754,-532,-532,44484291.01666486,3964.5833336180076,-590,0,0,0.19622448724944885,-8195316733,2014.8198934020256,1837.111127754833,177.70876564719265,0.7982495573076487,0.7988944931403182,-590
1610,2021-05-30,2021,256120,256120,516371485.3999997,4093995.983333334,204642,0,37,0.8844135561455578,61897051,9442874217,256513,256513,73797,330310,472017232.7333312,4089773.366666595,205158,0,38,0.6888861978141797,8273247007,-393,-393,44354252.666668475,4222.616666738875,-516,0,-1,0.19552735833137813,-8211349956,2016.1310534124616,1840.1298676220356,176.001185790426,0.7990082773699828,0.799795721854253,-516
1611,2021-05-31,2021,258997,258997,517249237.2166669,4113192.783333332,202598,0,35,0.8626818071251785,61533955,9459552650,259342,259342,79235,338577,472968688.25000226,4109182.499999818,203117,0,35,0.6633321223828038,8294352946,-345,-345,44280548.96666461,4010.2833335138857,-519,0,0,0.1993496847423747,-8232818991,1997.1244347103127,1823.7257684833241,173.39866622698855,0.7822407209349915,0.7832013326032806,-519
1612,2021-06-01,2021,258873,258873,517815099.48333263,4125877.900000007,202337,0,39,0.8639101026372005,61211904,9470880523,259332,259332,77404,336736,473630541.8166696,4122125.166664793,202911,0,39,0.6678198945167658,8310744873,-459,-459,44184557.66666305,3752.7333352137357,-574,0,0,0.19609020812043465,-8249532969,2000.2669242575805,1826.3482401580584,173.91868409952212,0.7816071973515971,0.7824371847670168,-574
1613,2021-06-02,2021,256845,256845,518263477.5000001,4133957.399999998,201520,0,35,0.8702213397185073,60996147,9478570857,257297,257297,75421,332718,474249439.7166631,4129628.583333079,202134,0,35,0.6763114709754181,8328251160,-452,-452,44014037.783337,4328.816666919272,-614,0,0,0.19390986874308924,-8267255013,2017.8063715470425,1843.198481586117,174.6078899609256,0.7845977145749382,0.7856057396704975,-614
1614,2021-06-03,2021,255276,255276,518803036.84999996,4109568.599999999,199827,0,42,0.8672887384634668,60810352,9487374239,255719,255719,75294,331013,474884934.4499982,4105501.616666317,200374,0,42,0.6727439707806129,8340341807,-443,-443,43918102.400001764,4066.9833336821757,-547,0,0,0.1945447676828539,-8279531455,2032.322023417791,1857.0576861711418,175.26433724664912,0.7827880411789593,0.7835710291374517,-547
1615,2021-06-04,2021,256738,256738,519140922.5333335,4103175.099999996,202065,0,34,0.8670590251540489,61601182,9495407546,257283,257283,76083,333366,475325278.200002,4099175.9499996933,202758,0,37,0.6723781069455231,8354689060,-545,-545,43815644.333331466,3999.1500003025867,-693,0,-3,0.19468091820852573,-8293087878,2022.0649944041531,1847.4803162276637,174.58467817648943,0.7870474958907524,0.7880738330942969,-693
1616,2021-06-05,2021,255916,255916,519536490.2500005,4152887.5666666655,204204,0,63,0.8764750933900185,61815147,9503786961,256303,256303,75437,331740,475741877.2833326,4148652.616666376,204737,0,63,0.6799059504431114,8363821144,-387,-387,43794612.96666789,4234.950000289362,-533,0,0,0.19656914294690708,-8302005997,2030.1055434204993,1856.1697572144399,173.93578620605945,0.7979336969943263,0.7988084415711092,-533
1617,2021-06-06,2021,260225,260225,520509744.8499999,4131076.21666667,206577,0,39,0.8743049284273249,63754374,9521660001,260662,260662,72713,333375,476814626.616668,4127121.5499996883,207082,0,40,0.6859632545931759,8377685218,-437,-437,43695118.23333192,3954.666666981764,-505,0,-1,0.18834167383414901,-8313930844,2000.229589201652,1829.2448711997451,170.9847180019069,0.7938399462004035,0.7944464478903714,-505
1618,2021-06-07,2021,255148,255148,521261303.0666663,4124042.3833333356,200594,0,34,0.8689897628043338,62807972,9541696922,255470,255470,81089,336559,477664501.7333352,4119661.8666664725,201040,0,35,0.6616254505153647,8397512375,-322,-322,43596801.33333111,4380.516666863114,-446,0,-1,0.20736431228896912,-8334704403,2042.976245420957,1869.7479223914165,173.22832302954043,0.7861868405788013,0.7869417152698948,-446
1619,2021-06-08,2021,258525,258525,521818898.3833335,4161149.2833333327,201762,0,45,0.8661135286722753,62843958,9550493155,258803,258803,72317,331120,478300406.3166719,4157395.416666344,202097,0,45,0.6784760811790257,8418125901,-278,-278,43518492.0666616,3753.8666669889353,-335,0,0,0.18763744749324962,-8355281943,2018.446565644845,1848.1254325362222,170.3211331086227,0.7804351610095736,0.7808912570565256,-335
1620,2021-06-09,2021,257917,257917,522622362.16666675,4158603.6500000036,202260,0,43,0.86591810543702,62382490,9567959448,258236,258236,74343,332579,479152722.35000354,4155134.599999721,202632,0,43,0.6735542532751781,8435095617,-319,-319,43469639.816663206,3469.05000028247,-372,0,0,0.19236385216184182,-8372713127,2026.3199485364157,1855.4838301011614,170.83611843525432,0.7842057716242047,0.7846775817469291,-372
1621,2021-06-10,2021,257269,257269,521989584.0333332,4152389.483333327,202259,0,57,0.8742328069063897,62250805,9557219697,257545,257545,74884,332429,478664402.88332784,4148217.9999995283,202618,0,57,0.6786772513829922,8439869223,-276,-276,43325181.15000534,4171.483333798591,-359,0,0,0.19555555552339754,-8377618418,2028.964173815474,1858.5660870268414,170.39808678863255,0.7861771142267432,0.7867285328777495,-359
1622,2021-06-11,2021,258431,258431,522583162.0333338,4139645.083333338,204478,0,41,0.8789270637036586,62411112,9571280556,258645,258645,74222,332867,479412014.11667216,4135764.8166663153,204765,0,41,0.6843033403732008,8447697904,-214,-214,43171147.91666162,3880.2666670228355,-287,0,0,0.19462372333045774,-8385286792,2022.1380640609439,1853.552220675722,168.58584338522178,0.7912286064752294,0.7916835817433161,-287
1623,2021-06-12,2021,256814,256814,522815757.1666671,4158668.083333331,204701,0,57,0.8814122283053101,62745871,9582371582,256876,256876,76274,333150,479742626.68333256,4154638.3833330935,204884,0,56,0.6810655860723386,8465138903,-62,-62,43073130.48333454,4029.7000002376735,-183,0,1,0.2003466422329715,-8402393032,2035.7759201860767,1867.6039282896518,168.17199189642497,0.7970788196905153,0.7975988414643641,-183
1624,2021-06-13,2021,256699,256699,523532454.51666677,4139201.9166666623,204339,0,72,0.878655545989661,63240470,9595807421,256822,256822,73447,330269,480585231.4500084,4135571.3499997207,204539,0,71,0.6843149069394954,8479844922,-123,-123,42947223.06665838,3630.566666941624,-200,0,1,0.19434063905016563,-8416604452,2039.4799142835257,1871.277505237123,168.20240904640264,0.7960256954643377,0.7964232036196276,-200
1625,2021-06-14,2021,246307,246307,523708872.2000002,4057501.5999999954,195021,0,52,0.8722163803708369,61134095,9608828751,246539,246539,78827,325366,480774683.98333406,4054765.3166662417,195238,0,52,0.6616487278941299,8500026714,-232,-232,42934188.21666616,2736.2833337537013,-217,0,0,0.21056765247670706,-8438892619,2126.2443706431413,1950.0958630615605,176.14850758158082,0.7917801767712651,0.7919152750680419,-217
1626,2021-06-15,2021,250433,250433,524235592.54999965,4083324.099999999,199059,0,49,0.8800717157882542,62188263,9618065806,250609,250609,68225,318834,481413596.40000135,4080113.2166663115,199221,0,49,0.6925955199257383,8513661192,-176,-176,42821996.14999831,3210.8833336876705,-162,0,0,0.18747619586251585,-8451472929,2093.3167455966254,1920.9748907660992,172.34185483052624,0.7948593036860159,0.7949475078708267,-162
1627,2021-06-16,2021,258383,258383,524930846.36666685,4178687.266666662,200716,0,63,0.860331368549789,63146233,9631975434,258508,258508,69222,327730,482162076.75000244,4175146.2833329807,200928,0,63,0.679596008909783,8528258676,-125,-125,42768769.61666441,3540.9833336812444,-212,0,0,0.18073535964000598,-8465112443,2031.5997815903788,1865.172748038755,166.42703355162394,0.7768158121857862,0.7772602782118928,-212
1628,2021-06-17,2021,260517,260517,526245837.616666,4255741.316666667,201402,0,60,0.8532571770748165,61665200,9656468715,260711,260711,69870,330581,483519905.13332486,4252256.1333333375,201610,0,60,0.6738469543016699,8539591186,-194,-194,42725932.48334116,3485.1833333298564,-208,0,0,0.17941022277314667,-8477925986,2020.005748633164,1854.6202696983437,165.3854789348204,0.773085825493154,0.7733083759411763,-208
1629,2021-06-18,2021,262951,262951,527539608.93333286,4265368.08333333,204950,0,92,0.8618944213941003,62093565,9679081754,263032,263032,71981,335013,484876234.91666937,4261060.333333071,205157,0,92,0.6779139913973387,8565618403,-81,-81,42663374.01666349,4307.750000258908,-207,0,0,0.18398042999676167,-8503524838,2006.2278102510843,1843.4115807835906,162.8162294674937,0.7794227821913589,0.7799697375224307,-207
1630,2021-06-19,2021,265639,265639,528362216.84999996,4303939.666666666,204968,0,56,0.852216730224101,63560137,9697925965,265748,265748,73807,339555,485794055.53333384,4299854.916666853,205143,0,56,0.6678476240962427,8589583595,-109,-109,42568161.316666126,4084.749999812804,-175,0,0,0.1843691061278584,-8526023458,1989.0235125489855,1828.0252552543532,160.99825729463237,0.7716035672472792,0.7719456026009603,-175
1631,2021-06-20,2021,263993,263993,529186118.41666645,4262695.399999998,203771,0,58,0.8626857530313301,63794662,9717965386,264018,264018,75461,339479,486707280.9666725,4258045.150000014,203938,0,58,0.6723273015414646,8612277320,-25,-25,42478837.44999397,4650.249999983236,-167,0,0,0.19035845148986552,-8548482658,2004.5460236319389,1843.4624948551707,161.08352877676816,0.7718803150083525,0.7724397578952951,-167
1632,2021-06-21,2021,261879,261879,530341318.6166659,4256542.383333329,200212,0,67,0.8538599887734412,62561738,9742651170,261904,261904,78904,340808,487893050.06666094,4252302.250000212,200433,0,67,0.6578249336870108,8633467662,-25,-25,42448268.55000496,4240.13333311677,-221,0,0,0.19603505508643038,-8570905924,2025.1387801872845,1862.8697922393737,162.26898794791077,0.764521019249348,0.7652918626672368,-221
1633,2021-06-22,2021,263047,263047,531308897.05000085,4277230.249999997,201704,0,61,0.8613821864533706,62111796,9761081555,263191,263191,73341,336532,488946032.233336,4272700.016666784,201910,0,61,0.6746044952634671,8655829569,-144,-144,42362864.816664875,4530.233333213255,-206,0,0,0.1867776911899035,-8593717773,2019.8249630294238,1857.7612161256882,162.0637469037356,0.7667983288157629,0.7671614910844216,-206
1634,2021-06-23,2021,264105,264105,532397194.6500005,4254651.283333331,206312,0,69,0.8788019916321151,62546961,9781306471,264253,264251,72151,336404,490083304.6666704,4250622.450000072,206519,0,69,0.6912075956290523,8678138405,-148,-146,42313889.98333013,4028.8333332594484,-207,0,0,0.18759439600306282,-8615591444,2015.8542801158649,1854.6128668072038,161.2414133086611,0.781174154218966,0.78151998274381,-207
1635,2021-06-24,2021,260761,260761,532130481.9999999,4180320.299999996,207018,0,78,0.8844689198154626,61748773,9780660369,260817,260817,76888,337705,489917502.8666643,4176149.6333330637,207196,0,78,0.6844909018225938,8700442468,-56,-56,42212979.13333559,4170.666666932404,-178,0,0,0.19997801799286885,-8638693695,2040.6827784829782,1878.3955910338063,162.28718744917182,0.7938993944646631,0.7944114072318905,-178
1636,2021-06-25,2021,262163,262163,532558212.23333323,4206473.1,207924,0,87,0.8810434729538497,62033992,9788348423,262102,262102,76209,338311,490414251.48333246,4203095.583333035,208078,0,86,0.6840067275376709,8708502521,61,61,42143960.750000775,3377.516666964628,-154,0,1,0.19703674541617877,-8646468529,2031.401121566862,1871.081683784681,160.319437782181,0.7931096302681919,0.7938817712188385,-154
1637,2021-06-26,2021,260413,260413,532311451.7833333,4199321.783333337,206533,0,76,0.8929047320986289,62414730,9789800765,260363,260363,76938,337301,490318326.2500015,4195699.166666408,206662,0,76,0.690267743054417,8714361603,50,50,41993125.53333181,3622.616666928865,-129,0,0,0.2026369890442119,-8651946873,2044.104755842962,1883.2104648125944,160.89429103036764,0.7930978868182464,0.7937456551046039,-129
1638,2021-06-27,2021,258649,258649,532503785.90000033,4143965.433333336,204963,0,67,0.8969994084647525,62766300,9796594028,258604,258604,75948,334552,490636817.2333326,4140138.0666665593,205080,0,67,0.6951086826562151,8725555894,45,45,41866968.66666776,3827.366666776594,-117,0,0,0.2018907258085374,-8662789594,2058.789270014577,1897.2514625966055,161.53780741797164,0.7924368545789854,0.7930271766871355,-117
1639,2021-06-28,2021,255871,255871,533110728.6499999,4160785.2833333346,202717,0,83,0.8950877590660922,63036586,9814412980,255585,255585,78748,334333,491325739.8000031,4156962.4999996573,202793,0,72,0.684987721822248,8735812364,286,286,41784988.849996805,3822.783333677333,-76,0,11,0.21010003724384418,-8672775778,2083.513679354049,1922.3574928106232,161.15618654342597,0.7922625072790586,0.7934464072617721,-76
1640,2021-06-29,2021,252702,252702,533281163.9166665,4143951.6833333373,200346,0,88,0.8962018504008671,61185249,9812757996,252695,252695,71334,324029,491822140.13333553,4140222.5333328065,200454,0,88,0.6999342651429561,8746629221,7,7,41459023.78333098,3729.1500005307607,-108,0,0,0.196267585257911,-8685443972,2110.3163564857678,1946.3073671158334,164.0089893699344,0.7928152527482965,0.7932646075308177,-108
1641,2021-06-30,2021,252124,252124,533609939.7833331,4123329.999999997,200875,0,84,0.8986213133220166,61132271,9819713915,252085,252085,69723,321808,492183258.10000384,4119676.9666661755,200973,0,84,0.70459715109631,8755737141,39,39,41426681.683329284,3653.033333821688,-98,0,0,0.1940241622257065,-8694604870,2116.458329168715,1952.4496027133857,164.00872645532922,0.7967309736478876,0.7972429934347541,-98
1642,2021-07-01,2021,253427,253427,533915172.4833334,4144483.433333337,202522,0,82,0.8939339533672408,62840038,9830703855,253474,253474,70508,323982,492568767.5166802,4140989.1833327524,202685,0,82,0.7006376897481988,8768970000,-47,-47,41346404.96665323,3494.250000584405,-163,0,0,0.19329626361904195,-8706129962,2106.78093685098,1943.2713710939986,163.5095657569816,0.7991334782797413,0.7996283642503768,-163
1643,2021-07-02,2021,256839,256839,534286190.81666625,4168699.65,206135,0,114,0.8990534926549325,64031332,9837014817,256799,256799,68884,325683,493029416.1333306,4164910.283332874,206241,0,114,0.7099480169367048,8780450171,40,40,41256774.68333566,3789.3666671258397,-106,0,0,0.18910547571822767,-8716418839,2080.237778595409,1919.903956531492,160.33382206391707,0.8025844984601248,0.803122286301738,-106
1644,2021-07-03,2021,254933,254933,534469786.65000033,4158998.666666666,205431,0,175,0.8887433168714917,63160053,9848379513,254927,254927,73331,328258,493297094.4333442,4154863.2833335116,205555,0,169,0.6908133236661547,8788126163,6,6,41172692.21665615,4135.383333154488,-124,0,6,0.197929993205337,-8724966110,2096.5107955815856,1935.0523657099648,161.45842987162087,0.8058234908779954,0.8063288706178632,-124
1645,2021-07-04,2021,253566,253566,534948249.3666663,4100884.0500000003,204229,0,84,0.9046678182406159,60790954,9862442342,253467,253466,72749,326216,493855067.7333336,4097744.6666659866,204330,0,87,0.7030035314025199,8803315484,99,100,41093181.63333273,3139.3833340136334,-101,0,-3,0.201664286838096,-8742524530,2109.7002333383275,1948.4075486784561,161.29268465987138,0.8054273837975123,0.8061404443181953,-101
1646,2021-07-05,2021,252011,252011,535266020.6,4064550.9000000013,203050,0,105,0.8962624647336822,58659000,9869376232,252173,252172,75166,327339,494285386.0999971,4063097.9333330733,203238,0,105,0.6911428213564487,8818915377,-162,-161,40980634.50000292,1452.9666669280268,-188,0,0,0.20511964337723354,-8760256377,2123.978796957276,1960.1120905572272,163.86670640004854,0.8057187979889767,0.8059467111863681,-188
1647,2021-07-06,2021,250171,250171,535704185.0166668,4135140.233333332,201622,0,157,0.8990690367788436,62383722,9876606316,250325,250325,71529,321854,494867624.66667616,4132579.8166664364,201781,0,159,0.6992456206851608,8830829669,-154,-154,40836560.349990666,2560.416666895617,-159,0,-2,0.19982341609368282,-8768445947,2141.352055260869,1976.9005279803303,164.45152728053858,0.805936739270339,0.8060761010686108,-159
1648,2021-07-07,2021,259132,259132,536404780.44999975,4221201.083333329,207952,0,71,0.8985767871200779,62632552,9886682607,259174,259174,66153,325327,495630227.033336,4218575.766666588,208073,0,74,0.7163438632514472,8841228265,-42,-42,40774553.416663766,2625.316666740924,-121,0,-3,0.18223292386863077,-8778595713,2070.005944653689,1912.3454784559253,157.66046619776353,0.8024944815769569,0.8028313025226296,-121
1649,2021-07-08,2021,261720,261720,536131051.4166659,4237219.450000005,209014,0,89,0.8968821641448875,62383540,9889613850,261842,261842,69123,330965,495464874.76667005,4233809.416666526,209184,0,90,0.7103047150000741,8846103974,-122,-122,40666176.64999586,3410.0333334784955,-170,0,-1,0.18657744914481345,-8783720434,2048.4909499337687,1892.228423120317,156.2625268134516,0.7986168424270212,0.7988939895051214,-170
1650,2021-07-09,2021,265744,265744,536421666.16666716,4238465.26666666,211573,0,74,0.8912976398338256,63514809,9900705165,265843,265843,73256,339099,495724024.51666105,4234236.19999986,211776,0,74,0.6998103798595864,8856300213,-99,-99,40697641.650006115,4229.066666800529,-203,0,0,0.1914872599742392,-8792785404,2018.565484702071,1864.7247605416019,153.8407241604691,0.7961534409055332,0.7966205617601366,-203
1651,2021-07-10,2021,260729,260729,535900922.3166666,4213195.766666658,207575,0,142,0.8780956472045679,60195291,9897797925,260852,260852,77558,338410,495288895.65000135,4209190.1333329175,207700,0,143,0.6773588250938258,8860443454,-123,-123,40612026.666665256,4005.633333740756,-125,0,-1,0.20073682211074206,-8800248163,2055.3943838877403,1898.7352815006261,156.65910238711422,0.7961331497455212,0.7962369466210725,-125
1652,2021-07-11,2021,261669,261669,536341869.53333324,4225158.100000001,209203,0,146,0.8849768218627345,62332264,9908294185,261731,261731,74879,336610,495826736.98332673,4221396.466666242,209311,0,149,0.6887169127476824,8871359750,-62,-62,40515132.55000651,3761.633333758451,-108,0,-3,0.1962599091150521,-8809027486,2049.6958735399808,1894.413489358642,155.28238418133878,0.7994947815751962,0.7997180311082753,-108
1653,2021-07-12,2021,266305,266305,537549451.6666666,4249710.71666667,210658,0,93,0.8903362685642404,64322659,9935329437,266432,266432,77462,343894,497054850.99999714,4245520.933333181,210843,0,93,0.691416541143475,8892731004,-127,-127,40494600.66666949,4189.78333348874,-185,0,0,0.19891972742076547,-8828408345,2018.548099610096,1865.597416976929,152.95068263316693,0.791040348472616,0.79135764472736,-185
1654,2021-07-13,2021,266113,266113,536590607.4999999,4222895.266666669,208809,0,77,0.8800547135991091,63858843,9931700131,266336,266336,76051,342387,495896770.48333895,4218276.5833330825,209046,0,77,0.6843338094027969,8895791778,-223,-223,40693837.01666093,4618.683333586901,-237,0,0,0.19572090419631227,-8831932935,2016.4013313892965,1861.9216721860319,154.47965920326465,0.7846629063593286,0.7848957707557371,-237
1655,2021-07-14,2021,262331,262331,535025962.5666664,4232694.283333334,207459,0,72,0.8882289931422521,64432491,9913683655,262377,262377,76718,339095,494704801.5999925,4228835.383333226,207592,0,72,0.6883439744024551,8893538308,-46,-46,40321160.96667391,3858.900000108406,-133,0,0,0.19988501873979703,-8829105817,2039.5071972685898,1885.4731992514303,154.03399801715955,0.7908291433341846,0.7911973991622742,-133
1656,2021-07-15,2021,265829,265829,535732377.08333385,4268580.099999993,209354,0,141,0.8859040962423211,64991639,9931002319,265853,265853,73951,339804,495431494.03333265,4264342.46666685,209568,0,141,0.6942266718461384,8901935476,-24,-24,40300883.050001204,4237.633333142847,-214,0,0,0.19167742439618274,-8836943837,2015.3270601903248,1863.554272599266,151.7727875910589,0.7875513958221263,0.788285255385495,-214
1657,2021-07-16,2021,268556,268556,536377943.59999985,4255210.466666664,211584,0,122,0.886001429869376,65021434,9949482199,268539,268539,76261,344800,496157815.2666672,4250336.150000198,211808,0,122,0.6913950116009351,8921073508,17,17,40220128.33333266,4874.316666466184,-224,0,0,0.19460641826844094,-8856052074,1997.2666542546056,1847.619210865711,149.64744338889454,0.7878580258865935,0.7887420449171256,-224
1658,2021-07-17,2021,264608,264608,535668457.8666659,4238036.85,210101,0,134,0.8858273370419641,65213560,9955687249,264612,264612,80344,344956,495511721.46666443,4233797.933333445,210331,0,135,0.6810288848432776,8938907043,-4,-4,40156736.400001466,4238.916666554287,-230,0,-1,0.20479845219868653,-8873693483,2024.3849689603712,1872.5973178339018,151.78765112646943,0.7940084955859233,0.7948656901425484,-230
1659,2021-07-18,2021,263394,263394,536116874.8833336,4227352.416666668,210027,0,131,0.895718960948237,65069547,9970769298,263394,263394,77771,341165,496004783.56667334,4222968.633333298,210148,0,131,0.6925651810707529,8949360134,0,0,40112091.316660285,4383.783333369531,-121,0,0,0.20315377987748406,-8884290587,2035.4179475741043,1883.1286345424471,152.28931303165723,0.7973871842183193,0.7978465720555518,-121
1660,2021-07-19,2021,266416,266416,536555462.0166663,4234439.400000006,211174,0,149,0.8910200588553243,64569135,9987910105,266454,266454,78798,345252,496522426.000003,4230636.199999858,211369,0,150,0.689322581766373,8967456292,-38,-38,40033036.01666331,3803.2000001482666,-195,0,-1,0.20169747708895136,-8902887157,2013.9761201154072,1863.445195043058,150.5309250723492,0.7926475887334095,0.7932663799380005,-195
1661,2021-07-20,2021,259693,259693,535953491.6833331,4213612.733333331,206379,0,137,0.8864428382744239,65295840,10002833240,259770,259770,78933,338703,495956595.78334147,4209946.766666372,206503,0,139,0.6807645636442462,8985252466,-77,-77,39996895.89999163,3665.966666958295,-124,0,-2,0.20567827463017774,-8919956626,2063.7964507450456,1909.214288729805,154.58216201524056,0.7947037463466478,0.7949455287369597,-124
1662,2021-07-21,2021,264219,264219,536754206.38333255,4251492.383333331,210677,0,133,0.8914385415129121,66237302,10026995793,264178,264178,73787,337965,496763874.4833444,4247582.21666634,210753,0,134,0.6976965070347548,9004909298,41,41,39990331.899988174,3910.1666669910774,-76,0,-1,0.1937420344781573,-8938671996,2031.474672083887,1880.4134881910848,151.06118389280232,0.7973574951082246,0.7977689285254639,-76
1663,2021-07-22,2021,266642,266642,537316759.1833336,4260945.533333331,213306,0,110,0.8883559229228702,65844373,10046042220,266680,266680,73921,340601,497364961.050014,4257096.199999678,213461,0,110,0.6966832158449335,9027458517,-38,-38,39951798.13331962,3849.333333653398,-155,0,0,0.1916727070779367,-8961614144,2015.1242459302496,1865.0253526699191,150.09889326033044,0.7999714973635061,0.8004387280635968,-155
1664,2021-07-23,2021,260409,260409,537491064.1499999,4192157.0500000003,209181,0,86,0.8944199317227896,64601073,10057054879,260379,260379,78102,338481,497607413.40000755,4188622.36666632,209311,0,86,0.6888363010035873,9043633406,30,30,39883650.74999231,3534.6833336804993,-130,0,0,0.20558363071920227,-8979032333,2064.026451274725,1911.0888873526956,152.9375639220293,0.8032786885245902,0.8038705118308312,-130
1665,2021-07-24,2021,256311,256311,537278617.7500002,4204851.033333328,206818,0,76,0.9035702720523111,65328763,10067019632,256226,256226,77008,333234,497468273.0666698,4200640.2166663185,206898,0,82,0.69550526056764,9058739210,85,85,39810344.68333042,4210.816667009145,-80,0,-6,0.20806501148467116,-8993410447,2096.198047489184,1941.5214422684264,154.67660522075744,0.8069025519778706,0.8074824568935237,-80
1666,2021-07-25,2021,250349,250349,537574649.6166668,4135205.7999999984,202715,0,62,0.9056956488741709,64532571,10078647057,250342,250342,71663,322005,497849768.1499992,4131264.633332789,202810,0,61,0.7049455753792678,9068306505,7,7,39724881.46666759,3941.1666672094725,-95,0,1,0.20075007349490304,-9003773934,2147.3009663176877,1988.678560329466,158.62240598822154,0.8097296174540342,0.810131739779981,-95
1667,2021-07-26,2021,251313,251313,538097275.0999994,4145091.599999999,201784,0,95,0.9008606797101616,63751924,10097387049,251293,251293,70549,321842,498440145.7333533,4140696.133332899,201891,0,94,0.7048924627612432,9088314293,20,20,39657129.36664611,4395.4666671003215,-107,0,1,0.19596821694891842,-9024562369,2141.14381309363,1983.5019110494654,157.64190204416445,0.8029190690493528,0.8034087698423752,-107
1668,2021-07-27,2021,251726,251726,538680552.6000004,4126866.0500000007,200404,0,144,0.8991681431397633,63808912,10112539804,254338,254337,67980,322318,499082553.2500253,4122725.049999586,201301,0,144,0.7065382634540934,9104465030,-2612,-2611,39597999.34997511,4141.000000414904,-897,0,0,0.1926298796856699,-9040656118,2139.948009343494,1962.2884332599083,177.65957608358576,0.7961195903482358,0.7914704055233587,-897
1669,2021-07-28,2021,259664,259664,539442548.9500002,4210727.133333336,205732,0,251,0.8857061433236807,64208721,10127342990,259656,259656,71331,330987,499818714.43334854,4206519.683332937,205832,0,253,0.6962962291570338,9121237757,8,8,39623834.51665163,4207.450000398792,-100,0,-2,0.18940991416664688,-9057029036,2077.463756816502,1924.9264967239292,152.53726009257298,0.7923008195206113,0.7927103552392396,-100
1670,2021-07-29,2021,263447,263447,540349200.8833342,4286980.216666669,209172,0,181,0.8843752253774009,64640765,10146001206,263397,263397,70962,334359,500820948.21667993,4282505.166666405,209256,0,183,0.6973791643114208,9137901251,50,50,39528252.66665423,4475.050000263378,-84,0,-2,0.1869960610659801,-9073260486,2051.0736538405604,1901.3919984535887,149.68165538697167,0.7939813321085456,0.7944509618560576,-84
1671,2021-07-30,2021,266562,266562,540958579.9666673,4278215.85,211366,0,272,0.894864984506419,64723904,10156377828,266472,266472,73205,339677,501477275.46667445,4274310.716666516,211388,0,273,0.7020316359364906,9153057798,90,90,39481304.49999285,3905.133333483711,-22,0,-1,0.1928333485699284,-9088333894,2029.3912109252906,1881.913579913366,147.4776310119246,0.7929337264876464,0.7932840973910955,-22
1672,2021-07-31,2021,267762,267762,541279050.5666666,4306058.833333334,213262,0,293,0.8992314069957645,65230432,10170516964,267713,267712,77797,345510,501898539.6833353,4302120.733333598,213360,0,296,0.6974790888830948,9169908513,49,50,39380510.8833313,3938.099999736063,-98,0,-3,0.2017523181126697,-9104678081,2021.4931564847386,1874.770423751402,146.72273273333667,0.7964610362934248,0.7969728776712375,-98
1673,2021-08-01,2021,269183,269183,541723632.7666667,4285335.883333329,214546,0,256,0.899767072957801,62881445,10181672438,269029,269029,77668,346697,502395514.783328,4281805.816666855,214579,0,257,0.6984946509488077,9184630514,154,154,39328117.983338654,3530.066666474566,-33,0,-1,0.2012724220089933,-9121749069,2012.4734205602383,1867.4399963696405,145.03342419059777,0.7970265581407444,0.7976054626081203,-33
1674,2021-08-02,2021,263773,263773,541610681.0333332,4210830.116666669,209531,0,335,0.8953569925655775,61600344,10193336658,263708,263708,84998,348706,502330850.5166645,4206838.566666485,209585,0,338,0.6779866133648457,9200585143,65,65,39279830.51666868,3991.5500001842156,-54,0,-3,0.21737037920073188,-9138984799,2053.3211550588317,1904.8752806765988,148.4458743822329,0.7943610604572872,0.7947616302880459,-54
1675,2021-08-03,2021,268190,268190,542280395.0833336,4298761.199999992,215201,0,365,0.9108206868265035,64956140,10206480249,268093,268093,75199,343292,503097222.3666691,4294767.900000201,215263,0,369,0.7121634060799451,9215236503,97,97,39183172.71666449,3993.2999997911975,-62,0,-4,0.19865728074655842,-9150280363,2022.0008019811835,1876.57724135531,145.4235606258735,0.802419926171744,0.8029415165632822,-62
1676,2021-08-04,2021,269059,269059,543006717.3166672,4306332.066666665,215614,0,348,0.9060949457182241,65563871,10222728686,269008,269006,75710,344718,503879032.35000235,4302625.833333387,215695,0,352,0.7079641910199101,9230162312,51,53,39127684.96666485,3706.233333277516,-81,0,-4,0.19813075469831398,-9164598441,2018.1696851496035,1873.1144745842187,145.05521056538487,0.8013632697661108,0.8018163028608815,-81
1677,2021-08-05,2021,262649,262649,543334397.3833327,4243112.183333332,210346,0,331,0.9048920803048929,63771599,10227695289,262587,262587,79129,341716,504275308.5166717,4239271.533333048,210411,0,334,0.696332627093829,9245933180,62,62,39059088.86666101,3840.6500002834946,-65,0,-3,0.20855945321106384,-9182161581,2068.671106241915,1920.4123148391645,148.25879140275038,0.8008635098553583,0.8013001405248547,-65
1678,2021-08-06,2021,266024,266024,543477841.5333328,4236194.85,211846,0,321,0.9065535440411386,63422545,10238423111,265935,265934,76498,342433,504515024.4333358,4231527.316666306,211929,0,322,0.704762683503043,9259240610,89,90,38962817.09999704,4667.533333693631,-83,0,-1,0.20179086053809558,-9195818065,2042.9654524905002,1897.143744061819,145.82170842868118,0.7963416834571316,0.7969203000733261,-83
1679,2021-08-07,2021,267866,267866,543491995.5333335,4254506.0166666685,211336,0,267,0.8887764777911342,64158774,10245995242,267814,267814,79853,347667,504628523.24998885,4250999.850000036,211441,0,270,0.6858689493106918,9271283609,52,52,38863472.283344686,3506.166666632518,-105,0,-3,0.20290752848044247,-9207124835,2028.969692059961,1884.2499766628662,144.7197153970949,0.7889616450016053,0.7895068965774754,-105
1680,2021-08-08,2021,266758,266758,541648682.4166665,4262469.133333334,210711,0,256,0.9019523313265203,63905594,10129580104,266683,266683,79869,346552,503363869.5666661,4258343.966666862,210806,0,258,0.6948105911955551,9178658416,75,75,38284812.85000038,4125.166666471399,-95,0,-2,0.2071417401309652,-9114752822,2030.48711722485,1887.498901567277,142.98821565757294,0.7898957107190787,0.7904740834623879,-95
1681,2021-08-09,2021,268964,268964,542491391.3999996,4298751.533333327,213250,0,271,0.8955250516797785,64695348,10154059511,268960,268960,80869,349829,504236909.4499995,4294863.566666835,213380,0,274,0.6898827712968361,9195321532,4,4,38254481.95000011,3887.966666491702,-130,0,-3,0.2056422803829424,-9130626184,2016.9665509138756,1874.7654277587728,142.20112315510278,0.7928570366294374,0.7933521713265913,-130
1682,2021-08-10,2021,271037,271037,543572131.1333333,4328888.98333333,216297,0,357,0.8989879610532888,65046501,10175332089,271127,271127,77230,348357,505380844.0166709,4324542.1166668935,216446,0,362,0.7006547880478842,9219923068,-90,-90,38191287.11666244,4346.866666436195,-149,0,-5,0.19833317300540465,-9154876567,2005.5274044995087,1864.0004279052653,141.52697659424348,0.7980349546371898,0.7983196066787889,-149
1683,2021-08-11,2021,271950,271950,544397364.5333332,4298905.466666666,215738,0,264,0.891362382790954,64615472,10195091199,272078,272078,77795,349873,506308211.83333176,4294857.466666908,216010,0,266,0.6949636010781027,9240261656,-128,-128,38089152.70000142,4047.999999757856,-272,0,-2,0.1963987817128513,-9175646184,2001.8288822700247,1860.8936107782758,140.93527149174884,0.7933002390145247,0.79392674159616,-272
1684,2021-08-12,2021,270501,270501,544968864.483333,4289568.083333338,215796,0,251,0.8935752548049736,64110012,10212015162,270596,270596,79990,350586,506919054.16666514,4286579.800000208,215921,0,256,0.6907206790915873,9262390692,-95,-95,38049810.316667855,2988.2833331292495,-125,0,-5,0.20285457571338628,-9198280680,2014.6648791809753,1873.3427477370883,141.32213144388697,0.7977641487462154,0.797946015462165,-125
1685,2021-08-13,2021,267658,267658,545179841.2,4261889.9333333345,213914,0,321,0.9048935581974005,64909161,10222370562,267770,267770,79997,347767,507155220.0166663,4258382.050000017,214122,0,324,0.6976682663967487,9282485893,-112,-112,38024621.183333755,3507.8833333179355,-208,0,-3,0.20722529180065175,-9217576732,2036.8524056818778,1893.9956679862057,142.8567376956721,0.799206450022043,0.7996489524592001,-208
1686,2021-08-14,2021,263513,263513,545027359.3166666,4247350.550000001,210504,0,232,0.9032191960168944,64498238,10227750334,267906,267906,80939,348845,507076871.13332826,4247477.866666549,212618,0,233,0.6894122031274584,9288841918,-4393,-4393,37950488.183338344,-127.31666654814035,-2114,0,-1,0.21380699288943594,-9224343680,2068.3129838629084,1892.7417494693223,175.5712343935861,0.7988372490161776,0.7936291087172367,-2114
1687,2021-08-15,2021,266152,266152,545509199.8166667,4256710.966666664,213482,0,233,0.9091985031110045,64437080,10242403210,266145,266145,81546,347691,507486480.83333755,4253067.95000012,213658,0,236,0.6971304980571882,9300308339,7,7,38022718.98332918,3643.01666654367,-176,0,-3,0.2120680050538163,-9235871259,2049.6152567580434,1906.8044894074192,142.81076735062425,0.8021055637380143,0.8027879539348851,-176
1688,2021-08-16,2021,276343,276343,546227091.3666668,4382829.4499999955,218501,0,304,0.9015462667771572,64238839,10260964313,276362,276362,78875,355237,508191040.81666356,4379153.550000686,218717,0,306,0.702820933630226,9316668698,-19,-19,38036050.55000323,3675.899999309331,-216,0,-2,0.1987253331469312,-9252429859,1976.6272037528245,1838.8600488369007,137.7671549159238,0.7906876599009203,0.7914148833775989,-216
1689,2021-08-17,2021,269905,269905,546005322.0333331,4332889.949999997,212193,0,296,0.8961486448935743,62965406,10265399425,269889,269889,81072,350961,508107777.14999723,4328839.116667015,212342,0,297,0.6901735520471061,9330337745,16,16,37897544.88333583,4050.8333329828456,-149,0,-1,0.2059750928464682,-9267372339,2022.9537134670832,1882.6546363504895,140.2990771165937,0.78617661769882,0.7867753039212417,-149
1690,2021-08-18,2021,271289,271289,546145280.4999992,4340551.466666669,214370,0,263,0.9019680119724722,63232769,10274102604,271278,271278,78046,349324,508344507.3666614,4335266.316667005,214501,0,267,0.701878485303058,9342013469,11,11,37800773.133337736,5285.149999663234,-131,0,-4,0.20008952666941426,-9278780700,2013.1493739148996,1873.8876995799933,139.26167433490627,0.7901905348171139,0.7907054755638128,-131
1691,2021-08-19,2021,276332,276332,546849545.5833335,4361805.433333335,215672,0,243,0.8932009322119764,63433793,10286585274,276337,276337,77639,353976,509153142.88333297,4356882.950000429,215859,0,246,0.6985558342938379,9353663286,-5,-5,37696402.700000525,4922.48333290685,-187,0,-3,0.19464509791813844,-9290229493,1978.9584470250768,1842.5080350562284,136.45041196884836,0.7804814498501802,0.7811440378957577,-187
1692,2021-08-20,2021,280592,280592,547432719.8333334,4363424.16666667,220629,0,141,0.8976699264412393,64900236,10301546151,280624,280624,80584,361208,509833248.96666664,4358709.950000466,220800,0,143,0.6980216385019028,9369476492,-32,-32,37599470.866666734,4714.2166662039235,-171,0,-2,0.19964828793933653,-9304576256,1950.991902240026,1816.7841986667806,134.20770357324545,0.7862982551177511,0.7868179485717544,-171
1693,2021-08-21,2021,278737,278737,547552528.1000005,4373364.599999995,220582,0,87,0.9029658782292989,64478260,10312683415,278778,278778,87450,366228,510013540.28333503,4368987.883333858,220765,0,87,0.6886830062147056,9384055317,-41,-41,37538987.81666547,4376.716666136868,-183,0,0,0.21428287201459328,-9319577057,1964.4056156879083,1829.4612210552305,134.9443946326778,0.7913624671285118,0.791902517415291,-183
1694,2021-08-22,2021,279004,279004,547938558.1166663,4368058.3500000015,220180,0,80,0.8967004057289485,64959189,10328161826,278881,278881,86023,364904,510462498.4333288,4364039.8000005465,220324,0,80,0.6867066406507014,9399119141,123,123,37476059.68333751,4018.54999945499,-144,0,0,0.20999376507824707,-9334159952,1963.909327882992,1830.3953960052095,133.51393187778262,0.7891643130564436,0.7900287219279908,-144
1695,2021-08-23,2021,273969,273969,548558394.7666665,4359184.58333333,214453,0,81,0.8922651832871606,64130716,10350299279,273929,273929,87751,361680,511131514.0000104,4354313.300000546,214578,0,81,0.6770957752709503,9415983552,40,40,37426880.76665616,4871.28333278466,-125,0,0,0.21516940801621032,-9351852836,2002.2644706761223,1865.9269883802385,136.33748229588377,0.782763743343225,0.7833343676646138,-125
1696,2021-08-24,2021,278206,278206,548742657.7333332,4352802.7,216740,0,45,0.883597046792665,64303228,10358470823,280871,280870,83288,364159,511380545.99999756,4349282.916667151,218218,0,45,0.6799145428233235,9437594237,-2665,-2664,37362111.733335674,3519.7833328489214,-1478,0,0,0.2036825039693415,-9373291009,1972.4328653347995,1820.7019119165363,151.7309534182632,0.7790629964846193,0.776933182849066,-1478
1697,2021-08-25,2021,281635,281635,549696430.7333337,4412954.883333336,218813,0,78,0.8822802563601831,64348115,10376065958,281627,281627,86152,367779,512289854.26666033,4409745.783333981,218944,0,78,0.6767406513150502,9442244861,8,8,37406576.466673374,3209.099999354221,-131,0,0,0.2055396050451329,-9377896746,1951.8043948136194,1819.036719727371,132.76767508624835,0.7769382356596304,0.7774254599168403,-131
1698,2021-08-26,2021,282000,282000,550475737.4166669,4401255.666666667,218492,0,48,0.884446808510638,64829311,10391439843,287672,287672,83612,371284,513159712.1166724,4403631.2333339555,220693,0,48,0.6789842815742207,9456833212,-5672,-5672,37316025.29999447,-2375.566667288542,-2201,0,0,0.2054625269364172,-9392003901,1952.0416220449179,1783.8361471282308,168.20547491668708,0.7747943262411348,0.7671688589782808,-2201
1699,2021-08-27,2021,278354,278354,550784559.3166668,4338682.749999998,218014,0,78,0.8917026520186536,64370441,10404536801,278334,278334,92706,371040,513175678.84998894,4334839.516666974,218153,0,78,0.6699681974989203,9465765251,20,20,37608880.466677904,3843.2333330241963,-139,0,0,0.22173445451973328,-9401394810,1978.7197572755083,1843.7405378070553,134.97921946845304,0.7832256766563441,0.7837813562123205,-139
1700,2021-08-28,2021,269308,269308,550205374.883334,4279911.76666667,212690,0,62,0.8942326258410428,63339879,10408922104,269285,269285,89035,358320,512646149.64999956,4276507.600000011,212756,0,62,0.6727394507702568,9476414398,23,23,37559225.23333448,3404.1666666595265,-66,0,0,0.22149317507078603,-9413074519,2043.0339049836398,1903.7308043522646,139.30310063137517,0.7897648788747457,0.7900774272610803,-66
1701,2021-08-29,2021,266941,266941,550355647.2333337,4239578.583333332,211374,0,65,0.8969210424775513,62889257,10419027377,266906,266906,83443,350349,512916924.1833274,4235790.266666736,211438,0,65,0.6842691145115449,9487148465,35,35,37438723.05000633,3788.316666595638,-64,0,0,0.2126519279660064,-9424259208,2061.712690194963,1921.7137276169415,139.99896257802175,0.7918378967637043,0.7921815170884131,-64
1702,2021-08-30,2021,270825,270825,550452449.5666671,4291600.599999993,211838,0,66,0.8843016708206413,63750790,10430618657,270837,270837,81076,351913,513060777.1333386,4288149.7666667905,211906,0,67,0.6813587449170676,9502183062,-12,-12,37391672.43332851,3450.8333332026377,-68,0,-1,0.20294292590357366,-9438432272,2032.5023523185343,1894.352607410873,138.14974490766144,0.7821951444659836,0.7824115611973254,-68
1703,2021-08-31,2021,274592,274592,550629821.916667,4243247.48333333,214152,0,75,0.8836164199976689,61377990,10436576811,274567,274567,80551,355118,513368958.4500016,4237681.96666689,214368,0,75,0.6849047358906081,9512655077,25,25,37260863.46666539,5565.516666439362,-216,0,0,0.19871168410706086,-9451277087,2005.2653461013686,1869.740203484037,135.52514261733154,0.7798916210231908,0.7807493253012926,-216
1704,2021-09-01,2021,284465,284465,549574960.3166667,4395959.966666661,221441,0,80,0.8888263934051644,63355398,10426278711,284527,284527,83281,367808,512666717.88332725,4391484.183333803,221627,0,83,0.6885331477292538,9513525223,-62,-62,36908242.43333948,4475.783332858235,-186,0,-3,0.20029324567591067,-9450169825,1931.9598555768432,1801.820979672675,130.13887590416812,0.7784472606471798,0.7789313492216907,-186
1705,2021-09-02,2021,279365,279365,549607361.75,4270615.216666671,217860,0,77,0.8760331466003249,55513816,10427435539,279499,279499,87096,366595,512735437.26666075,4266616.7333337525,218121,0,77,0.6692617193360579,9510552830,-134,-134,36871924.48333925,3998.483332918957,-261,0,0,0.206771427264267,-9455039014,1967.3450924417875,1834.4803998105924,132.8646926311951,0.7798399942727257,0.7803999298745254,-261
1706,2021-09-03,2021,287462,287462,549638407.2166666,4440700.749999999,223580,0,61,0.8824331563824095,63569922,10433750183,291831,291831,85942,377773,512795287.8999896,4438950.166667634,225268,0,61,0.6763506126695213,9519172504,-4369,-4369,36843119.316676974,1750.5833323653787,-1688,0,0,0.20608254371288814,-9455602582,1912.038485840447,1757.165235701449,154.87325013899795,0.7777723664345201,0.7719125110080834,-1688
1707,2021-09-04,2021,288702,288702,549100263.95,4437642.650000007,223636,0,63,0.8799419470595973,63764054,10428231223,288784,288784,93374,382158,512289511.4833242,4432837.950000953,223863,0,63,0.6660334207317465,9525418297,-82,-82,36810752.46667582,4804.6999990539625,-227,0,0,0.21390852632785073,-9461654243,1901.9621060817037,1773.9539291765618,128.0081769051419,0.7746257386509272,0.7751918388830407,-227
1708,2021-09-05,2021,285200,285200,549466665.6000001,4427215.599999997,223225,0,44,0.889793127629733,64484977,10440550593,285260,285260,92107,377367,512733604.19999826,4422979.783334073,223431,0,45,0.6736333595677374,9529823181,-60,-60,36733061.40000188,4235.816665924154,-206,0,-1,0.21615976806199555,-9465338204,1926.6012117812068,1797.4255212788273,129.17569050237944,0.7826963534361852,0.783253873659118,-206
1709,2021-09-06,2021,281923,281923,549586050.7333325,4357145.266666667,218448,0,46,0.8800629959244203,63261828,10450460026,281934,281934,94929,376863,512871289.2833317,4352963.7166670915,218623,0,47,0.6595685965457105,9540849964,-11,-11,36714761.45000082,4181.549999575131,-175,0,-1,0.22049439937870974,-9477588136,1949.4189928928556,1819.1182662727151,130.3007266201405,0.7748498703546713,0.7754403512878901,-175
1710,2021-09-07,2021,284855,284855,549843522.3000004,4332411.283333332,219858,0,46,0.8766144178617195,62607775,10458230449,284709,284709,92510,377219,513161328.3999977,4327148.316667068,219971,0,46,0.6629199483589051,9551749584,146,146,36682193.90000272,5262.9666662644595,-113,0,0,0.21369446950281434,-9489141809,1930.2575777149793,1802.406416376011,127.85116133896827,0.7718242614663601,0.7726169527482447,-113
1711,2021-09-08,2021,287749,287749,549280852.7333336,4445688.083333332,220268,0,61,0.8726702786108722,63834811,10443487163,287799,287799,89351,377150,512709401.0166674,4440958.816667647,220397,0,61,0.6664801802995967,9539826272,-50,-50,36571451.71666616,4729.266665684991,-129,0,0,0.20619009831127555,-9475991461,1908.8888327442792,1781.4843033390227,127.40452940525643,0.7654865872687655,0.7658018269695169,-129
1712,2021-09-09,2021,291336,291336,549681820.3833333,4488060.583333337,224135,0,56,0.877461075871159,64743039,10448542294,291363,291363,88820,380183,513349286.90000117,4483139.416667851,224290,0,57,0.6731337277048056,9547489728,-27,-27,36332533.48333216,4921.16666548606,-155,0,-1,0.20432734816635334,-9482746689,1886.762433696259,1761.8890761695932,124.87335752666581,0.7693350632946152,0.7697957530640472,-155
1713,2021-09-10,2021,285261,285261,549967190.2666667,4404442.299999996,221767,0,49,0.8862129768878326,63419374,10456604123,285260,285260,93794,379054,513616813.4500006,4400349.150000571,221881,0,51,0.66761200251151,9557436949,1,1,36350376.81666607,4093.149999424815,-114,0,-2,0.21860097437632264,-9494017575,1927.943848849533,1800.5216765407017,127.42217230883125,0.7774178734562384,0.777820234172334,-114
1714,2021-09-11,2021,289068,289068,550020952.2833333,4457319.166666663,225894,0,46,0.8891679466423122,63846613,10465882312,291498,291498,92222,383720,513759907.3666707,4453091.4500011,226882,0,46,0.6729490253309672,9568800323,-2430,-2430,36261044.916662574,4227.716665563174,-988,0,0,0.216218921311345,-9504953710,1902.738982811426,1762.4817575649602,140.25722524646585,0.7814562663456349,0.7783312406946188,-988
1715,2021-09-12,2021,286552,286552,550252264.4666668,4458953.183333334,225220,0,47,0.8908260978810132,64094495,10483630896,286492,286492,94594,381086,513970074.35000336,4453827.983334446,225338,0,49,0.6704917000361984,9579494168,60,60,36282190.116663456,5125.199998887256,-118,0,-2,0.2203343978448148,-9515399673,1920.2527445862072,1794.011959670788,126.24078491541923,0.7859655490103018,0.7865420325872974,-118
1716,2021-09-13,2021,283189,283189,550777060.6000004,4453008.949999993,219719,0,40,0.8845152883763143,64011348,10501967698,283153,283153,95928,379081,514544007.05000293,4448528.80000094,219856,0,40,0.6618532714644045,9597818711,36,36,36233053.54999745,4480.149999052286,-137,0,0,0.2226620169119098,-9533807363,1944.9097973438247,1817.1942626424686,127.71553470135609,0.7758740629049857,0.7764565446949175,-137
1717,2021-09-14,2021,278686,278686,550940943.783334,4479955.53333334,216003,0,43,0.8894382925586504,63672592,10508058324,278759,278759,85797,364556,514813394.01666003,4475422.916667771,216120,0,44,0.6808364147072108,9613644776,-73,-73,36127549.76667398,4532.616665569134,-117,0,-1,0.20860187785143958,-9549972184,1976.9236480603045,1846.8045660109988,130.1190820493057,0.7750766095175216,0.7752933537571881,-117
1718,2021-09-15,2021,287754,287754,551921721.7999997,4543676.199999999,222598,0,45,0.8809086928418022,63892873,10519473210,287783,287783,81690,369473,515850448.58332825,4539296.1833346,222725,0,45,0.6869784801595726,9631208453,-29,-29,36071273.21667147,4380.016665399075,-127,0,0,0.19393021268222954,-9567315580,1918.0331873753266,1792.4979883569504,125.53519901837626,0.7735704803408467,0.7739338320887613,-127
1719,2021-09-16,2021,291708,291708,552496846.5833328,4553701.383333336,225639,0,37,0.8800958492739309,63809987,10532387892,291774,291774,84472,376246,516479064.88333285,4549521.933334678,225847,0,39,0.6832790248932853,9640198221,-66,-66,36017781.69999993,4179.449998657219,-208,0,-2,0.19681682438064563,-9576388234,1894.0064947938788,1770.1339560184692,123.87253877540957,0.773509811181044,0.7740477218669244,-208
1720,2021-09-17,2021,287198,287198,552473566.4333334,4398385.1166666625,223163,0,135,0.8829274577121003,63219681,10541236553,287223,287223,91720,378943,516583248.90000063,4393797.016667485,223450,0,136,0.6704596733545563,9652637346,-25,-25,35890317.533332765,4588.09999917727,-287,0,-1,0.2124677843575441,-9589417665,1923.6678752405428,1798.5441587198818,125.12371652066099,0.7770353553994108,0.7779669455440547,-287
1721,2021-09-18,2021,284368,284368,552084850.9499999,4430286.283333337,223288,0,195,0.8914821639565635,63976596,10545334392,284360,284360,92366,376726,516253634.3166674,4425654.566667432,223456,0,197,0.6737363494954008,9665065727,8,8,35831216.63333255,4631.716665904969,-168,0,-2,0.2177458144611627,-9601089131,1941.4450674829795,1815.4931576757187,125.95190980726079,0.7852078996230237,0.7858207905471937,-168
1722,2021-09-19,2021,280709,280709,552365506.9499997,4313776.083333332,220871,0,185,0.8943496645992822,63139057,10548594529,280552,280552,88914,369466,516597715.61666197,4309447.483333707,221048,0,185,0.6805605928556403,9673663037,157,157,35767791.333337724,4328.599999625236,-177,0,0,0.21378907174364192,-9610523980,1967.7513259282734,1841.3617283664416,126.3895975618318,0.7868326273828057,0.7879038467022156,-177
1723,2021-09-20,2021,267122,267122,551897791.8666667,4233423.666666661,211835,0,203,0.9065707803924788,62318299,10558487920,267065,267065,95351,362416,516184275.7333347,4229602.349999946,211878,0,205,0.6690212352655464,9682441629,57,57,35713516.133331954,3821.3166667157784,-43,0,-2,0.2375495451269325,-9620123330,2066.08887274978,1932.803908162188,133.28496458759196,0.7930271561309065,0.7933574223503641,-43
1724,2021-09-21,2021,270506,270506,551509823.5999991,4251677.299999995,212055,0,93,0.8961132100581872,62134852,10561628330,270417,270417,87204,357621,515913690.7833362,4247114.116666488,212179,0,94,0.6786094776313497,9691106724,89,89,35596132.81666285,4563.183333506808,-124,0,-1,0.21750373242683751,-9628971872,2038.8080988961394,1907.844886909241,130.9632119868984,0.7839197651808093,0.7846363209413609,-124
1725,2021-09-22,2021,287472,287472,552494642.3500003,4435232.833333332,222430,0,205,0.892257332888073,63324823,10572368824,287544,287544,79230,366774,516946495.8499968,4430584.000000779,222649,0,205,0.7009875291050938,9696322635,-72,-72,35548146.50000346,4648.833332553506,-219,0,0,0.1912698037829792,-9632997812,1921.90767222547,1797.7996266658208,124.1080455596491,0.7737449212445038,0.7743128008235262,-219
1726,2021-09-23,2021,282379,282379,552742300.5333339,4399207.33333333,217767,0,273,0.878879095116847,62627517,10578634261,282433,282433,87403,369836,517277247.6833364,4394748.166667439,217984,0,276,0.672484560724216,9708220319,-54,-54,35465052.84999752,4459.166665891185,-217,0,-3,0.206394534392631,-9645592802,1957.4483248872398,1831.5042777697238,125.94404711751599,0.7711869508709925,0.7718078269890558,-217
1727,2021-09-24,2021,280232,280232,553306306.1333336,4349291.250000001,218362,0,255,0.8868330526135489,62316776,10594689176,280292,280292,89798,370090,517906097.1166614,4344753.6166671235,218566,0,256,0.6726093652895365,9716670345,-60,-60,35400209.016672134,4537.63333287742,-204,0,-1,0.21422368732401242,-9654353569,1974.4579710144935,1847.737706094578,126.72026491991551,0.7792186474064347,0.7797796583562856,-204
1728,2021-09-25,2021,277460,277460,553621928.2166667,4372813.666666665,217275,0,104,0.8912636055647669,64209457,10605291640,277299,277299,89207,366506,518324325.7166613,4367880.950000474,217440,0,108,0.6760080326106667,9731452666,161,161,35297602.500005424,4932.716666190885,-165,0,-4,0.21525557295410025,-9667243209,1995.3215894783634,1869.189307269991,126.13228220837232,0.7830858502126432,0.7841355360098666,-165
1729,2021-09-26,2021,278908,278908,554240059.249999,4301800.23333333,219296,0,42,0.8914875155965417,61591185,10617014730,278850,278850,84543,363393,519000207.6500105,4297555.850000102,219499,0,42,0.6852085758393858,9745532915,58,58,35239851.59998852,4244.383333227597,-203,0,0,0.20627893975715594,-9683941730,1987.1787802787983,1861.216452035182,125.96232824361618,0.7862664391125389,0.7871579702348933,-203
1730,2021-09-27,2021,274820,274820,554384258.8833327,4340711.350000001,214572,0,55,0.8975584018630371,62962996,10628158212,274788,274788,90936,365724,519182214.0666662,4336386.81666709,214706,0,54,0.6749488685456922,9765606219,32,32,35202044.81666654,4324.533332910389,-134,0,1,0.2226095333173449,-9702643223,2017.2631500012108,1889.3918732501645,127.87127675104625,0.7807728695145914,0.7813514418387993,-134
1731,2021-09-28,2021,275631,275631,554851007.7000003,4330320.16666666,215393,0,51,0.8948267792809959,62417163,10640620289,275635,275635,82607,358242,519719484.5833361,4325447.983333805,215509,0,52,0.689436191178034,9769323514,-4,-4,35131523.11666417,4872.183332855813,-116,0,-1,0.20539058810296185,-9706906351,2013.0210596776135,1885.5351627454284,127.48589693218514,0.7814541905663731,0.781863696555227,-116
1732,2021-09-29,2021,278152,278152,555288083.4666666,4394379.466666675,217913,0,116,0.9055013086370045,63225908,10649623768,278296,278296,82877,361173,520208700.383334,4390174.433333794,218083,0,116,0.698429838332325,9783640571,-144,-144,35079383.0833326,4205.033332881518,-170,0,0,0.20707147030467954,-9720414663,1996.3476209650355,1869.264022419776,127.08359854525952,0.7834313612700969,0.7836368470980539,-170
1733,2021-09-30,2021,280711,280711,556035052.7999996,4438037.533333338,218162,0,114,0.9017637356569558,63645457,10663272155,280722,280722,82594,363316,521028493.8500048,4433408.133334368,218328,0,116,0.6979984366226734,9796288017,-11,-11,35006558.9499948,4629.39999897033,-166,0,-2,0.20376529903428242,-9732642560,1980.8096326827222,1856.0301431665662,124.77948951615599,0.7771765267481502,0.7777374056896147,-166
1734,2021-10-01,2021,281149,281149,556251285.7166663,4429613.249999994,217579,0,137,0.8953437501111517,62369822,10672681130,281221,281221,83445,364666,521341745.166668,4425114.116667428,217725,0,137,0.6912462362819499,9807323997,-72,-72,34909540.54999834,4499.133332566358,-146,0,0,0.20409751382920183,-9744954175,1978.492847979777,1853.8506909749556,124.64215700482146,0.7738921354868771,0.7742131633128394,-146
1735,2021-10-02,2021,281186,281186,556429175.183333,4412824.766666667,215049,0,42,0.8747590562830312,62778900,10675765426,281075,281075,83294,364369,521582395.79999804,4408042.116667762,215231,0,44,0.6763089066303638,9819964968,111,111,34846779.383334994,4782.649998904206,-182,0,-2,0.19845014965266738,-9757186068,1978.8651468541573,1855.6698240683022,123.19532278585507,0.764792699494285,0.7657422396157609,-182
1736,2021-10-03,2021,267380,267380,556368901.2000009,4264050.966666666,209870,0,64,0.8955494053407134,62834796,10688288447,267312,267312,90473,357785,521595087.08333176,4259347.8166667335,210047,0,64,0.6704333608172438,9827105005,68,68,34773814.11666912,4703.149999932386,-177,0,0,0.22511604452346956,-9764270209,2080.817193507371,1951.2595285035156,129.5576650038554,0.7849128581045702,0.7857746752858084,-177
1737,2021-10-04,2021,261307,261307,556570720.9166671,4221363.5333333295,205183,0,132,0.9005537547788616,63062496,10707401100,261345,261345,85079,346424,521855303.3666753,4216647.249999789,205407,0,132,0.6805417638500821,9848909429,-38,-38,34715417.54999179,4716.283333540894,-224,0,0,0.22001199092877943,-9785846933,2129.9495264828997,1996.8061503632184,133.1433761196813,0.7852181533598411,0.7859610859209092,-224
1738,2021-10-05,2021,261154,261154,556578604.5499998,4220879.749999997,205251,0,120,0.8999708983971147,62819780,10711434200,261212,261212,78114,339326,521952826.0000028,4216277.016665959,205480,0,121,0.694096532538048,9863509419,-58,-58,34625778.54999703,4602.733334038407,-229,0,-1,0.2058743658590667,-9800689639,2131.2275689822854,1998.196200787111,133.03136819517454,0.7859385649846451,0.7866407362602025,-229
1739,2021-10-06,2021,263954,263954,557128347.8166664,4241878.683333329,207241,0,141,0.8991718253938201,63475589,10726994600,264019,264019,75226,339245,522551777.34999967,4237857.566666641,207386,0,142,0.7006912408436512,9877271874,-65,-65,34576570.4666667,4021.1166666876525,-145,0,-1,0.19848058455016893,-9813796285,2110.702424728045,1979.2203491036616,131.48207562438347,0.7851405926790274,0.7854964983580727,-145
1740,2021-10-07,2021,265501,265501,557670949.6833327,4268870.1000000015,207579,0,41,0.8954429550171187,63592494,10740135221,265516,265516,77043,342559,523165885.8833357,4264891.300000098,207757,0,42,0.6951386476490099,9892248330,-15,-15,34505063.79999697,3978.7999999038875,-178,0,-1,0.20030430736810878,-9828655836,2100.447643072277,1970.3742368947096,130.07340617756745,0.781838863130459,0.7824650868497567,-178
1741,2021-10-08,2021,268241,268241,558025679.333334,4300784.699999996,210172,0,50,0.9003619879138534,63679144,10751934852,268152,268152,77361,345513,523670031.73332846,4297153.366666961,210304,0,51,0.6998810464439851,9906996237,89,89,34355647.60000551,3631.3333330349997,-132,0,-1,0.20048094146986828,-9843317093,2080.3146399444304,1952.885049275517,127.4295906689133,0.7835192979447586,0.7842716071481846,-132
1742,2021-10-09,2021,266940,266940,558159000.7333336,4307615.116666666,210533,0,37,0.9046939387128189,63904426,10756627196,266946,266946,78216,345162,523863249.13333404,4303849.9666670505,210690,0,37,0.7005000550466239,9922944211,-6,-6,34295751.59999955,3765.1499996157363,-157,0,0,0.20419388366619495,-9859039785,2090.953025898455,1962.4315372147703,128.52148868368477,0.788690342399041,0.7892607493650401,-157
1743,2021-10-10,2021,264985,264985,558534629.7666672,4261146.783333333,210737,0,39,0.9167650999113149,64812940,10770255442,264956,264956,80330,345286,524182453.3000047,4257435.166666656,210890,0,39,0.7042306957131285,9930541607,29,29,34352176.466662526,3711.616666677408,-153,0,0,0.21253440419818648,-9865728667,2107.7971574491658,1978.3754785700446,129.42167887912115,0.7952789780553616,0.7959434774075695,-153
1744,2021-10-11,2021,255981,255981,558883798.2833343,4205722.033333333,202777,0,47,0.9116496927506341,62501611,10781863868,255941,255941,82556,338497,524556578.0499945,4201679.333333228,202954,0,49,0.6902867676818398,9947550537,40,40,34327220.23333973,4042.7000001054257,-177,0,-2,0.2213629250687943,-9885048926,2183.301878980605,2049.521483662229,133.78039531837612,0.7921564491114574,0.792971817723616,-177
1745,2021-10-12,2021,256868,256868,558889938.9999993,4247196.416666664,203581,0,35,0.9081707336063651,62751565,10785105105,256847,256847,73636,330483,524605253.4333371,4244007.466666609,203639,0,35,0.7062753606085478,9962677024,21,21,34284685.56666219,3188.9500000551343,-58,0,0,0.20189537299781735,-9899925459,2175.7865479545885,2042.481529600646,133.30501835394261,0.7925510378871639,0.792841652812764,-58
1746,2021-10-13,2021,272295,272295,559162540.9666662,4344031.566666665,213151,0,48,0.8910409665987257,63414968,10784283968,272428,272428,70992,343420,525079137.15000355,4340585.766666863,213311,0,50,0.7073758080484702,9966220506,-133,-133,34083403.81666267,3445.799999801442,-160,0,-2,0.18366515855025545,-9902805538,2053.517475409634,1927.405175495924,126.11229991370988,0.7827943957839842,0.7829995448338644,-160
1747,2021-10-14,2021,273445,273445,559873468.9833338,4330568.116666668,212235,0,45,0.8817860995812686,63268918,10798590027,273447,273444,78475,351922,525841015.4666609,4326981.96666712,212454,0,45,0.6863225373804361,9975640939,-2,1,34032453.51667291,3586.1499995477498,-219,0,0,0.1954635622008325,-9912372021,2047.481098514633,1923.0300005363472,124.45109797828582,0.7761524255334711,0.7769476351907316,-219
1748,2021-10-15,2021,272560,272560,559923899.0500001,4295459.9,212725,0,40,0.8947828001174056,63209937,10809242542,272497,272497,85566,358063,525935700.7833398,4291111.76666695,212926,0,41,0.6821397351862784,9987262787,63,63,33988198.26666027,4348.133333050646,-201,0,-1,0.21264306493112728,-9924052850,2054.314275939243,1930.0605173023548,124.25375863688828,0.7804703551511594,0.781388418955071,-201
1749,2021-10-16,2021,258521,258521,559307660.1000004,4219961.333333326,206378,0,45,0.9226871317997379,62736735,10808337194,258566,258566,86573,345139,525400874.11666864,4215618.183333278,206522,0,45,0.6919907631417946,9998543335,-45,-45,33906785.98333174,4343.15000004787,-144,0,0,0.2306963686579433,-9935806600,2163.4902390908296,2031.979742567347,131.51049652348252,0.7983026523957435,0.7987206361238524,-144
1750,2021-10-17,2021,263733,263733,559487803.2499994,4157102.0666666683,207185,0,31,0.8910337348758025,61785375,10816636750,263802,263802,80982,344784,525601652.1833314,4153186.3666664083,207296,0,33,0.6820357093136484,10005199935,-69,-69,33886151.06666803,3915.7000002600253,-111,0,-2,0.20899802556215408,-9943414560,2121.4175065312243,1992.4096564216018,129.0078501096225,0.7855861799623104,0.7858014723163584,-111
1751,2021-10-18,2021,271339,271339,558686189.8833338,4259973.099999998,213676,0,47,0.9004750515038387,63331685,10803421667,271364,271364,83171,354535,524984320.98332775,4255875.683333363,213892,0,47,0.6901998392260307,10003582642,-25,-25,33701868.900006056,4097.416666634381,-216,0,0,0.210275212277808,-9940250957,2058.9970106889677,1934.6129957670425,124.3840149219252,0.787487239209992,0.78821066906443,-216
1752,2021-10-19,2021,265545,265545,558885752.0999994,4205914.0666666655,210271,0,48,0.9120224444067868,60966556,10808001942,265562,265562,83854,349416,525234194.88333267,4201204.566666539,210477,0,48,0.6942097671543315,9999858649,-17,-17,33651557.21666676,4709.50000012666,-206,0,0,0.21781267725245534,-9938892093,2104.674356888661,1977.8213557788113,126.85300110984963,0.7918469562597676,0.7925719794247671,-206
1753,2021-10-20,2021,266942,266942,559060657.1166674,4286663.649999998,207887,0,54,0.9086955218736652,61748758,10811841385,266685,266685,80087,346772,525493527.5999904,4281773.8166669505,208068,0,54,0.7005236870335565,10007033949,257,257,33567129.51667696,4889.833333047107,-181,0,0,0.2081718348401087,-9945285191,2094.3150838634137,1970.465259013407,123.84982485000683,0.7787721677368118,0.7802013611564205,-181
1754,2021-10-21,2021,266783,266783,559273159.5499998,4268574.766666667,210351,0,122,0.922581273919253,62474158,10809717091,266777,266777,78903,345680,525762944.3333434,4264360.416666836,210486,0,122,0.712896320296228,10013637492,6,6,33510215.216656446,4214.349999831058,-135,0,0,0.20968495362302508,-9951163334,2096.3598113448,1970.795624560376,125.56418678442424,0.7884722789683001,0.7889960528831196,-135
1755,2021-10-22,2021,262372,262372,558988681.8833325,4241588.266666666,206663,0,60,0.9166145777750674,62401515,10808371747,262367,262367,80338,342705,525525746.250009,4237456.016666553,206815,0,61,0.7025896908419905,10014967944,5,5,33462935.63332349,4132.25000011269,-152,0,-1,0.21402488693307686,-9952566429,2130.519574814891,2003.0177051611254,127.50186965376543,0.7876717027731618,0.7882660548010992,-152
1756,2021-10-23,2021,265752,265752,559149586.4500003,4259787.683333331,209499,0,37,0.9092499774225588,62465335,10811991098,265687,265687,77632,343319,525783277.83333045,4255425.06666678,209637,0,38,0.704784762859044,10014578188,65,65,33366308.616669834,4362.616666550748,-138,0,-1,0.20446521456351474,-9952112853,2104.02776441946,1978.9574869426447,125.07027747681514,0.7883252054547096,0.7890374764290311,-138
1757,2021-10-24,2021,261150,261150,559001773.5,4188099.483333334,206380,0,38,0.9121883974727163,61611194,10813639097,261150,261150,80039,341189,525659875.01666343,4183633.2333332943,206529,0,38,0.699172599351087,10018366832,0,0,33341898.483336568,4466.250000039581,-149,0,0,0.2130157981216293,-9956755638,2140.5390522688112,2012.8656902801586,127.67336198865269,0.7902737890101474,0.7908443423319931,-149
1758,2021-10-25,2021,266041,266041,559433918.0999995,4217767.4,207013,0,45,0.8963280095925065,61405274,10829463034,265903,265903,78034,343937,526160998.3000017,4214658.3333333265,207181,0,45,0.6945719710295656,10029963755,138,138,33272919.799997866,3109.066666673869,-168,0,0,0.2017560385629409,-9968558481,2102.8109129795766,1978.7704474940174,124.04046548555925,0.7781244244308209,0.7791600696494586,-168
1759,2021-10-26,2021,267062,267062,559196318.9666672,4254667.183333332,210696,0,42,0.9152930780118476,61587733,10825796424,267018,267018,80974,347992,525962617.43333787,4251279.75000003,210736,0,42,0.7027977654658871,10032145951,44,44,33233701.533329308,3387.4333333019167,-40,0,0,0.21249531254596044,-9970558218,2093.8820160362284,1969.7646504480517,124.11736558817665,0.7889403958631329,0.7892202023833599,-40
1760,2021-10-27,2021,272744,272744,559561794.5000001,4343299.149999999,214365,0,42,0.9221614407649665,63021626,10833543305,272752,272752,79432,352184,526397535.4833363,4338865.016667079,214506,0,42,0.7150551984190375,10035897647,-8,-8,33164259.01666379,4434.133332920261,-141,0,0,0.207106242345929,-9972876021,2051.60074832077,1929.9493147010337,121.65143361973628,0.7859567946499282,0.7864506951369743,-141
1761,2021-10-28,2021,272925,272925,560095229.9166664,4334069.266666662,212500,0,54,0.9103893010900432,62610499,10841480461,272938,272938,79468,352406,526970472.1166673,4330705.900000503,212653,0,54,0.7061911545206287,10045647247,-13,-13,33124757.799999118,3363.3666661586612,-153,0,0,0.20419814656941448,-9983036748,2052.1946685597377,1930.733251202351,121.46141735738661,0.7786021800861043,0.7791256622383105,-153
1762,2021-10-29,2021,252891,252891,558893003.15,3883335.266666668,191889,0,71,0.8690661193953131,59572786,10837908553,252975,252975,85531,338506,525830786.483335,3881093.73333284,192115,0,71,0.6507211098178333,10051530405,-84,-84,33062216.666664958,2241.533333828207,-226,0,0,0.21834500957747982,-9991957619,2210.0153945771103,2078.587949336239,131.4274452408713,0.7587814512971992,0.7594228678723194,-226
1763,2021-10-30,2021,227586,227586,549758749.4833331,3709010.600000001,165419,0,67,0.8301960577539911,58228569,10795935737,227747,227747,89380,317127,516732485.866668,3705207.7499997728,165643,0,67,0.5969911108167943,10047370536,-161,-161,33026263.616665125,3802.850000228267,-224,0,0,0.23320494693719673,-9989141967,2415.6088225256963,2268.888221871937,146.72060065375945,0.7268417213712619,0.7273114464734991,-224
1764,2021-10-31,2021,222855,222855,547277692.3000002,3648718.1333333347,162950,0,43,0.8363509905543971,58148252,10786955022,223045,223045,68674,291719,514262022.8666602,3645511.049999642,163155,0,43,0.6402325525591499,10011265209,-190,-190,33015669.433340013,3207.0833336925134,-205,0,0,0.1961184379952472,-9953116957,2455.7568477261007,2305.6424616855797,150.1143860405209,0.7311929281371295,0.7314891613799905,-205
1765,2021-11-01,2021,223832,223832,546032589.1333325,3630140.2666666685,163532,0,59,0.8354301440365992,57697419,10787259868,223891,223891,65508,289399,513074747.35000354,3626490.383333033,163685,0,59,0.6473311932660407,10002058598,-59,-59,32957841.78332895,3649.8833336355165,-153,0,0,0.1880989507705585,-9944361179,2439.4750935225193,2291.6273872107568,147.84770631176252,0.7306015225704993,0.73109236190825,-153
1766,2021-11-02,2021,224736,224736,544580281.75,3643432.699999999,163856,0,39,0.8275487683326221,58162546,10775833631,224975,224975,64025,289000,511711195.7166726,3640776.3666662206,164068,0,39,0.6447993079584879,10001657534,-239,-239,32869086.0333274,2656.333333778195,-212,0,0,0.1827494603741342,-9943494988,2423.2000291453082,2274.524705930315,148.6753232149931,0.7291043713512744,0.7292721413490387,-212
1767,2021-11-03,2021,229238,229238,543363502.3333329,3675579.966666665,165874,0,47,0.8216918660954986,57517841,10763977508,229469,229469,63458,292927,510640875.8666704,3674039.166666379,166071,0,47,0.6442936294708163,9990431154,-231,-231,32722626.466662467,1540.8000002857298,-197,0,0,0.17739823662468235,-9932913313,2370.3029267980564,2225.3152969101293,144.98762988792714,0.7235885847896073,0.7237186722389517,-197
1768,2021-11-04,2021,231271,231271,542384538.1000011,3598318.500000001,165644,0,46,0.8102745264213846,56929718,10752001867,231452,231452,63935,295387,509747684.58332264,3596049.283333023,165871,0,46,0.6359352307312156,9977243782,-181,-181,32636853.516678452,2269.2166669778526,-227,0,0,0.17433929569016904,-9920314064,2345.233678671347,2202.390493853251,142.84318481809623,0.7162333366483477,0.7166539930525552,-227
1769,2021-11-05,2021,223462,223462,539193661.5499997,3525854.783333328,160707,0,60,0.8120217307640669,56137208,10723201795,223727,223727,73751,297478,506595552.1000049,3524533.5833328944,160987,0,61,0.6117796946328782,9969340435,-265,-265,32598109.449994802,1321.200000433717,-280,0,-1,0.20024203613118874,-9913203227,2412.909852905638,2264.3469590170384,148.56289388859977,0.7191692547278732,0.7195689389300353,-280
1770,2021-11-06,2021,211303,211303,536266808.5666664,3388897.7166666677,154637,0,50,0.8240015522732761,55751429,10698248581,211440,211440,72494,283934,503710612.69998837,3385788.1999997427,154830,0,50,0.61447378616158,9945692979,-137,-137,32556195.86667806,3109.5166669250466,-193,0,0,0.2095277661116961,-9889941550,2537.904376968933,2382.2862878357378,155.6180891331951,0.73182586144068,0.7322644721906924,-193
1771,2021-11-07,2021,168751,168751,522950941.3500004,2865955.700000002,132224,0,34,0.8823651415399021,52028796,10585292624,168856,168856,82351,251207,490442281.6500033,2863607.2833328447,132342,0,34,0.5938250128380151,9912202062,-105,-105,32508659.699997067,2348.4166671573184,-118,0,0,0.28854012870188694,-9860173266,3098.9501771841374,2904.5001755934245,194.45000159071287,0.7835449864000806,0.7837565736485527,-118
1772,2021-11-08,2021,170801,170801,519326764.51666677,2878490.066666666,132999,0,87,0.8817044396695566,52158694,10554394279,170945,170945,47510,218455,486852068.25001395,2875696.8166663083,133100,0,87,0.690865395619232,9818438837,-144,-144,32474696.266652822,2793.250000357628,-101,0,0,0.1908390440503246,-9766280143,3040.537025641927,2848.004143145538,192.532882496389,0.7786781107838947,0.7786130041826318,-101
1773,2021-11-09,2021,172256,172256,517686420.53333354,2889788.4333333317,134485,0,45,0.8809910830391975,52606597,10535851816,172399,172399,44066,216465,485332635.63333476,2885508.633332977,134639,0,45,0.7029311897997406,9782537444,-143,-143,32353784.899998784,4279.800000354648,-154,0,0,0.17805989323945692,-9729930847,3005.3317186822724,2815.1708283304124,190.16089035185996,0.780727521827977,0.7809732075012036,-154
1774,2021-11-10,2021,171856,171856,515012949.04999983,2882684.383333331,133579,0,61,0.8758437296341125,51540546,10501803320,172066,172066,45781,217847,482819451.9499975,2881608.6333329873,133788,0,61,0.6931148925622067,9765290105,-210,-210,32193497.10000235,1075.750000343658,-209,0,0,0.1827288370719058,-9713749559,2996.7702556209842,2806.0131109574086,190.75714466357567,0.7772728330695466,0.7775388513709856,-209
1775,2021-11-11,2021,173182,173182,514033187.2666667,2890794.5833333363,134417,0,202,0.8809980251989239,51555990,10485825840,173376,173376,47414,220790,481927452.73333436,2888612.333333061,134565,0,203,0.6927895285112459,9748717803,-194,-194,32105734.533332348,2182.250000275206,-148,0,-1,0.18820849668767803,-9697161813,2968.1675189492366,2779.6664632552047,188.50105569403195,0.7761603399891444,0.7761454872646734,-148
1776,2021-11-12,2021,174181,174181,513423216.23333323,2887500.6333333296,135496,0,185,0.8876513511806688,52231195,10479009061,174268,174268,50111,224379,481416153.7333432,2884879.8166663335,135624,0,188,0.6908489653666265,9737509123,-87,-87,32007062.499990046,2620.8166669961065,-128,0,-3,0.1968023858140423,-9685277928,2947.641914062574,2762.504612053522,185.13730200905184,0.7779034452667053,0.778249592581541,-128
1777,2021-11-13,2021,170675,170675,512392997.316667,2883284.750000003,133539,0,126,0.8942610224110144,52025677,10469253331,170829,170829,52455,223284,480422406.3833349,2879199.5833331584,133691,0,127,0.6853110836423748,9723323262,-154,-154,31970590.933332145,4085.166666844394,-152,0,-1,0.20894993876863954,-9671297585,3002.15612899761,2812.300056684374,189.85607231323593,0.7824168741760656,0.7826013147650575,-152
1778,2021-11-14,2021,169435,169435,512215656.166667,2871281.5000000037,131933,0,135,0.889149231268628,52250274,10472041710,169608,169608,50324,219932,480200975.9833328,2868941.616666455,132069,0,136,0.6866576941963874,9723096023,-173,-173,32014680.18333417,2339.8833335489035,-136,0,-1,0.20249153707224055,-9670845749,3023.080568753014,2831.24013008427,191.84043866874435,0.7786643845722548,0.7786719966039338,-136
1779,2021-11-15,2021,174223,174223,512570285.0,2924474.1833333336,134824,0,73,0.8856867348168718,53169118,10481833238,174440,174440,49720,224160,480582657.21666753,2922086.4999998156,135016,0,73,0.6911001070663711,9727713253,-217,-217,31987627.783332467,2387.6833335179836,-192,0,0,0.19458662775050062,-9674544135,2942.035695631461,2755.0026210540445,187.0330745774163,0.7738587901712174,0.7739967897271268,-192
1780,2021-11-16,2021,174844,174844,512621418.06666714,2929763.7833333337,136326,0,50,0.8875397497197502,52638659,10487155773,175113,175113,49423,224536,480729553.3500024,2927176.7666664445,136502,0,50,0.6935324402323021,9732701813,-269,-269,31891864.71666473,2587.0166668891907,-176,0,0,0.19400730948744815,-9680063154,2931.878806631438,2745.2533698240704,186.62543680736735,0.779700761821967,0.779508089062491,-176
1781,2021-11-17,2021,174220,174220,512900249.6500004,2917942.7500000065,135715,0,51,0.8892492251176671,52035493,10495534782,175456,175456,50787,226243,481073722.31666636,2916261.249999668,136355,0,53,0.6889273922287,9740272204,-1236,-1236,31826527.33333403,1681.5000003385358,-640,0,-2,0.2003218328889671,-9688236711,2943.9803102399287,2741.848225860993,202.13208437893582,0.7789863391114683,0.777146407076418,-640
1782,2021-11-18,2021,172322,172322,512672646.2333331,2899005.8333333335,134491,0,37,0.886677266976939,52064542,10493573060,172532,172532,52943,225475,480951365.0833284,2895303.0999996844,134653,0,38,0.6797294600288324,9747306777,-210,-210,31721281.150004685,3702.733333649114,-162,0,-1,0.20694780694810666,-9695242235,2975.0852835582987,2787.6067343062646,187.4785492520341,0.7804633186708604,0.7804523218881135,-162
1783,2021-11-19,2021,172153,172153,512561262.2833337,2877870.4999999963,134480,0,39,0.8881808623724244,52329521,10497893793,172239,172239,51000,223239,480884331.18333304,2875789.433333086,134610,0,41,0.6863854434036992,9750743138,-86,-86,31676931.10000068,2081.066666910425,-130,0,-2,0.20179541896872522,-9698413617,2977.3588742765664,2791.9596095154584,185.39926476110804,0.781165591073057,0.7815303154337868,-130
1784,2021-11-20,2021,168223,168223,512050023.86666703,2861236.5333333295,131433,0,66,0.8934687884534216,52641160,10498542995,168324,168324,53323,221647,480411044.89999574,2858669.0833331156,131545,0,69,0.6796843629735616,9757297940,-101,-101,31638978.966671288,2567.450000213925,-112,0,-3,0.21378442547985999,-9704656780,3043.876425142026,2854.085245716569,189.79117942545736,0.7813022000558782,0.7814987761697678,-112
1785,2021-11-21,2021,165397,165397,511898714.7499994,2820097.8333333326,129925,0,65,0.9000163243589661,52000474,10499170650,165507,165507,50921,216428,480381541.30000174,2815450.5833330527,130036,0,65,0.6888526438353508,9754721183,-110,-110,31517173.449997663,4647.250000279862,-111,0,0,0.21116368052361523,-9702720709,3094.9697681940993,2902.484736597254,192.48503159684515,0.7855341995320351,0.785682780788728,-111
1786,2021-11-22,2021,165116,165116,511838220.11666596,2821023.499999999,130261,0,76,0.9016085660989848,52071169,10508992553,165305,165305,51481,216786,480347216.5833375,2818367.449999714,130383,0,76,0.6877658151356564,9761479374,-189,-189,31491003.533328474,2656.050000285264,-122,0,0,0.2138427509633284,-9709408205,3099.87051598068,2905.8238806045642,194.04663537611577,0.7889059812495458,0.7887420223223738,-122
1787,2021-11-23,2021,165410,165410,511980322.03333384,2826317.9166666702,130918,0,65,0.9025935554077745,52042756,10517273705,165624,165624,46860,212484,480515336.63332695,2824005.583333121,131064,0,65,0.7043212665424178,9767868701,-214,-214,31464985.40000689,2312.3333335490897,-146,0,0,0.19827228886535675,-9715825945,3095.2198901718994,2901.2421909465234,193.977699225376,0.7914757269814401,0.7913345891899725,-146
1788,2021-11-24,2021,168135,168135,512115524.66666704,2856954.183333331,132189,0,104,0.9006928955898529,51715046,10521890455,168342,168342,46890,215232,480666924.64999676,2854383.799999813,132300,0,106,0.7051274903360053,9775950249,-207,-207,31448600.016670287,2570.383333517704,-111,0,-2,0.19556540525384758,-9724235203,3045.8591290728705,2855.3000715804537,190.55905749241674,0.7862075118208582,0.7859001318743986,-111
1789,2021-11-25,2021,167460,167460,512308594.8666666,2870187.5833333367,131788,0,72,0.9015884390302158,51036739,10525696214,167612,167612,48159,215771,480983493.9999994,2868590.5166664296,131997,0,72,0.7016698258802241,9780939078,-152,-152,31325100.86666721,1597.0666669071652,-209,0,0,0.1999186131499917,-9729902339,3059.289351885027,2869.6244540963617,189.66489778866526,0.7869819658425893,0.787515213707849,-209
1790,2021-11-26,2021,167524,167524,512696433.7833333,2854463.7666666703,131921,0,35,0.8999546333659647,51498695,10531349833,167732,167732,48312,216044,481428216.6166692,2852029.449999734,132125,0,35,0.6999129806891213,9786319577,-208,-208,31268217.166664124,2434.316666936502,-204,0,0,0.20004165267684337,-9734820882,3060.4357213493786,2870.222835336544,190.2128860128346,0.7874752274300996,0.7877149261917822,-204
1791,2021-11-27,2021,162465,162465,512448896.18333316,2821918.566666669,128795,0,43,0.9047364047641033,50954169,10528670152,162673,162673,49789,212462,481213305.2500019,2819926.5333330953,128997,0,42,0.6941758996902958,9793661615,-208,-208,31235590.93333125,1992.033333573956,-202,0,1,0.21056050507380752,-9742707446,3154.2110373516334,2958.163341488765,196.0476958628683,0.7927553626935032,0.7929834699058849,-202
1792,2021-11-28,2021,161789,161789,512221404.24999905,2811821.150000003,128042,0,60,0.9105377992323332,51282143,10529380111,161974,161974,47568,209542,480959797.9000072,2809270.8499996546,128233,0,60,0.7049278903513412,9794004720,-185,-185,31261606.349991858,2550.300000348594,-191,0,0,0.20560990888099206,-9742722577,3165.9841166581105,2969.3642059837207,196.61991067438976,0.791413507716841,0.791688789558818,-191
1793,2021-11-29,2021,205933,205933,513027171.45,3136360.6999999983,147118,0,45,0.8261376272865455,55505853,10547829894,206581,206581,45751,252332,481833583.2166776,3132718.5166664277,147603,0,45,0.6780511389756285,9806321313,-648,-648,31193588.233322382,3642.1833335706033,-485,0,0,0.14808648831091697,-9750815460,2491.233417907766,2332.4196475797753,158.81377032799082,0.7143974010964731,0.7145042380470614,-485
1794,2021-11-30,2021,218871,218871,514383468.2833336,3676201.899999998,160407,0,101,0.8540921364639447,61816691,10567548850,220409,220409,42917,263326,483313543.4166893,3671656.883332664,161760,0,101,0.7200352414877462,9798119669,-1538,-1538,31069924.866644323,4545.016667333897,-1353,0,0,0.13405689497619844,-9736302978,2350.1673053229238,2192.803122452755,157.36418287016886,0.7328837534438094,0.7339083249776551,-1353
1795,2021-12-01,2021,234883,234883,515834187.06666696,3833268.700000002,172823,0,42,0.8624038351008796,62936922,10589173074,236832,236832,54876,291708,484851331.6499932,3828272.5833334983,174488,0,39,0.707039231011829,9820651726,-1949,-1949,30982855.41667378,4996.116666503716,-1665,0,3,0.15536460408905062,-9757714804,2196.1324875221576,2047.2374157630438,148.89507175911376,0.7357833474538387,0.7367585461424132,-1665
1796,2021-12-02,2021,251835,251835,517804604.4833333,4077913.6333333347,183360,0,75,0.8559096233645038,62673681,10612824122,253728,253728,57128,310856,486833189.51666725,4072083.833333481,184994,0,75,0.7033031371438837,9845049383,-1893,-1893,30971414.966666043,5829.799999853596,-1634,0,0,0.15260648622062012,-9782375702,2056.126449791861,1918.7207935926158,137.4056561992452,0.7280957769968431,0.7291036070122335,-1634
1797,2021-12-03,2021,255631,255631,519635454.63333386,4133400.8666666597,184526,0,44,0.8619846575728296,63214584,10640447801,257572,257572,63839,321411,488730606.84999937,4128195.8166668043,186233,0,42,0.6946588635734127,9873590087,-1941,-1941,30904847.783334494,5205.049999855459,-1707,0,2,0.16732579399941694,-9810375503,2032.7560218961466,1897.4523894289728,135.30363246717388,0.7218451596246152,0.7230327830664823,-1707
1798,2021-12-04,2021,247841,247841,521033728.31666595,4059445.8333333344,179176,0,53,0.8656033505352215,63254983,10662912021,249707,249707,68799,318506,490114822.03333277,4053238.5666671055,180934,0,53,0.6835224454170317,9899765388,-1866,-1866,30918906.283333182,6207.266666228883,-1758,0,0,0.18208090511818986,-9836510405,2102.290292230365,1962.759642434264,139.53064979610122,0.7229473735176989,0.7245852138706564,-1758
1799,2021-12-05,2021,246832,246832,522419346.3666666,3963447.849999999,177012,0,43,0.8515427497245096,62849585,10686430194,248598,248598,66309,314907,491547141.0999976,3957366.183333647,178631,0,43,0.6773364834697158,9922261122,-1766,-1766,30872205.266669035,6081.66666635219,-1619,0,0,0.17420626625479385,-9859411537,2116.4976436064476,1977.2771345706626,139.22050903578497,0.717135541582939,0.7185536488628227,-1619
1800,2021-12-06,2021,242079,242079,523803901.10000014,3900215.2333333315,173050,0,42,0.8415310704356836,63117109,10723565437,243955,243955,72027,315982,492943858.1166664,3893818.6666668146,174702,0,39,0.6541543505642705,9950900608,-1876,-1876,30860042.983333766,6396.566666516941,-1652,0,3,0.18737671987141313,-9887783499,2163.7725746553815,2020.6343715712585,143.138203084123,0.714849284737627,0.7161238753048718,-1652
1801,2021-12-07,2021,243666,243666,525021554.8500006,3927265.4999999963,174811,0,47,0.852256777720323,62586970,10749729354,245592,245592,68954,314546,494145212.5833389,3921915.433333709,176470,0,45,0.6705060627062611,9982191314,-1926,-1926,30876342.266661704,5350.06666628737,-1659,0,2,0.18175071501406193,-9919604344,2154.677118884049,2012.0574472431467,142.6196716409022,0.7174205674981327,0.7185494641519268,-1659
1802,2021-12-08,2021,250924,250924,526217808.98333395,3985072.1500000027,179315,0,50,0.85014586089812,63062895,10772181476,255025,255025,66264,321289,495374364.4666635,3982176.033333548,182457,0,50,0.6784670499145656,10012147067,-4101,-4101,30843444.516670465,2896.116666454822,-3142,0,0,0.17167881098355442,-9949084172,2097.1202793807447,1942.4541298565375,154.66614952420719,0.7146187690296664,0.7154475051465543,-3142
1803,2021-12-09,2021,254936,254936,527188720.36666596,4051474.1999999927,183109,0,51,0.8520452191922673,62836667,10787584517,266980,266980,70213,337193,496462156.8499983,4051914.950000463,189179,0,51,0.6675108913886104,10032127262,-12044,-12044,30726563.516667664,-440.7500004703179,-6070,0,0,0.18453432780365686,-9969290595,2067.9257553529746,1859.5481191474953,208.37763620547935,0.7182547776696896,0.7085886583264664,-6070
1804,2021-12-10,2021,252189,252189,528381215.4166671,4043091.633333331,180659,0,88,0.8504375686489102,62691127,10807539991,254214,254214,78313,332527,494711515.41666514,4037657.033333582,182407,0,88,0.655312200212322,9888906878,-2025,-2025,33669700.00000197,5434.599999749102,-1748,0,0,0.19512536843658823,-9826215751,2095.179470225375,1946.0435515615393,149.1359186638358,0.7163635210100361,0.7175332593798925,-1748
1805,2021-12-11,2021,242899,242899,529115124.66666657,3967143.3166666664,175624,0,111,0.8542357111391984,62755767,10832664040,244642,244642,73037,317679,495554274.84999734,3961147.616667075,177307,0,113,0.6623446938576387,9906867985,-1743,-1743,33560849.816669226,5995.699999591336,-1683,0,-2,0.19189101728155966,-9844112218,2178.3338946091444,2025.6304103547116,152.70348425443285,0.7230330301895026,0.7247610794548769,-1683
1806,2021-12-12,2021,227832,227832,529748975.41666615,3779633.7499999977,164692,0,119,0.849116893149338,62382744,10859658587,229762,229762,71463,301225,496204820.01666135,3774506.616666907,166431,0,121,0.652581957008889,9934651052,-1930,-1930,33544155.400004804,5127.133333090693,-1739,0,-2,0.19653493614044903,-9872268308,2325.173704381589,2159.6470261255618,165.52667825602703,0.7228659714175357,0.7243626013004761,-1739
1807,2021-12-13,2021,244026,244026,531036286.0333333,3929678.2833333304,176620,0,157,0.8559948530074662,62703696,10888692861,260162,260162,64838,325000,497536175.5166955,3934097.2333328477,188330,0,158,0.6839876923076841,9964954240,-16136,-16136,33500110.516637802,-4418.9499995172955,-11710,0,-1,0.17200716069978217,-9902250544,2176.146337002341,1912.4090970883353,263.73723991400584,0.7237753354150788,0.7238951115074453,-11710
1808,2021-12-14,2021,256368,256368,532293653.56666684,4120821.866666672,183225,0,171,0.8519667041128383,63941340,10912794094,258199,258199,64967,323166,483792757.66666186,4114918.5833336497,184907,0,177,0.685328902174119,9335153427,-1831,-1831,48500895.90000498,5903.283333022147,-1682,0,-6,0.16663780193871924,-9271212087,2076.287421076994,1873.7204933662092,202.56692771078497,0.7146952817824378,0.7161414257994803,-1682
1809,2021-12-15,2021,255183,255183,533707616.75000036,4110403.8333333326,179281,0,125,0.8298867871292364,63425262,10938610180,257234,257234,67406,324640,485269356.39999896,4104780.483333446,181063,0,129,0.6632731641202623,9357424642,-2051,-2051,48438260.350001395,5623.349999886472,-1782,0,-4,0.1666136230089741,-9293999380,2091.470108706302,1886.4899523391114,204.98015636719083,0.7025585560166625,0.7038844009734327,-1782
1810,2021-12-16,2021,246273,246273,534621620.7000002,3872922.1833333336,174776,0,111,0.8331242158092842,62596678,10969488512,248160,248160,71981,320141,486168883.766674,3868694.566666024,176300,0,111,0.6495356733439185,9386700407,-1887,-1887,48452736.933326244,4227.616667309776,-1524,0,0,0.1835885424653657,-9324103729,2170.849507254146,1959.0944703686089,211.75503688553704,0.7096839686039477,0.7104287556415216,-1524
1811,2021-12-17,2021,222503,222503,534121723.05000013,3694624.150000001,160054,0,110,0.847575088875207,62617906,10989220725,224000,224000,80841,304841,485747347.5500078,3689418.7333331276,161328,0,110,0.6270088341135278,9413644216,-1497,-1497,48374375.49999231,5205.416666873265,-1274,0,0,0.22056625476167924,-9351026310,2400.514703397258,2168.5149444196777,231.9997589775803,0.7193341213376898,0.7202142857142857,-1274
1812,2021-12-18,2021,221727,221727,534573648.40000045,3727272.216666662,163674,0,53,0.8645676890951485,62894116,11005491829,223424,223424,66136,289560,486287709.13333184,3721777.450000209,165239,0,53,0.6717916839342433,9437783637,-1697,-1697,48285939.26666862,5494.766666453332,-1565,0,0,0.1927760051609052,-9374889521,2410.954229299997,2176.52404904277,234.43018025722722,0.7381780297392739,0.7395758736751648,-1565
1813,2021-12-19,2021,232869,232869,535592112.9666664,3870730.466666664,169553,0,59,0.8627597490434536,62785238,11030484601,234633,234633,56711,291344,487357831.4666697,3864782.1666669673,171106,0,60,0.6997295293536118,9459914398,-1764,-1764,48234281.49999672,5948.299999696668,-1553,0,-1,0.16303021968984188,-9397129160,2299.9717135671403,2077.1069349438044,222.86477862333595,0.7281046425243377,0.7292495088073715,-1553
1814,2021-12-20,2021,243592,243592,537396994.3166673,3965349.2333333376,176022,0,95,0.8554878649545141,63363177,11061973606,245430,245430,58170,303600,489240644.0833324,3959354.366666898,177603,0,95,0.6962154150197627,9489716779,-1838,-1838,48156350.2333349,5994.866666439455,-1581,0,0,0.15927244993475143,-9426353602,2206.135646148754,1993.4019642396302,212.7336819091238,0.722609937928996,0.723640141791957,-1581
1815,2021-12-21,2021,242922,242922,538465154.4499998,3873043.716666665,173773,0,66,0.8414758646808448,62360225,11082824976,246695,246695,64011,310706,490295847.549996,3867256.616666897,176883,0,66,0.6722593062251699,9518661096,-3773,-3773,48169306.90000379,5787.099999767728,-3110,0,0,0.16921655845567485,-9456300871,2216.617492240307,1987.4575793996473,229.15991284065967,0.7153448432006981,0.7170108838849591,-3110
1816,2021-12-22,2021,237717,237717,538879087.6999998,3863356.683333332,168900,0,47,0.8302098714017084,62218031,11104854294,239960,239960,71343,311303,489615810.16666925,3858582.2500000037,170703,0,48,0.6439803021493643,9490691959,-2243,-2243,49263277.53333056,4774.433333328459,-1803,0,-1,0.18622956925234413,-9428473928,2266.8933551239493,2040.4059433516804,226.48741177226884,0.710508714143288,0.711381063510585,-1803
1817,2021-12-23,2021,236105,236105,539691591.6166667,3835540.849999992,169904,0,41,0.8386480591262355,62504935,11121740675,237758,237758,68328,306086,490450919.1500103,3829695.8999993782,171193,0,40,0.6544827270767064,9515151489,-1653,-1653,49240672.46665639,5844.950000613928,-1289,0,1,0.18416533204952912,-9452646554,2285.811785505037,2062.8156324919046,222.99615301313224,0.7196120370174287,0.720030451130982,-1289
1818,2021-12-24,2021,213188,213188,539247573.8166664,3525881.0999999996,153428,0,36,0.8324389740510734,54633320,11127951564,214435,214435,70610,285045,490087131.01667374,3522757.1833330765,154465,0,34,0.6294620147696038,9525186851,-1247,-1247,49160442.79999262,3123.916666923091,-1037,0,2,0.20297695928146953,-9470553531,2529.446187480845,2285.4810596062853,243.96512787455958,0.7196840347486725,0.7203348333993984,-1037
1819,2021-12-25,2021,190698,190698,537754990.6000005,3294846.133333333,137117,0,38,0.8317863847549527,52777084,11124486034,191579,191579,66773,258352,488616173.35000396,3291384.8166666715,137721,0,40,0.6179476063665126,9533377409,-881,-881,49138817.24999654,3461.316666661296,-604,0,-2,0.21383877838844012,-9480600325,2819.9298922904304,2550.4683360389395,269.46155625149095,0.7190269431247313,0.7188731541557268,-604
1820,2021-12-26,2021,199561,199561,538211082.3000004,3393251.6500000013,145550,0,35,0.8445187185872992,55760568,11137192189,200743,200743,49166,249909,489197306.2666804,3390294.9999995665,146447,0,35,0.6811479378493762,9540547736,-1182,-1182,49013776.03332001,2956.6500004348345,-897,0,0,0.163370780737923,-9484787168,2696.9752722225307,2436.9333240346136,260.0419481879171,0.7293509252809918,0.7295248153111192,-897
1821,2021-12-27,2021,221846,221846,540098757.9166666,3714525.883333333,162748,0,37,0.8512121020888365,61301407,11174247803,223786,223786,44108,267894,491036818.10001504,3710003.299999486,164314,0,37,0.7154844826685138,9562516598,-1940,-1940,49061939.81665158,4522.583333846647,-1566,0,0,0.13572761942032263,-9501215191,2434.5661310849264,2194.22492068322,240.34121040170658,0.7336079983411916,0.734246110123064,-1566
1822,2021-12-28,2021,236925,236925,541609539.4666662,3892718.0833333307,171017,0,40,0.8437986704653373,61457675,11196611878,238746,238746,51746,290492,492591671.98335034,3887405.266666023,172605,0,40,0.6978333310383631,9593745583,-1821,-1821,49017867.483315885,5312.816667307634,-1588,0,0,0.1459653394269742,-9532287908,2285.9957347965233,2063.245759021514,222.74997577500926,0.7218191410784003,0.722964992083637,-1588
1823,2021-12-29,2021,232248,232248,542936331.9833333,3824217.1166666625,167394,0,48,0.8431202852123595,61077422,11217825608,233996,233996,60296,294292,494039900.09999955,3818336.2833334752,168855,0,48,0.6746258817772891,9617451847,-1748,-1748,48896431.8833338,5880.833333187271,-1461,0,0,0.16849440343507038,-9556374425,2337.743842716981,2111.317715260088,226.42612745689303,0.7207553994006407,0.7216148993999898,-1461
1824,2021-12-30,2021,227029,227029,543857790.016666,3746173.0833333326,164891,0,42,0.8518735491941564,61311715,11240701361,228837,228837,64784,293621,495038305.18333703,3740763.466666987,166369,0,44,0.6679529052758459,9645334534,-1808,-1808,48819484.83332902,5409.616666345391,-1478,0,-2,0.18392064391831042,-9584022819,2395.5432566617746,2163.279125243457,232.26413141831745,0.7262992833514661,0.727019669022055,-1478
1825,2021-12-31,2021,228004,228004,544675897.3166667,3792639.466666669,165003,0,35,0.8522087331801197,61821170,11261810141,229723,229723,61449,291172,495998226.64999586,3787266.200000319,166516,0,36,0.6778708117538732,9670172468,-1719,-1719,48677670.66667086,5373.266666349955,-1513,0,-1,0.1743379214262465,-9608351298,2388.8874638895227,2159.114353591046,229.7731102984767,0.7236846721987333,0.7248555869460176,-1513
1826,2022-01-01,2022,225584,225584,545712362.4500005,3817554.8166666636,164795,0,38,0.8621001489467334,61119269,11285127494,227320,227320,58032,285352,497127631.78333914,3811862.9833335886,166357,0,30,0.6919734222994737,9694756477,-1736,-1736,48584730.66666138,5691.8333330750465,-1562,0,8,0.1701267266472597,-9633637208,2419.1093448560205,2186.906703252416,232.20264160360466,0.730526101141925,0.7318185817349991,-1562
1827,2022-01-02,2022,224366,224366,543747212.0666658,3763827.0666666706,161237,0,51,0.8495003699312722,59392151,11286210387,226145,226145,59514,285659,495377210.3666674,3758498.166666912,163073,0,35,0.67893537399487,9720808700,-1779,-1779,48370001.69999838,5328.899999758694,-1836,0,16,0.17056499593640218,-9661416549,2423.4831127116663,2190.529131162163,232.95398154950317,0.7186338393517735,0.7210992947003029,-1836
1828,2022-01-03,2022,232728,232728,542616928.8333333,3819406.1833333285,166797,0,49,0.840655185452546,59026831,11281691458,234420,234420,57074,291494,494385303.8166603,3813507.0000002366,168248,0,35,0.6804050855249141,9729547961,-1692,-1692,48231625.01667297,5899.1833330919035,-1451,0,14,0.16025009992763195,-9670521130,2331.5498299875103,2108.9723735886882,222.57745639882205,0.7167036196761886,0.7177203310297756,-1451
1829,2022-01-04,2022,233515,233515,543939420.8333333,3831788.5833333284,168487,0,83,0.8454745947797792,59704289,11304591240,235401,235401,59978,295379,495796413.4499976,3825598.8833334683,170098,0,83,0.6794084887551215,9721994767,-1886,-1886,48143007.38333565,6189.699999860022,-1611,0,0,0.16606610602465766,-9662290478,2329.355376885139,2106.178025794273,223.17735109086607,0.7215253838083207,0.7225882642809504,-1611
1830,2022-01-05,2022,230956,230956,544737774.2333335,3755086.1666666623,165837,0,60,0.8417101092848851,60073026,11328813216,232730,232730,63226,295956,496661360.70000553,3749617.6166668325,167314,0,60,0.6669842814472512,9751372122,-1774,-1774,48076413.53332794,5468.549999829847,-1477,0,0,0.1747258278376339,-9691299096,2358.621444055723,2134.066775662809,224.55466839291375,0.718045861549386,0.7189189189189189,-1477
1831,2022-01-06,2022,224568,224568,544879714.0166667,3734940.116666668,162735,0,56,0.8489811549285737,59954223,11343078604,226244,226244,66119,292363,496894674.03335005,3729255.349999261,164107,0,35,0.6617834678122837,9776856475,-1676,-1676,47985039.9833166,5684.766667407006,-1372,0,21,0.18719768711629003,-9716902252,2426.3462025607682,2196.2777975696595,230.06840499110876,0.7246580100459549,0.7253540425381446,-1372
1832,2022-01-07,2022,228026,228026,545910129.9166671,3774511.4666666663,165422,0,40,0.8553366721338791,59815917,11368441200,229751,229751,61217,290968,498008968.7333275,3769330.0833335523,166925,0,41,0.6803462923758035,9799342551,-1725,-1725,47901161.183339596,5181.383333113976,-1503,0,-1,0.17499037975807563,-9739526634,2394.069667128604,2167.603051709579,226.46661541902495,0.7254523606957102,0.7265474361373835,-1503
1833,2022-01-08,2022,229198,229198,546885309.633333,3797701.2833333337,166237,0,91,0.8604918018481829,59309082,11384012712,230985,230985,60730,291715,499093864.5000019,3792080.616666873,167749,0,91,0.6856589479457665,9824887836,-1787,-1787,47791445.13333106,5620.666666460689,-1512,0,0,0.17483285390241632,-9765578754,2386.0823813180436,2160.7198064809486,225.36257483709505,0.7252986500754806,0.7262333051929779,-1512
1834,2022-01-09,2022,224414,224414,547819142.2333333,3779987.366666665,164009,0,63,0.8640949316887538,58891853,11406604136,226116,226116,59685,285801,500145957.98333967,3773635.8333334527,165524,0,65,0.6894867407741719,9849166033,-1702,-1702,47673184.24999368,6351.533333212137,-1515,0,-2,0.1746081909145819,-9790274180,2441.1094772756305,2211.899900862122,229.20957641350833,0.7308323010150882,0.73203134674238,-1515
1835,2022-01-10,2022,223699,223699,548704660.0833327,3693064.716666664,162788,0,56,0.8534995686167566,59028420,11430887499,225154,225154,60038,285192,501230132.23333466,3687827.250000138,164073,0,56,0.6780274341496358,9875704865,-1455,-1455,47474527.849998,5237.466666526161,-1285,0,0,0.17547213446712073,-9816676445,2452.8704199988942,2226.1657897853675,226.7046302135268,0.7277100031739078,0.7287145686952041,-1285
1836,2022-01-11,2022,211481,211481,548551163.5000006,3602222.73333333,155042,0,37,0.8549420515318158,59656216,11449563255,213756,213756,63721,277477,501252315.1833553,3597114.7333327048,156420,0,37,0.6605556496574357,9904798534,-2275,-2275,47298848.316645324,5108.000000625383,-1378,0,0,0.19438640187438005,-9845142318,2593.8555402140173,2344.9742471947234,248.88129301929393,0.7331249615804729,0.7317689328018863,-1378
1837,2022-01-12,2022,221558,221558,549253428.4833333,3676531.133333329,162013,0,46,0.8583982523763525,59458341,11469433211,224472,224472,58069,282541,502078825.1666681,3671688.250000137,163627,0,46,0.6835326554376279,9928651742,-2914,-2914,47174603.31666523,4842.883333192207,-1614,0,0,0.1748655969387246,-9869193401,2479.050309550246,2236.710258592021,242.34005095822477,0.731244188880564,0.728941694287038,-1614
1838,2022-01-13,2022,226077,226077,550170814.1999997,3712750.699999999,163893,0,48,0.8498874277347988,61128091,11483346298,227608,227608,59112,286720,502987841.56666464,3707624.43333267,165215,0,48,0.6787423270089342,9952185574,-1531,-1531,47182972.633335054,5126.266667328775,-1322,0,0,0.17114510072586453,-9891057483,2433.55500205682,2209.886478360447,223.66852369637263,0.7249432715402274,0.7258751889213033,-1322
1839,2022-01-14,2022,235543,235543,551089625.866667,3816725.0999999954,170978,0,54,0.8561111983799138,60961540,11506498664,237255,237255,60707,297962,504029611.2499984,3810996.100000033,172467,0,45,0.6867486458004813,9973959054,-1712,-1712,47060014.61666864,5728.999999962281,-1489,0,9,0.16936255257943245,-9912997514,2339.656138652675,2124.4214505489804,215.23468810369468,0.7258886912368442,0.7269267244104445,-1489
1840,2022-01-15,2022,231035,231035,551501692.3333328,3764669.949999998,167656,0,95,0.856943753111,60944806,11517479845,232558,232558,63823,296381,504495754.7333353,3759038.216666948,168983,0,95,0.6767809002601433,9993560133,-1523,-1523,47005937.59999746,5631.733333049808,-1327,0,0,0.18016285285085676,-9932615327,2387.0915330289035,2169.33304695317,217.75848607573334,0.7256735992382106,0.7266273359764016,-1327
1841,2022-01-16,2022,221146,221146,551960986.9666672,3667858.649999998,161184,0,54,0.8573024155987453,59500975,11532800158,222600,222600,69384,291984,505023649.5000218,3661825.849999381,162489,0,55,0.6581079785193821,10011195093,-1454,-1454,46937337.46664536,6032.800000616815,-1305,0,-1,0.19919443707936324,-9951694118,2495.9121438627294,2268.749548517618,227.16259534511119,0.7288578586092446,0.7299595687331536,-1305
1842,2022-01-17,2022,219358,219358,552733607.4000005,3682240.5833333414,160874,0,121,0.8577485206830844,59198131,11558597002,220859,220859,63219,284078,505871487.43333334,3677229.183333489,162108,0,121,0.6705552700314736,10030029209,-1501,-1501,46862119.966667116,5011.399999852292,-1234,0,0,0.18719325065161074,-9970831078,2519.7786604546013,2290.4725975999772,229.3060628546241,0.7333856070897802,0.733988653394247,-1234
1843,2022-01-18,2022,220549,220549,553677280.7166663,3600548.2999999993,160507,0,67,0.8522641227119607,58722859,11579824741,222126,222126,54968,277094,506865110.3499989,3596253.783333005,161815,0,67,0.6873660201953239,10056791391,-1577,-1577,46812170.36666745,4294.51666699443,-1308,0,0,0.16489810251663684,-9998068532,2510.45019799077,2281.8810510701082,228.56914692066175,0.727761177788156,0.7284829331100366,-1308
1844,2022-01-19,2022,216812,216812,554005026.8499999,3458479.3333333354,156867,0,191,0.8480942014279654,56471192,11595423290,218147,218147,62437,280584,507246679.81666845,3452872.6000001444,157867,0,191,0.6628104239728473,10075829236,-1335,-1335,46758347.033331454,5606.733333190903,-1000,0,0,0.18528377745511815,-10019358044,2555.232306560522,2325.251687241486,229.98061931903612,0.7235162260391491,0.7236725694142023,-1000
1845,2022-01-20,2022,222108,222108,555250210.05,3702708.666666665,163008,0,121,0.8565337583517919,58670046,11617676217,223625,223625,54602,278227,508572198.91666913,3697530.966666812,164319,0,122,0.6930204473325638,10096596515,-1517,-1517,46678011.13333082,5177.699999853037,-1311,0,-1,0.16351331101922806,-10037926469,2499.9108994273056,2274.218888392036,225.6920110352694,0.7339132314009401,0.7347970933482393,-1311
1846,2022-01-21,2022,219747,219747,555791918.7166669,3647108.900000001,160102,0,35,0.8502186605505421,58623344,11634082861,221244,221244,58118,279362,509228607.4333398,3642238.8666667566,161486,0,37,0.6791224289631255,10123540428,-1497,-1497,46563311.28332716,4870.033333244268,-1384,0,-2,0.1710962315874166,-10064917084,2529.2355241103037,2301.6606436031702,227.57488050713346,0.7285742239939567,0.7299000198875449,-1384
1847,2022-01-22,2022,221708,221708,556134718.7833338,3644879.9833333297,163043,0,43,0.8570146318581191,59228841,11650226129,223159,223159,59878,283037,509652625.06666875,3640168.7833336345,164392,0,36,0.6808367810568995,10142422036,-1451,-1451,46482093.71666503,4711.199999695178,-1349,0,7,0.17617785080121962,-10083193195,2508.410696877577,2283.8094142143887,224.60128266318816,0.7353952045032205,0.7366586156059133,-1349
1848,2022-01-23,2022,214368,214368,556244991.3000009,3561373.6000000015,158305,0,40,0.8607254814151368,58703310,11662673791,215763,215763,61473,277236,509838592.40000606,3556186.9500002177,159625,0,40,0.6753199440188198,10162113054,-1395,-1395,46406398.89999485,5186.64999978384,-1320,0,0,0.18540553739631704,-10103409744,2594.813550996422,2362.9565421319044,231.8570088645174,0.738473092998955,0.7398163725940036,-1320
1849,2022-01-24,2022,212147,212147,556956258.2333326,3564634.3833333342,157207,0,40,0.8614639848784095,58813815,11692699994,213552,213552,60803,274355,510580576.6166711,3558275.1666667173,158470,0,40,0.6754897851324061,10181850281,-1405,-1405,46375681.61666155,6359.216666616965,-1263,0,0,0.18597419974600338,-10123036466,2625.3317663381176,2390.8957847113165,234.4359816268011,0.7410286263769933,0.7420675058065482,-1263
1850,2022-01-25,2022,211532,211532,557229598.9999998,3549250.599999996,155749,0,36,0.855270124614716,59113235,11706156520,213046,213046,55021,268067,510993176.03333575,3543979.4333332907,157024,0,36,0.6838924597208986,10206449912,-1514,-1514,46236422.966664016,5271.166666705161,-1275,0,0,0.17137766489381734,-10147336677,2634.2567507516583,2398.511007169042,235.74574358261634,0.7362904903277045,0.7370427043924787,-1275
1851,2022-01-26,2022,207425,207425,557843408.5166668,3488118.849999997,154476,0,43,0.8647993250572495,59941484,11731859747,208758,208758,54327,263085,511660174.86667246,3483697.1333333934,155568,0,43,0.6900165345800788,10229843483,-1333,-1333,46183233.64999431,4421.716666603461,-1092,0,0,0.1747827904771707,-10169901999,2689.3740316580297,2450.972776452507,238.40125520552283,0.7447318307822104,0.7452073692984221,-1092
1852,2022-01-27,2022,196988,196988,558038892.3000002,3389052.4666666654,148700,0,41,0.8764036388003331,59664393,11757105435,198194,198194,55615,253809,511943063.65000623,3384618.4166664053,149731,0,41,0.6876509501239213,10254310808,-1206,-1206,46095828.649993956,4434.050000260118,-1031,0,0,0.18875268867641182,-10194646415,2832.857292322376,2583.040170994108,249.81712132826806,0.7548683168517879,0.7554769569209966,-1031
1853,2022-01-28,2022,188275,188275,557816970.5166664,3303710.7166666677,142767,0,47,0.8744814765635377,58882798,11775132696,189260,189260,52348,241608,511814840.2333329,3299552.2833329993,143648,0,47,0.6886609714909985,10283380201,-985,-985,46002130.28333354,4158.433333668392,-881,0,0,0.18582050507253922,-10224497403,2962.777694949762,2704.2948337384173,258.4828612113447,0.7582897357588634,0.7589982035295361,-881
1854,2022-01-29,2022,181852,181852,557934764.3500003,3253207.616666664,139156,0,60,0.8829102786881651,59692797,11795190005,182669,182669,47411,230080,511991189.65000194,3249006.183333057,139938,0,61,0.7035465924895657,10306295695,-817,-817,45943574.69999832,4201.433333606925,-782,0,-1,0.17936368619859933,-10246602898,3068.07054280404,2802.835673540677,265.2348692633632,0.7652156698854014,0.7660741559870585,-782
1855,2022-01-30,2022,177784,177784,558098620.3499997,3190930.433333337,135893,0,69,0.8797923322683703,58943356,11813206569,178691,178691,43356,222047,512231082.5999998,3187587.716666594,136674,0,69,0.7107098947520116,10327064142,-907,-907,45867537.74999988,3342.7166667426936,-781,0,0,0.16908243751635865,-10268120786,3139.1948676483803,2866.574604205023,272.6202634433571,0.7643713720019799,0.7648622482385794,-781
1856,2022-01-31,2022,178763,178763,558568459.2166663,3205437.450000001,136948,0,102,0.8810548044058333,59710941,11834809976,179927,179927,41077,221004,512812651.4333359,3201640.3499999624,137874,0,102,0.7209190783877244,10349608983,-1164,-1164,45755807.78333044,3797.100000038743,-926,0,0,0.16013572601810888,-10289898042,3124.63126718989,2850.115054624019,274.5162125658708,0.7660869419286989,0.7662774347374213,-926
1857,2022-02-01,2022,178001,178001,558978814.2333333,3208821.449999997,136986,0,92,0.886337717203836,59019358,11853726802,179003,179003,39436,218439,513343344.7999971,3204838.1666666223,137794,0,90,0.7288396302857945,10370421794,-1002,-1002,45635469.43333626,3983.283333374653,-808,0,2,0.15749808691804157,-10311402436,3140.3127748345983,2867.7918515331985,272.52092330139976,0.7695799461800776,0.7697859812405379,-808
1858,2022-02-02,2022,182442,182442,560037417.1999999,3246679.5833333377,139274,0,63,0.8793644007410575,59571255,11880399101,183596,183596,38137,221733,514441994.4833347,3242655.9666665867,140155,0,63,0.7303107791803711,10394321625,-1154,-1154,45595422.71666521,4023.6166667509824,-881,0,0,0.14905362156068636,-10334750370,3069.673743984389,2802.0326939766373,267.6410500077518,0.763387816401925,0.7633880912438179,-881
1859,2022-02-03,2022,184255,184255,561000329.7500004,3282449.9000000004,140794,0,49,0.8777943610756822,60484655,11901640122,185323,185323,40191,225514,515435511.78333163,3278936.899999942,141661,0,49,0.7239151449577447,10424126884,-1068,-1068,45564817.966668725,3513.0000000582077,-867,0,0,0.15387921611793753,-10363642229,3044.695285066893,2781.2819336149946,263.4133514518985,0.7641258039130553,0.7644005331232496,-867
1860,2022-02-04,2022,186599,186599,561767191.1166667,3267899.716666662,141812,0,49,0.8722822737528078,59862305,11921919051,187541,187541,40594,228135,516319269.3833314,3263526.4833333646,142652,0,49,0.7198457053937451,10447436112,-942,-942,45447921.73333526,4373.2333332975395,-840,0,0,0.1524365683590626,-10387573807,3010.5584226960846,2753.1007586785367,257.4576640175478,0.7599826365628969,0.7606443391045158,-840
1861,2022-02-05,2022,182713,182713,562381892.1499999,3233224.4666666663,138384,0,85,0.871213323627766,58838518,11942677890,183896,183896,45109,229005,516980663.3833461,3228173.1666663922,139459,0,87,0.7027051811095704,10466896084,-1183,-1183,45401228.766653776,5051.300000274088,-1075,0,-2,0.16850814251819568,-10408057566,3077.9522647540125,2811.2664951023735,266.685769651639,0.7573845320256358,0.7583579849480141,-1075
1862,2022-02-06,2022,186729,186729,562827090.7333335,3269260.0666666655,140493,0,102,0.8678566264479532,59139202,11960063940,187936,187936,43526,231462,517532703.10000247,3264048.350000047,141629,0,106,0.7082847292428038,10488683877,-1207,-1207,45294387.633331,5211.716666618362,-1136,0,-4,0.15957189720514942,-10429544675,3014.138621924465,2753.7709810786782,260.3676408457868,0.7523898269684944,0.7536022901413247,-1136
1863,2022-02-07,2022,195119,195119,563920212.1166662,3360143.8833333342,145825,0,218,0.8637805646810403,59675323,11986643534,196470,196470,42145,238615,518698598.91666996,3354559.1333333305,147020,0,218,0.7153238480397253,10516455960,-1351,-1351,45221613.19999623,5584.750000003725,-1195,0,0,0.148456716641315,-10456780637,2890.13480038677,2640.090593559678,250.04420682709224,0.747364428886987,0.7483076296635619,-1195
1864,2022-02-08,2022,200355,200355,564817778.2666669,3397664.7833333323,148376,0,55,0.8549923885103936,59221599,12003117103,201446,201446,46374,247820,519762920.0333305,3393155.366666481,149353,0,50,0.6986925994673508,10539138857,-1091,-1091,45054858.23333639,4509.416666851379,-977,0,5,0.15629978904304276,-10479917258,2819.0850154309446,2580.160043055362,238.92497237558246,0.7405654962441666,0.7414046444208373,-977
1865,2022-02-09,2022,212578,212578,565987372.4500002,3525729.9833333325,157087,0,73,0.8572523967673042,59876935,12027791483,214173,214173,48453,262626,520954959.81666785,3520354.5500000212,158307,0,39,0.7026075102998126,10561543979,-1595,-1595,45032412.63333231,5375.43333331123,-1220,0,34,0.15464488646749164,-10501667044,2662.492696563145,2432.402589573232,230.09010698991278,0.7389616987646888,0.7391547954223922,-1220
1866,2022-02-10,2022,221219,221219,567457896.8333333,3654584.166666662,163387,0,39,0.8554102495716923,61215622,12053306427,222927,222927,50985,273912,522513589.4999947,3649516.8833335224,164685,0,41,0.6993377435088765,10590683408,-1708,-1708,44944307.33333856,5067.283333139494,-1298,0,-2,0.15607250606281586,-10529467786,2565.1408641813464,2343.877545115642,221.2633190657043,0.7385758004511367,0.7387395873985655,-1298
1867,2022-02-11,2022,222109,222109,568496855.9499996,3693379.6000000006,164070,0,42,0.8583623356099935,61410428,12071380890,223920,223920,57505,281425,523658162.54999936,3689097.350000064,165532,0,42,0.6861046459980483,10616497832,-1811,-1811,44838693.400000215,4282.24999993667,-1462,0,0,0.1722576896119452,-10555087404,2559.5399373730897,2338.594866693459,220.9450706796306,0.7386913632495756,0.7392461593426224,-1462
1868,2022-02-12,2022,218665,218665,569424173.1999999,3648821.6333333356,161151,0,68,0.857096471771888,61691103,12094133778,220537,220537,58463,279000,524679736.7666803,3643097.949999318,162692,0,69,0.6819354838709766,10642187378,-1872,-1872,44744436.43331963,5723.683334017638,-1541,0,-1,0.1751609879009114,-10580496275,2604.093811080877,2379.1007258041973,224.99308527667972,0.736976653785471,0.7377084117404336,-1541
1869,2022-02-13,2022,206916,206916,570228342.3666672,3526408.1166666695,151801,0,58,0.8571014324653476,60427250,12121044142,208432,208432,59858,268290,525558652.01666474,3521176.750000309,153183,0,53,0.6711767117671138,10664355082,-1516,-1516,44669690.35000241,5231.366666360293,-1382,0,5,0.18592472069823385,-10603927832,2755.844605379319,2521.4873532694824,234.35725210983674,0.7336358715614065,0.7349303369924004,-1382
1870,2022-02-14,2022,211722,211722,571345003.733333,3550609.1833333336,155893,0,56,0.8563871491861962,61068241,12149702945,213255,213255,55308,268563,526717723.80000633,3545277.683333327,157218,0,56,0.6848076615170227,10699274421,-1533,-1533,44627279.93332666,5331.500000006519,-1325,0,0,0.17157948766917352,-10638206180,2698.562283245638,2469.8962453401155,228.66603790552244,0.7363098780476285,0.7372300766687768,-1325
1871,2022-02-15,2022,214077,214077,572099427.3333336,3580935.350000002,159195,0,50,0.8663237993805962,61266545,12169684719,215748,215748,51941,267689,527560973.21666867,3575528.7500001197,160576,0,50,0.7019899958533939,10724536267,-1671,-1671,44538454.116664946,5406.599999882281,-1381,0,0,0.16433380352720228,-10663269722,2672.4002453945714,2445.2647218823286,227.1355235122428,0.743634299808013,0.7442757290913473,-1381
1872,2022-02-16,2022,212687,212687,573142578.0833334,3590525.133333336,159040,0,71,0.8679044793522871,61475397,12195997649,214142,214142,54621,268763,528658983.70000565,3585319.6500000744,160288,0,71,0.6948649925771113,10751427596,-1455,-1455,44483594.38332772,5205.483333261684,-1248,0,0,0.17303948677517578,-10689952199,2694.770146192919,2468.7309528257215,226.03919336719764,0.7477654957754822,0.7485126691634523,-1248
1873,2022-02-17,2022,214828,214828,574043064.2499995,3613148.5333333295,159009,0,48,0.8609166402889761,60093837,12215947655,216101,216101,55467,271568,529596448.30000126,3607152.9000000907,160109,0,48,0.6889766099098674,10778362923,-1273,-1273,44446615.94999826,5995.633333238773,-1100,0,0,0.17194003037910865,-10718269086,2672.1054250377024,2450.6894845465836,221.41594049111882,0.740168879289478,0.7408989315181327,-1100
1874,2022-02-18,2022,213816,213816,574836323.3833337,3595218.349999998,158791,0,76,0.8613433980618866,61666731,12237410340,215070,215070,55636,270706,530403758.5499993,3590417.066666727,159903,0,76,0.6872843601545472,10801570712,-1254,-1254,44432564.83333439,4801.283333271276,-1112,0,0,0.17405903790733945,-10739903981,2688.462619183474,2466.1912798158705,222.27133936760356,0.7426525610805552,0.74349281629237,-1112
1875,2022-02-19,2022,207264,207264,575235212.5333335,3524077.9833333357,155470,0,66,0.8685975374401725,61906138,12251326200,208448,208448,58967,267415,530857734.2666683,3519344.6333330106,156514,0,66,0.6800329076529198,10825955124,-1184,-1184,44377478.26666522,4733.350000325125,-1044,0,0,0.18856462978725275,-10764048986,2775.374462199579,2546.7154123170685,228.65904988251032,0.7501061448201328,0.7508539299969297,-1044
1876,2022-02-20,2022,201177,201177,575979441.3000001,3494165.083333337,151022,0,32,0.8675792958439591,60506166,12275736592,202244,202244,55902,258146,531679297.8666633,3489171.6499997163,152039,0,32,0.6828151511160445,10840432751,-1067,-1067,44300143.433336794,4993.433333620895,-1017,0,0,0.18476414472791458,-10779926585,2863.0481680311373,2628.9002287665558,234.1479392645815,0.7506921765410559,0.7517602499950555,-1017
1877,2022-02-21,2022,210577,210577,576970302.683333,3567415.099999994,156957,0,31,0.8618652559396321,60402008,12295346650,211919,211919,49633,261552,532768635.2333351,3563147.0666668154,158153,0,31,0.7022504129197924,10865693226,-1342,-1342,44201667.44999796,4268.03333317861,-1196,0,0,0.15961484301983975,-10805291218,2739.949294953072,2514.020145590226,225.9291493628457,0.7453663030625377,0.7462898560298982,-1196
1878,2022-02-22,2022,210936,210936,577782903.3999997,3580105.033333337,157432,0,35,0.8624985777676634,61284409,12315380133,212492,212492,50918,263410,533783331.9333285,3575402.383333441,158741,0,35,0.6999772218215163,10889151231,-1556,-1556,43999571.46667123,4702.649999896064,-1309,0,0,0.16252135594614703,-10827866822,2739.1384277695593,2512.0161320582824,227.12229571127682,0.7463496036712557,0.7470445946200328,-1309
1879,2022-02-23,2022,213690,213690,578540344.2166669,3600992.5333333346,160232,0,43,0.8690439421592022,63065826,12334845313,215105,215105,52696,267801,534643918.8333369,3596092.0333328424,161436,0,43,0.7021108957770915,10907905018,-1415,-1415,43896425.38333005,4900.500000492204,-1204,0,0,0.1669330463821107,-10844839192,2707.38146013696,2485.502051711196,221.8794084257638,0.7498338714960925,0.7504985937100486,-1204
1880,2022-02-24,2022,221935,221935,579415272.6666671,3677999.4999999977,162426,0,43,0.8473381846035996,63099775,12357999211,223440,223440,54656,278096,535564984.4166685,3672453.566666054,163708,0,43,0.6840803175881713,10934321955,-1505,-1505,43850288.24999863,5545.933333943598,-1282,0,0,0.16325786701542822,-10871222180,2610.7431124728732,2396.9073774466005,213.8357350262727,0.7318629328406966,0.7326709631220909,-1282
1881,2022-02-25,2022,233524,233524,580203390.4666668,3766668.0166666685,172954,0,36,0.8564944074270741,63168931,12379017443,234954,234954,55768,290722,536400529.6166653,3761923.1666671014,174165,0,35,0.6957299413184943,10960832905,-1430,-1430,43802860.850001514,4744.849999567028,-1211,0,1,0.16076446610857975,-10897663974,2484.5557221813037,2283.002330739912,201.5533914413918,0.7406262311368425,0.7412727597742537,-1211
1882,2022-02-26,2022,232787,232787,580999558.6500003,3812102.9333333313,172671,0,38,0.8634245039456672,62912632,12395445709,234092,234092,63505,297597,537275195.9166706,3807114.9499994344,173920,0,38,0.6828193832598994,10982502401,-1305,-1305,43724362.73332977,4987.983333896846,-1249,0,0,0.18060512068576773,-10919589769,2495.8419441377755,2295.1454809078077,200.69646322996778,0.7417553385713119,0.7429557609828614,-1249
1883,2022-02-27,2022,232875,232875,581950217.7166668,3831759.883333333,172288,0,49,0.8619130434782608,63195463,12415727073,234297,234297,63070,297367,538269798.1666632,3826402.8666670336,173526,0,33,0.6824429072492774,11003059826,-1422,-1422,43680419.55000365,5357.016666299198,-1238,0,16,0.17947013622898345,-10939864363,2498.981074467705,2297.382374365285,201.59870010242003,0.7398303811057434,0.7406240796937221,-1238
1884,2022-02-28,2022,244084,244084,583344771.3500004,3919507.5833333265,180131,0,75,0.8669597351731372,63587535,12444211453,245452,245452,62295,307747,539744001.966669,3913970.4666669415,181360,0,75,0.6947362606296874,11029100833,-1368,-1368,43600769.38333142,5537.116666384973,-1229,0,0,0.17222347454344977,-10965513298,2389.9344952967026,2198.9798492848663,190.9546460118363,0.7379877419249111,0.738881736551342,-1229
1885,2022-03-01,2022,239384,239384,583842134.1000005,3866906.6333333356,177469,0,42,0.8601953346923784,63618043,12451770286,240872,240872,68017,308889,540337239.7000006,3861409.56666693,178727,0,42,0.6736076713641441,11049065746,-1488,-1488,43504894.39999986,5497.066666405648,-1258,0,0,0.1865876633282343,-10985447703,2438.9354931825037,2243.254673436517,195.6808197459868,0.7413569829228353,0.741999900362018,-1258
1886,2022-03-02,2022,249928,249928,584330615.5333326,3941735.4333333345,186647,0,48,0.8677939246503003,64448697,12462776966,251407,251407,66829,318236,540932328.5833335,3936426.133333567,188050,0,40,0.6894883042773329,11073317691,-1479,-1479,43398286.949999094,5309.299999767449,-1403,0,8,0.17830562037296738,-11008868994,2337.9958049251486,2151.6199969902727,186.37580793487587,0.7468030792868346,0.7479903105323241,-1403
1887,2022-03-03,2022,247866,247866,585195665.5999993,3983665.183333333,183112,0,48,0.8596297999725651,64384598,12480002689,249587,249587,74271,323858,541962385.600003,3978054.6500003194,184596,0,36,0.6662333491839131,11085725479,-1721,-1721,43233279.999996305,5610.5333330137655,-1484,0,12,0.19339645078865197,-11021340881,2360.9356087563415,2171.436755920793,189.4988528355484,0.7387540041796777,0.7396058288292259,-1484
1888,2022-03-04,2022,238612,238612,585681609.3333325,3898912.316666666,178236,0,55,0.8705723098586821,63440414,12491971288,242373,242373,69609,311982,542538978.0333245,3894014.533333371,180512,0,59,0.6767057073805511,11103617347,-3761,-3761,43142631.30000806,4897.783333295025,-2276,0,-4,0.19386660247813092,-11040176933,2454.5354354908072,2238.4464360028737,216.0889994879335,0.7469699763633011,0.744769425637344,-2276
1889,2022-03-05,2022,229891,229891,585708558.749999,3814685.016666667,172235,0,52,0.8629654923420227,62145425,12503408510,236324,236324,70401,306725,542576059.6166571,3815031.0666669067,175208,0,52,0.6607025837476577,11111861399,-6433,-6433,43132499.13334191,-346.0500002396293,-2973,0,0,0.20226290859436502,-11049715974,2547.766370801811,2295.899102996975,251.8672678048356,0.7492028831054717,0.7413889406069634,-2973
1890,2022-03-06,2022,226316,226316,585722817.9333334,3777766.5833333326,170332,0,98,0.8703715159334736,63644745,12513734240,227896,227896,68414,296310,540998831.7166646,3772645.2166667455,171743,0,98,0.6735749721575428,11059830578,-1580,-1580,44723986.216668844,5121.36666658707,-1411,0,0,0.1967965437759308,-10996185833,2588.0751601006264,2373.8847181024,214.19044199822656,0.7526290673217978,0.7536025204479236,-1411
1891,2022-03-07,2022,238577,238577,586935509.3166668,3885511.6333333324,183354,0,74,0.8867242022491694,64999455,12543835612,240311,240311,60785,301096,542234105.3666661,3880113.2166670267,184872,0,75,0.7114043361585763,11073983148,-1734,-1734,44701403.95000076,5398.416666305624,-1518,0,-1,0.17531986609059302,-11008983693,2460.1512690522004,2256.384873629031,203.76639542316934,0.7685317528512807,0.7693031113848305,-1518
1892,2022-03-08,2022,239277,239277,588189714.5833325,3948544.466666663,179495,0,64,0.8656703318747727,64839860,12570030248,241116,241116,63415,304531,543588766.7500037,3943283.9666669215,181091,0,64,0.6896801967615733,11101002821,-1839,-1839,44600947.83332884,5260.499999741558,-1596,0,0,0.1759901351131994,-11036162961,2458.1957922547194,2254.4699097115235,203.7258825431959,0.7501556773112334,0.7510534348612287,-1596
1893,2022-03-09,2022,244216,244216,589424595.733333,3987334.9166666674,181859,0,44,0.8604841615618959,65935564,12600366698,245990,245990,62300,308290,544820318.1333321,3980965.483333718,183398,0,33,0.6909954912582369,11132612935,-1774,-1774,44604277.60000086,6369.433332949411,-1539,0,11,0.169488670303659,-11066677371,2413.537998056364,2214.8067731750566,198.7312248813073,0.7446645592426376,0.7455506321395179,-1539
1894,2022-03-10,2022,241205,241205,590187475.383333,3957002.1166666658,179473,0,47,0.861764888787546,64623199,12614506972,242996,242996,67704,310700,545635305.6499957,3951507.8833334954,181161,0,36,0.6788027035725777,11160020815,-1791,-1791,44552169.73333728,5494.233333170414,-1688,0,11,0.18296218521496832,-11095397616,2446.8293583604527,2245.449742588338,201.3796157721149,0.7440683236251322,0.7455307906302985,-1688
1895,2022-03-11,2022,243926,243926,591120298.1833335,4002583.366666667,183026,0,52,0.8778195026360461,65360241,12635498119,245344,245344,65186,310530,546661475.9833345,3996996.2000003005,184467,0,34,0.6993720413486757,11179618087,-1418,-1418,44458822.199998975,5587.166666366626,-1441,0,18,0.17844746128737043,-11114257846,2423.35912606009,2228.142836113109,195.2162899469813,0.7503341177242279,0.751870842572062,-1441
1896,2022-03-12,2022,236584,236584,591430979.5000006,3937343.816666668,177625,0,51,0.8742264903797387,64248008,12650784013,238747,238747,67102,305849,547075906.083334,3932865.86666675,179366,0,38,0.6876432487927051,11206352278,-2163,-2163,44355073.41666663,4477.949999917764,-1741,0,13,0.18658324158703354,-11142104270,2499.877335322763,2291.4462007201514,208.43113460261156,0.7507904169343658,0.7512806443641177,-1741
1897,2022-03-13,2022,235802,235802,592380424.4999999,3892745.6166666737,177079,0,39,0.8731054019898057,64788521,12677655921,237071,237071,65868,302939,547998421.9499973,3886771.516666926,178359,0,36,0.6883795087459749,11226385712,-1269,-1269,44382002.550002575,5974.099999747705,-1280,0,3,0.18472589324383082,-11161597191,2512.1942328733426,2311.5371426703277,200.65709020301483,0.7509647924953987,0.752344234427661,-1280
1898,2022-03-14,2022,241678,241678,593597495.5166668,3933157.7666666647,180622,0,62,0.868750982712534,65320022,12708944563,243504,243504,65326,308830,549246336.9000078,3927943.2166668437,182301,0,62,0.691050092283786,11257244753,-1826,-1826,44351158.616658926,5214.549999821,-1679,0,0,0.17770089042874804,-11191924731,2456.1503137094264,2255.5947208259736,200.55559288345285,0.7473663304065741,0.748657106248768,-1679
1899,2022-03-15,2022,240232,240232,594398146.7000002,3943146.749999996,179731,0,39,0.8666289253721406,66220066,12725441365,242050,242050,65603,307653,550179389.7499999,3937492.000000345,181306,0,32,0.6861691581099489,11280982563,-1818,-1818,44218756.950000286,5654.749999650754,-1575,0,7,0.1804597672621917,-11214762497,2474.267153002099,2272.998924808923,201.26822819317567,0.7481559492490593,0.749043586035943,-1575
1900,2022-03-16,2022,235283,235283,594686833.9166667,3821769.9499999997,174232,0,35,0.8616007106335775,64801759,12740842850,236938,236938,68571,305509,550573808.30001,3816818.866666781,175650,0,31,0.6725333787220604,11302993357,-1655,-1655,44113025.61665678,4951.083333218936,-1418,0,4,0.18906733191151703,-11238191598,2527.538470338557,2323.704126395977,203.8343439425803,0.7405209896167594,0.7413331757675004,-1418
1901,2022-03-17,2022,222412,222412,594455151.8833327,3682338.6999999983,164657,0,31,0.859423052712983,62829533,12758737109,224058,224058,70864,294922,550363805.7999986,3677458.933332996,166032,0,31,0.6568177348587232,11322931277,-1646,-1646,44091346.08333409,4879.766667002346,-1375,0,0,0.20260531785425984,-11260101744,2672.765641617056,2456.345257924281,216.42038369277498,0.7403242630793303,0.7410224138392738,-1375
1902,2022-03-18,2022,226098,226098,594652677.2833333,3713315.66666667,167748,0,31,0.8604764305743527,63447585,12773888793,227421,227421,64706,292127,550553302.1000026,3708147.5666668955,168902,0,31,0.6740527236441649,11345863985,-1323,-1323,44099375.183330655,5168.099999774247,-1154,0,0,0.18642370693018784,-11282416400,2630.066065526158,2420.855163331454,209.21090219470398,0.7419260674574742,0.742684272780438,-1154
1903,2022-03-19,2022,223446,223446,594698167.8999994,3738099.3833333347,168177,0,34,0.8695926532585048,64075061,12785871797,225004,225004,64209,289213,550692874.2333468,3732543.566666388,169634,0,34,0.6824520336222692,11363818177,-1558,-1558,44005293.66665256,5555.816666946746,-1457,0,0,0.18714061963623552,-11299743116,2661.484957886914,2447.480374719324,214.00458316758977,0.7526516473778899,0.7539154859469165,-1457
1904,2022-03-20,2022,223836,223836,595573787.5499997,3768482.0333333346,169589,0,33,0.8733000947122007,64512283,12811192686,225465,225465,60123,285588,551584762.1166844,3762568.6833330924,171036,0,31,0.6949416642155708,11376314524,-1629,-1629,43989025.43331528,5913.350000242237,-1447,0,2,0.17835843049662992,-11311802241,2660.7596077038534,2446.4318724266936,214.32773527715972,0.757648456905949,0.7585922426984233,-1447
1905,2022-03-21,2022,228699,228699,596306798.2000004,3784814.9166666754,171254,0,40,0.8618140000612161,65482929,12834907702,230275,230275,60824,291099,552391191.466682,3779682.883333022,172706,0,40,0.6867697930944244,11406045665,-1576,-1576,43915606.73331845,5132.033333653584,-1452,0,0,0.17504420696679168,-11340562736,2607.3869942588312,2398.8326629754943,208.55433128333698,0.7488183157775067,0.7499989143415482,-1452
1906,2022-03-22,2022,227833,227833,596816039.4500002,3794802.85,170712,0,32,0.8604504176304586,63634111,12853196342,229182,229182,63384,292566,552978405.2833374,3789932.550000244,171986,0,32,0.6787938448076585,11422728537,-1349,-1349,43837634.16666281,4870.299999756273,-1274,0,0,0.18165657282280012,-11359094426,2619.5329010722776,2412.835236987797,206.6976640844805,0.7492856609885311,0.7504341527694147,-1274
1907,2022-03-23,2022,231397,231397,597678603.6333326,3846071.033333332,174816,0,42,0.8703829349559418,65917669,12871163509,232757,232757,61083,293840,553886289.750009,3841191.2666663574,176104,0,42,0.6944970051728901,11448457180,-1360,-1360,43792313.88332367,4879.766666974407,-1288,0,0,0.17588592978305162,-11382539511,2582.914228072674,2379.676184819399,203.238043253275,0.7554808402874713,0.7566002311423502,-1288
1908,2022-03-24,2022,233401,233401,598665977.4999992,3836674.300000004,175875,0,49,0.8716372252046906,65877388,12894248777,235289,235289,61051,296340,554999087.2000008,3831523.266666302,177476,0,39,0.696736856313684,11469862064,-1888,-1888,43666890.2999984,5151.033333702013,-1601,0,10,0.17490036889100657,-11403984676,2564.967491570298,2358.7974244439847,206.17006712631337,0.7535314758719971,0.754289405794576,-1601
1909,2022-03-25,2022,228678,228678,599047656.2666668,3750634.8666666695,170865,0,59,0.866261730468169,64635932,12911391969,230134,230134,68015,298149,555459348.6333454,3745503.5499997437,172153,0,60,0.6736195660558911,11492634865,-1456,-1456,43588307.633321404,5131.316666925792,-1288,0,-1,0.19264216441227788,-11427998933,2619.6121020240985,2413.6344418180074,205.97766020609106,0.7471859995277202,0.7480554807199284,-1288
1910,2022-03-26,2022,228092,228092,599582278.4,3769407.7333333385,171962,0,42,0.8758001157427698,64913073,12928720711,229542,229542,67974,297516,556036650.4833423,3764574.08333306,173292,0,35,0.681499482380773,11513808338,-1450,-1450,43545627.916657686,4833.650000278372,-1330,0,7,0.19430063336199688,-11448895265,2628.6861371727196,2422.3743388283724,206.31179834434715,0.7539150868947617,0.7549468071202655,-1330
1911,2022-03-27,2022,228703,228703,600500322.4666672,3817349.450000001,173888,0,47,0.8813570438516333,65560770,12954690480,230244,230244,63522,293766,556972594.3166562,3813040.916666802,175232,0,47,0.6950838422417752,11534136879,-1541,-1541,43527728.15001094,4308.533333199099,-1344,0,0,0.18627320160985805,-11468576109,2625.677505177751,2419.0536748695135,206.6238303082373,0.7603223394533521,0.7610708639530237,-1344
1912,2022-03-28,2022,236937,236937,601933644.0999995,3904575.2833333393,176133,0,57,0.8629129262208943,64196413,12984546912,238191,238191,61850,300041,558430945.6999961,3899199.566666884,177339,0,57,0.6892924633633359,11563258320,-1254,-1254,43502698.40000343,5375.716666455381,-1206,0,0,0.1736204628575584,-11499061907,2540.47972287992,2344.467027301603,196.01269557831665,0.7433748211549905,0.7445243523055027,-1206
1913,2022-03-29,2022,240885,240885,603001910.6500006,3963681.3999999976,180347,0,50,0.8737530356809259,64655884,13006361893,242413,242413,62389,304802,559507495.0333327,3958946.5333335632,181647,0,53,0.699001318888995,11587286042,-1528,-1528,43494415.61666787,4734.866666434333,-1300,0,-3,0.1747517167919309,-11522630158,2503.277126637194,2308.0754540116773,195.20167262551695,0.7486850571849638,0.7493286251149897,-1300
1914,2022-03-30,2022,238260,238260,604021101.5999998,3928761.7666666685,178474,0,37,0.8750356753126834,65442056,13029352166,239718,239718,64060,303778,560617349.833327,3923497.2666669893,179798,0,37,0.6945565511656594,11610818241,-1458,-1458,43403751.76667273,5264.499999679159,-1324,0,0,0.18047912414702405,-11545376185,2535.1343137748668,2338.6535422176353,196.4807715572315,0.7490724418702258,0.7500396298984641,-1324
1915,2022-03-31,2022,230719,230719,604593140.6666672,3851985.8833333277,174408,0,75,0.8851460001126908,65327617,13046655425,232036,232036,66878,298914,561188766.5000114,3846936.066666385,175551,0,75,0.6906836079942624,11634781309,-1317,-1317,43404374.16665578,5049.8166669425555,-1143,0,0,0.19446239211842842,-11569453692,2620.4739993960934,2418.5418060129095,201.93219338318386,0.7559325413164932,0.756567946353152,-1143
1916,2022-04-01,2022,229342,229342,604955499.566667,3855554.0166666685,174384,0,58,0.8890957609160126,64347086,13063459518,230706,230706,62855,293561,561585620.0499997,3850778.8333330806,175615,0,58,0.7028624374491417,11656238720,-1364,-1364,43369879.51666725,4775.183333587833,-1231,0,0,0.18623332346687094,-11591891634,2637.7876689253035,2434.204658959887,203.5830099654163,0.7603666140523759,0.7612069040250362,-1231
1917,2022-04-02,2022,230645,230645,605241078.0166674,3912376.466666665,176451,0,43,0.9032322400225457,65263024,13068429958,232267,232267,58350,290617,562009501.5500021,3907223.93333302,177912,0,42,0.7267228001114683,11674831425,-1622,-1622,43231576.46666527,5152.533333644737,-1461,0,1,0.17650943991107737,-11609568401,2624.123991487643,2419.6700415900755,204.45394989756733,0.7650328426803096,0.7659805310267924,-1461
1918,2022-04-03,2022,234539,234539,606218131.1499994,3935217.7166666673,178338,0,42,0.8936040487935896,65572346,13088239769,236097,236097,57070,293167,563084512.0500178,3930470.549999728,179816,0,42,0.7245597219332334,11692395223,-1558,-1558,43133619.09998155,4747.166666939389,-1478,0,0,0.1690443268603562,-11626822877,2584.7220767121858,2384.9710587174673,199.7510179947185,0.7603767390497955,0.7616191650042143,-1478
1919,2022-04-04,2022,240471,240471,607267319.0333338,3969907.6333333324,179762,0,50,0.8718057478864386,65778107,13115069178,241966,241966,60928,302894,564164526.6499995,3964953.7333336426,181082,0,50,0.7009845028293833,11715127220,-1495,-1495,43102792.38333428,4953.899999689776,-1320,0,0,0.17082124505705532,-11649349113,2525.3245465496207,2331.5859527784874,193.7385937711333,0.7475412835643384,0.7483778712711703,-1320
1920,2022-04-05,2022,248873,248873,608126766.3833331,4078197.183333335,186960,0,47,0.8815379731831099,66504346,13132679251,250569,250569,61546,312115,565069823.7000064,4073022.3833335675,188405,0,47,0.7110552200310786,11738334066,-1696,-1696,43056942.68332672,5174.799999767449,-1445,0,0,0.17048275315203132,-11671829720,2443.522464804672,2255.146581181257,188.37588362341512,0.7512265291936048,0.7519086558991734,-1445
1921,2022-04-06,2022,250128,250128,608967618.9166671,4102762.666666663,187855,0,42,0.8813887289707671,67156020,13156708369,251920,251920,65138,317058,565983370.0166637,4097163.816666958,189428,0,42,0.705230588725089,11762435560,-1792,-1792,42984248.90000343,5598.849999704864,-1573,0,0,0.1761581402456781,-11695279540,2434.6239482051874,2246.678985458335,187.94496274685253,0.7510354698394422,0.7519371228961576,-1573
1922,2022-04-07,2022,250812,250812,609907311.916668,4061615.050000004,185921,0,59,0.8636070044495479,67122867,13179096717,252630,252630,66897,319527,566961710.7666622,4055754.95000009,187637,0,59,0.6880545306030429,11786844193,-1818,-1818,42945601.15000582,5860.099999913946,-1716,0,0,0.17555247384650496,-11719721326,2431.7309854260084,2244.237464935527,187.4935204904814,0.7412763344656556,0.7427344337568776,-1716
1923,2022-04-08,2022,248743,248743,610544898.2999983,4025125.483333333,186558,0,44,0.8744205867099776,66294402,13202358855,250381,250381,71557,321938,567614578.8000028,4019373.416666828,188015,0,44,0.684737433915852,11808263288,-1638,-1638,42930319.49999547,5752.066666504834,-1457,0,0,0.18968315279412562,-11741968886,2454.520924407916,2267.00340201534,187.5175223925762,0.7500030151602256,0.7509156046185613,-1457
1924,2022-04-09,2022,249923,249923,611356570.0999998,4069684.049999998,187840,0,40,0.8789467155884025,66637590,13227830692,251796,251796,69633,321429,568516229.7833389,4063839.116666772,189593,0,34,0.693792408276779,11832843621,-1873,-1873,42840340.31666088,5844.933333226014,-1753,0,6,0.18515430731162352,-11766206031,2446.1797037487536,2257.844563787109,188.33513996164447,0.7515914901789751,0.7529627158493384,-1753
1925,2022-04-10,2022,248511,248511,612365966.4000012,4030200.7333333343,186880,0,37,0.8813372446290101,66587605,13252577533,250422,250422,68833,319255,569541110.19999,4024444.750000357,188525,0,34,0.69664061643514,11861068648,-1911,-1911,42824856.200011134,5755.9833329771645,-1645,0,3,0.18469662819387012,-11794481043,2464.140285138288,2274.325379559264,189.81490557902407,0.7519989054810451,0.7528292242694332,-1645
1926,2022-04-11,2022,253031,253031,613775384.5666678,4089822.9166666623,192247,0,38,0.8896261722871895,66372547,13285233676,254980,254980,69891,324871,571000430.2833384,4084124.6000002734,193850,0,38,0.7023803294230628,11893526670,-1949,-1949,42774954.28332937,5698.316666388884,-1603,0,0,0.1872458428641267,-11827154123,2425.6924430866884,2239.393012327784,186.29943075890424,0.7597764700767891,0.7602557063299082,-1603
1927,2022-04-12,2022,253273,253273,614524248.8499998,4065047.5666666697,190026,0,56,0.8825417632357175,65978315,13305997228,255033,255033,69747,324780,571761205.7833327,4059600.749999904,191452,0,56,0.6966069339245098,11921311738,-1760,-1760,42763043.06666708,5446.816666765604,-1426,0,0,0.18593482931120775,-11855333423,2426.3314638749484,2241.9106773763892,184.4207864985592,0.7502813169978639,0.7506950080969914,-1426
1928,2022-04-13,2022,249064,249064,615027286.550002,4007924.2833333337,185824,0,48,0.8828333279799561,65616139,13324596900,250769,250769,71705,322474,572376422.3999957,4002200.7166668256,187278,0,48,0.6904091492647392,11944470310,-1705,-1705,42650864.150006294,5723.5666665080935,-1454,0,0,0.1924241787152169,-11878854171,2469.3544091077074,2282.4847664583567,186.86964264935068,0.7460893585584428,0.7468147976823292,-1454
1929,2022-04-14,2022,246313,246313,615524239.4166669,3971402.366666665,185678,0,75,0.8860068287098116,66601322,13352661743,248001,248001,73133,321134,572889879.0333449,3965809.8999997415,187174,0,75,0.6883575080807395,11971034771,-1688,-1688,42634360.383322,5592.46666692337,-1496,0,0,0.19764932062907214,-11904433449,2498.951494304673,2310.03052017268,188.9209741319928,0.753829477128694,0.7547308276982754,-1496
1930,2022-04-15,2022,243392,243392,615507917.8500005,3951257.299999996,184783,0,56,0.8841416316066261,67673457,13365342157,244695,244695,71135,315830,572980765.9333266,3946331.3166663377,185936,0,56,0.688430484754466,11997944280,-1303,-1303,42527151.9166739,4925.983333658427,-1153,0,0,0.19571114685216007,-11930270823,2528.874892560152,2341.6120718990032,187.2628206611489,0.7591991519852748,0.759868407609473,-1153
1931,2022-04-16,2022,245250,245250,616188201.1833322,3998247.0833333344,186928,0,59,0.8914006116207962,68177856,13389186952,247062,247062,67188,314250,573685606.0166669,3993072.9666663944,188610,0,60,0.7050596658711259,12015752140,-1812,-1812,42502595.166665316,5174.116666940041,-1682,0,-1,0.1863409457496703,-11947574284,2512.490116955483,2322.030931574531,190.45918538095157,0.7621936799184506,0.7634116132792579,-1682
1932,2022-04-17,2022,244252,244252,616964105.1833335,3996455.4833333283,182441,0,55,0.8701873474935717,67669360,13409521873,245941,245941,66899,312840,574553025.399992,3991094.9666663916,184012,0,55,0.6889336401994494,12039218139,-1689,-1689,42411079.78334153,5360.516666936688,-1571,0,0,0.18125370729412238,-11971548779,2525.9326645568244,2336.1416982121405,189.79096634468397,0.7469375890473773,0.7481957054740771,-1571
1933,2022-04-18,2022,256460,256460,618403444.133333,4153171.133333328,194357,0,69,0.8886376043047652,69143902,13438030804,258388,258388,64602,322990,576056863.4666564,4148438.3499995726,196019,0,69,0.7148951979937564,12067952204,-1928,-1928,42346580.66667652,4732.783333755564,-1662,0,0,0.1737424063110088,-11998808302,2411.305638826066,2229.4257607422032,181.87987808386288,0.7578452780160649,0.7586226914562596,-1662
1934,2022-04-19,2022,256826,256826,619327648.6999998,4158818.4333333336,192501,0,70,0.8806117760662862,68175176,13462837893,259431,259431,71531,330962,577010268.9333237,4154592.7333335206,194527,0,70,0.6934089109928072,12097879345,-2605,-2605,42317379.76667607,4225.69999981299,-2026,0,0,0.18720286507347894,-12029704169,2411.467875915989,2224.1377049516973,187.33017096429194,0.7495385981170131,0.7498217252371536,-2026
1935,2022-04-20,2022,262100,262100,620052591.7499999,4170593.3500000015,196516,0,57,0.8772987409385732,68787802,13479878269,263820,263820,73042,336862,577049328.4833285,4165349.8833334697,197996,0,57,0.6903895363680046,12105403124,-1720,-1720,43003263.26667142,5243.466666531749,-1480,0,0,0.1869092045705686,-12036615322,2365.7100028615027,2187.284241086076,178.42576177542696,0.7497748950782144,0.7504965506784929,-1480
1936,2022-04-21,2022,263781,263781,620577092.4000002,4195357.033333334,197390,0,116,0.8742858659266585,68128988,13497607105,265531,265531,75686,341217,577618920.5999889,4189654.9333336437,198863,0,116,0.6836470633057657,12114811884,-1750,-1750,42958171.80001128,5702.099999690428,-1473,0,0,0.19063880262089272,-12046682896,2352.6224117734037,2175.335160866298,177.28725090710577,0.748310151223932,0.7489257374845122,-1473
1937,2022-04-22,2022,266734,266734,621457129.8500006,4238067.683333335,203287,0,70,0.8948428021924459,68570465,13518013652,268505,268505,78427,346932,578619330.0833302,4232532.733333656,204842,0,71,0.6962661270796543,12134498502,-1771,-1771,42837799.766670465,5534.949999679811,-1555,0,-1,0.19857667511279165,-12065928037,2329.8759432618285,2154.9666862193635,174.90925704246501,0.7621338112126688,0.762898270050837,-1555
1938,2022-04-23,2022,262868,262868,621836492.083333,4180040.583333338,198804,0,45,0.8836336107856412,65549404,13533392840,264575,264575,78227,342802,579055491.1499977,4173747.733333571,200330,0,45,0.6854423253073243,12154173432,-1707,-1707,42781000.933335304,6292.8499997672625,-1526,0,0,0.19819128547831688,-12088624028,2365.584597909723,2188.625120098262,176.95947781146106,0.7562883272212669,0.7571766039875272,-1526
1939,2022-04-24,2022,257547,257547,613145219.8000002,4138301.7833333337,196388,0,79,0.8954715061716887,67434529,13330402851,261668,261667,76906,338574,571046317.3833336,4133016.1500002877,198434,0,67,0.6906436997524854,11965967877,-4121,-4120,42098902.41666663,5285.633333045989,-2046,0,12,0.20482780641920328,-11898533348,2380.711946945607,2182.3398341530783,198.3721127925287,0.7625326639409505,0.7583426326490056,-2046
1940,2022-04-25,2022,257288,257288,614355777.8166672,4147363.7166666645,195334,0,47,0.8918177295482106,68022298,13361165110,267522,267522,77473,344995,571817558.0166606,4172204.883333601,200305,0,47,0.6825200365222553,11971335703,-10234,-10234,42538219.80000663,-24841.166666936595,-4971,0,0,0.20929769302595524,-11903313405,2387.8135700719317,2137.4599398055507,250.35363026638106,0.7592036939149902,0.7487421595233289,-4971
1941,2022-04-26,2022,263390,263390,614957298.8666668,4194922.183333332,202297,0,36,0.9057671134059753,68699171,13376738173,268278,268278,79641,347919,571507228.5666668,4189699.2000001115,205358,0,38,0.698102144464678,11961256101,-4888,-4888,43450070.29999995,5222.98333322024,-3061,0,-2,0.20766496894129727,-11892556930,2334.778461090652,2130.279890884332,204.49857020631998,0.7680511788602452,0.7654671646575567,-3061
1942,2022-04-27,2022,266543,266543,616157388.3333333,4268206.749999998,202647,0,37,0.8972698588970636,69063521,13405393880,268559,268559,75615,344174,571000799.633341,4262912.800000439,204293,0,37,0.7031646783312981,11888034073,-2016,-2016,45156588.6999923,5293.949999558739,-1646,0,0,0.19410518056576542,-11818970552,2311.6622396136204,2126.1651988328113,185.49704078080913,0.7602788293070911,0.7607006281673673,-1646
1943,2022-04-28,2022,262862,262862,617121908.3166667,4219881.816666664,199629,0,49,0.8893792179927104,68823225,13431884759,264729,264729,75581,340310,571999015.7166705,4214137.916667094,201114,0,49,0.6941994064235543,11915978400,-1867,-1867,45122892.59999621,5743.89999956917,-1485,0,0,0.1951798115691561,-11847155175,2347.703008866503,2160.6964696601826,187.0065392063202,0.7594441189673669,0.7596976530716317,-1485
1944,2022-04-29,2022,253455,253455,617217402.4833333,4109249.8333333293,193510,0,38,0.8888323371012604,68414037,13447450791,255148,255148,79752,334900,572199398.8333482,4103842.816666599,195010,0,38,0.6807644072857485,11944009068,-1693,-1693,45018003.649985194,5407.0166667304,-1500,0,0,0.20806792981551192,-11875595031,2435.21493946986,2242.6176134374878,192.59732603237217,0.7634885877177409,0.76430150344114,-1500
1945,2022-04-30,2022,247962,247962,617175678.9833338,4042742.7999999975,191498,0,35,0.8899670110742763,69392220,13467774251,249585,249585,73419,323004,572240066.8000072,4037674.8166663754,192989,0,35,0.691452737427404,11962662545,-1623,-1623,44935612.1833266,5067.983333622105,-1491,0,0,0.19851427364687235,-11893270325,2488.992986761414,2292.766259190285,196.22672757112923,0.7722876892427065,0.7732395776989803,-1491
1946,2022-05-01,2022,233912,233912,616327642.1833326,3885873.733333335,180558,0,46,0.8813186155477268,69198732,13487379801,235022,235022,75299,310321,571504172.983326,3881412.0499997535,181630,0,46,0.6707667222005532,11984954592,-1110,-1110,44823469.200006604,4461.6833335813135,-1072,0,0,0.2105518933471736,-11915755860,2634.869703919989,2431.7050020139645,203.16470190602467,0.7719056739286569,0.7728212677962063,-1072
1947,2022-05-02,2022,231869,231869,616607796.2666672,3870362.150000003,178603,0,39,0.8760075732417871,69399320,13515601606,233127,233127,68140,301267,571792377.6666646,3866201.366666381,179679,0,40,0.6806122144144533,12011662881,-1258,-1258,44815418.60000265,4160.783333622385,-1076,0,-1,0.19539535882733383,-11942263561,2659.2938092917434,2452.7076557698792,206.58615352186416,0.770275457262506,0.7707344065680938,-1076
1948,2022-05-03,2022,233333,233333,617134348.8166671,3882000.5333333253,178268,0,33,0.8665383807691147,67903548,13543860880,234526,234526,62251,296777,572324077.2333275,3877878.099999701,179249,0,36,0.687735235547222,12034359098,-1193,-1193,44810271.58333957,4122.433333624154,-981,0,-3,0.17880314522189267,-11966455550,2644.865273307535,2440.3438306768867,204.52144263064838,0.7640068057240081,0.7643033181822058,-981
1949,2022-05-04,2022,238526,238526,618139665.7666667,3942872.533333336,183550,0,32,0.8722235731115264,68835344,13567214663,239798,239798,63415,303213,573322025.050001,3938549.149999716,184583,0,33,0.6924142434526157,12065441217,-1272,-1272,44817640.716665626,4323.38333362015,-1033,0,-1,0.17980932965891072,-11996605873,2591.4980579335866,2390.8540732199644,200.6439847136221,0.7695177884171956,0.7697437009482981,-1033
1950,2022-05-05,2022,239120,239120,618636884.0666679,3961244.1499999985,185575,0,49,0.88321763131482,68642586,13583188332,240231,240231,64415,304646,573883745.0833244,3957236.0666664983,186522,0,49,0.6990342889780339,12091104439,-1111,-1111,44753138.98334348,4008.0833335001953,-947,0,0,0.18418334233678613,-12022461853,2587.1398631091834,2388.8829713206223,198.256891788561,0.7760747741719639,0.7764276883499631,-947
1951,2022-05-06,2022,240401,240401,619186618.1666664,3963971.9666666677,185139,0,48,0.8783865291741718,67887980,13600402908,241433,241433,64761,306194,574480880.250007,3959189.9833331164,186078,0,48,0.694954832557133,12113252228,-1032,-1032,44705737.916659355,4781.983333551325,-939,0,0,0.18343169661703884,-12045364248,2575.6407758980467,2379.462957632167,196.17781826587952,0.7701257482290007,0.770723140581445,-939
1952,2022-05-07,2022,237794,237794,619464284.0500003,3974044.2833333365,184782,0,36,0.8850307408933779,69432345,13614356701,238838,238838,67112,305950,574827736.8500041,3969527.6833330565,185657,0,37,0.6928713842130919,12127826502,-1044,-1044,44636547.19999623,4516.600000279956,-875,0,-1,0.19215935668028594,-12058394157,2605.0458970789855,2406.7683402557554,198.27755682323004,0.7770675458590208,0.7773344275199089,-875
1953,2022-05-08,2022,235975,235975,620227657.3833328,3926786.7166666654,182975,0,30,0.8827545290814702,69257213,13635995004,236972,236972,65946,302918,575632232.1833322,3922522.783333013,183823,0,31,0.692718821595291,12149726255,-997,-997,44595425.200000644,4263.93333365256,-848,0,-1,0.19003570748617926,-12080469042,2628.3617221457057,2429.114967942762,199.24675420294352,0.7753999364339442,0.775716118359975,-848
1954,2022-05-09,2022,237152,237152,621120478.4833341,3960630.0000000023,183018,0,57,0.8827713871272438,69684375,13659722120,238192,238192,65889,304081,576598502.2999922,3956356.666666435,183913,0,57,0.6938447321601725,12175316392,-1040,-1040,44521976.18334186,4273.3333335672505,-895,0,0,0.18892665496707128,-12105632017,2619.0817639460515,2420.7299250184396,198.35183892761188,0.7717328970449332,0.7721208101027742,-895
1955,2022-05-10,2022,241414,241414,621969176.3499993,3999551.9999999986,183193,0,38,0.878652439377998,69513132,13679624017,242579,242579,61872,304451,577556679.45001,3995115.6499998523,184178,0,38,0.7023888901662434,12197525600,-1165,-1165,44412496.89998937,4436.350000146311,-985,0,0,0.17626354921175458,-12128012468,2576.3591852585155,2380.9013948033835,195.457790455132,0.7588333733751977,0.7592495640595435,-985
1956,2022-05-11,2022,240534,240534,622939349.4166654,4017531.1166666644,184442,0,30,0.8820249943874875,68841507,13700904982,241648,241648,63965,305613,578572823.5499908,4013100.999999814,185378,0,30,0.70020908796419,12220431724,-1114,-1114,44366525.86667466,4430.116666850168,-936,0,0,0.18181590642329748,-12151590217,2589.818276903329,2394.2793797175677,195.53889718576147,0.7668021984418003,0.767140634311064,-936
1957,2022-05-12,2022,239936,239936,623659512.4833331,3983219.1833333424,182661,0,69,0.872616030941584,69330023,13724700186,240938,240938,63950,304888,579252602.5499971,3978055.9833330708,183545,0,69,0.6922476450368577,12249715937,-1002,-1002,44406909.93333602,5163.200000271667,-884,0,0,0.18036838590472637,-12180385914,2599.274441865052,2404.1562665498886,195.11817531516317,0.7612905108028808,0.7617934904415243,-884
1958,2022-05-13,2022,239655,239655,624252059.4833329,3939265.9666666654,184626,0,166,0.8796895537334921,69652716,13739183716,240229,240229,65299,305528,579922201.8500023,3931917.9999997383,185257,0,169,0.6946302793852136,12267442977,-574,-574,44329857.63333058,7347.9666669270955,-631,0,-3,0.1850592743482785,-12197790261,2604.794640142425,2414.0391120555896,190.7555280868355,0.7703824247355574,0.7711683435388733,-631
1959,2022-05-14,2022,234907,234907,624352972.3500001,3947880.533333331,184388,0,121,0.8887772607883125,70151573,13757071393,235931,235931,66858,302789,580182957.7166761,3943722.1666663624,185315,0,124,0.6954149589318028,12287795673,-1024,-1024,44170014.63332403,4158.366666968446,-927,0,-3,0.1933623018565097,-12217644100,2657.872998037522,2459.1213435990867,198.75165443843525,0.7849404232313213,0.785462698839915,-927
1960,2022-05-15,2022,233953,233953,625017906.866666,3917729.3833333356,183624,0,34,0.8898582193859448,69919070,13776763556,235001,235001,63511,298512,580909299.8499926,3913489.266666471,184568,0,34,0.7038142520233698,12309870201,-1048,-1048,44108607.01667333,4240.116666864604,-944,0,0,0.186043967362575,-12239951131,2671.553290048283,2471.9439485363578,199.60934151192532,0.7848755946707244,0.7853924025855209,-944
1961,2022-05-16,2022,236961,236961,625899423.2500001,3969122.683333329,183023,0,61,0.8802123556197022,70139486,13804642539,237948,237948,66189,304137,581756329.0166591,3964988.066666476,183941,0,61,0.6914811417223058,12336429735,-987,-987,44143094.23334098,4134.616666852962,-918,0,0,0.18873121389739644,-12266290249,2641.3604907558633,2444.8885009189366,196.4719898369267,0.7723760450031861,0.773030241901592,-918
1962,2022-05-17,2022,242086,242086,626774956.3500001,3994436.833333335,185721,0,33,0.8759862197731392,71656703,13816238421,243184,243184,61438,304622,582814606.8833306,3989975.3666664185,186587,0,33,0.7017122860463333,12359846478,-1098,-1098,43960349.46666956,4461.466666916385,-866,0,0,0.17427393372680589,-12288189775,2589.059079624597,2396.5993111525863,192.45976847201064,0.7671695182703667,0.7672667609711166,-866
1963,2022-05-18,2022,241492,241492,627470348.1666673,3993862.016666668,185042,0,42,0.8690267172411501,70611373,13838780814,242397,242397,67469,309866,583611495.2166666,3989861.8333330657,185869,0,33,0.6821916570388499,12379149104,-905,-905,43858852.95000076,4000.1833336022682,-827,0,9,0.18683506020230023,-12308537731,2598.3069756624127,2407.6679794579413,190.63899620447137,0.766244844549716,0.7667957936773145,-827
1964,2022-05-19,2022,246855,246855,628276077.2333329,4048187.0666666646,189045,0,52,0.8707135767960951,69289343,13859782938,247879,247879,65512,313391,584469661.100019,4044054.566666407,189948,0,52,0.6903197602994441,12401334157,-1024,-1024,43806416.133313894,4132.500000257511,-903,0,0,0.18039381649665098,-12332044814,2545.121942975969,2357.8829231198247,187.2390198561443,0.7658139393571125,0.766293231778408,-903
1965,2022-05-20,2022,251200,251200,628503713.8166676,4068989.283333333,191781,0,77,0.8678742038216546,67990071,13871211824,251917,251917,68319,320236,584796461.0499982,4064544.5166665083,192524,0,76,0.6853445583881864,12423985128,-717,-717,43707252.76666939,4444.766666824929,-743,0,1,0.18252964543346817,-12355995057,2502.005230161893,2321.3854604889634,180.61976967292958,0.7634593949044586,0.7642358395820846,-743
1966,2022-05-21,2022,249106,249106,628543904.9999996,4066691.6000000015,191576,0,55,0.8731503857795482,68581488,13873741450,250040,250040,71578,321618,584965656.3166525,4062054.066666387,192555,0,56,0.6822565901162236,12438107457,-934,-934,43578248.683347106,4637.533333614469,-979,0,-1,0.19089379566332454,-12369525969,2523.198578115339,2339.488307137468,183.710270977871,0.7690541375960435,0.7700967845144777,-979
1967,2022-05-22,2022,247831,247831,629317469.2666662,4012054.683333335,190186,0,49,0.8702583615447617,68723415,13887032435,249199,249199,71303,320502,585787934.2833376,4007639.983333131,191333,0,49,0.6793530149577901,12448187719,-1368,-1368,43529534.98332858,4414.700000204146,-1147,0,0,0.19090534658697156,-12379464304,2539.3008512521283,2350.6833265114933,188.61752474063496,0.7674019795747908,0.7677920055858972,-1147
1968,2022-05-23,2022,245518,245518,630304035.0666674,4021531.100000001,186642,0,40,0.8622219144828491,67518729,13914196384,246591,246591,75536,322127,586791116.0500026,4018373.349999781,187565,0,41,0.6622046584111315,12466865629,-1073,-1073,43512919.01666486,3157.750000219792,-923,0,-1,0.2000172560717176,-12399346900,2567.2416485417257,2379.6128652302905,187.6287833114352,0.7601968083806483,0.7606319776471971,-923
1969,2022-05-24,2022,245255,245255,631134816.2333333,4020460.650000004,186784,0,54,0.8700006116083264,66868995,13933373588,246273,246273,69350,315623,587650956.9500036,4015760.4999996945,187699,0,55,0.6810530284548237,12489969443,-1018,-1018,43483859.283329725,4700.150000309572,-915,0,-1,0.18894758315350269,-12423100448,2573.382056363105,2386.1769538276776,187.2051025354276,0.7615909971254409,0.7621582552695586,-915
1970,2022-05-25,2022,248772,248772,631765128.2833335,4080394.999999996,191248,0,52,0.8765455919476471,67553265,13941516496,249760,249760,67183,316943,588347778.0833383,4076142.61666635,192145,0,53,0.6931814237891271,12507747103,-988,-988,43417350.19999528,4252.383333645761,-897,0,-1,0.18336416815852008,-12440193838,2539.5347076171497,2355.652538770573,183.88216884657686,0.7687681893460678,0.7693185458039719,-897
1971,2022-05-26,2022,255380,255380,632724122.1333337,4132180.9500000025,194773,0,55,0.8649189443182711,68674439,13960679275,256426,256426,67862,324288,589308620.4833326,4127610.3666663994,195711,0,55,0.6858934033945108,12525716510,-1046,-1046,43415501.65000105,4570.583333603106,-938,0,0,0.17902554092376033,-12457042071,2477.578988696584,2298.1625127067173,179.41647598986674,0.7626791448038217,0.7632260379212716,-938
1972,2022-05-27,2022,257989,257989,633563848.9666666,4153167.500000001,195873,0,54,0.864544612367193,69654519,13983971472,259116,259116,71305,330421,589971917.0833242,4148064.4166668397,196902,0,54,0.6806256260951864,12542861956,-1127,-1127,43591931.883342385,5103.083333161194,-1029,0,0,0.18391898627200665,-12473207437,2455.778536940205,2276.8640959389777,178.91444100122726,0.759230044691828,0.759899041355995,-1029
1973,2022-05-28,2022,253136,253136,633990507.7333332,4144117.383333336,195639,0,47,0.8802027368687186,69330873,14000117456,254250,254250,74961,329211,590446436.6166717,4139037.583332972,196700,0,48,0.6826989377633269,12567495354,-1114,-1114,43544071.11666155,5079.800000363961,-1061,0,-1,0.19750379910539173,-12498164481,2504.545018224722,2322.306535365474,182.23848285924805,0.7728612287466026,0.7736479842674533,-1061
1974,2022-05-29,2022,250701,250701,634626483.0666658,4099285.599999999,193874,0,49,0.877539379579658,68028440,14020396024,251617,251617,72012,323629,591075099.6833354,4094554.7166663045,194709,0,49,0.6842155678261134,12587410350,-916,-916,43551383.383330345,4730.883333694655,-835,0,0,0.19332381175354463,-12519381910,2531.407864614285,2349.106378676065,182.30148593821968,0.7733275894392124,0.7738308619846831,-835
1975,2022-05-30,2022,253458,253458,635667982.4333328,4116248.8500000015,192794,0,38,0.8665064823363232,67278282,14045468537,254587,254587,72847,327434,592059003.033328,4111638.3166664424,193909,0,38,0.6769119883701832,12607582829,-1129,-1129,43608979.400004745,4610.533333559055,-1115,0,0,0.18959449396614003,-12540304547,2507.9815292211442,2325.566517667155,182.4150115539892,0.7606546252239029,0.7616610431797382,-1115
1976,2022-05-31,2022,253948,253948,636599660.3499992,4110504.550000001,191751,0,57,0.8649093515207845,68574310,14066852150,255235,255235,70054,325289,593075800.5333372,4105798.933333013,192818,0,57,0.6807915422900842,12631210395,-1287,-1287,43523859.816661954,4705.616666988004,-1067,0,0,0.1841178092307003,-12562636085,2506.8110808118167,2323.6460537674584,183.16502704435834,0.755079780112464,0.755452817991263,-1067
1977,2022-06-01,2022,251465,251465,637398721.8666661,4095908.199999996,193423,0,43,0.8753424929910733,68813032,14084643788,252775,252775,71846,324621,593905133.6499921,4090917.8833331284,194548,0,43,0.6847954999830644,12658278879,-1310,-1310,43493588.21667397,4990.316666867584,-1125,0,0,0.1905469930080088,-12589465847,2534.741303428573,2349.5406335673706,185.2006698612022,0.7691845783707474,0.769648897240629,-1125
1978,2022-06-02,2022,251166,251166,638084129.4666666,4126700.466666669,193585,0,43,0.8797687585103083,68480645,14100967177,252403,252403,70015,322418,594690194.6833532,4121826.4333330663,194700,0,43,0.6920333232015696,12679006221,-1237,-1237,43393934.78331339,4874.033333602827,-1115,0,0,0.1877354353087387,-12610525576,2540.4876833117005,2356.1138127651143,184.3738705465862,0.7707452441811392,0.7713854431207237,-1115
1979,2022-06-03,2022,257939,257939,638905096.0333335,4128453.9499999965,196522,0,46,0.8639639604712754,68702379,14119034788,259223,259223,68884,328107,595558960.0500041,4123640.8999997484,197590,0,43,0.6858860066990365,12692008264,-1284,-1284,43346135.983329415,4813.050000248011,-1068,0,3,0.1780779537722389,-12623305885,2476.9619795119524,2297.4773073762904,179.4846721356621,0.7618933158615021,0.7622394617761541,-1068
1980,2022-06-04,2022,251434,251434,639088240.9499995,4098183.2666666657,193545,0,53,0.8767549337002954,67521012,14133196533,252474,252474,75289,327763,595753231.2833391,4093289.48333308,194597,0,53,0.6784780466373584,12710206832,-1040,-1040,43335009.66666031,4893.783333585598,-1052,0,0,0.198276887062937,-12642685820,2541.773351853765,2359.6617128232574,182.11163903050738,0.7697646300818505,0.770760553561951,-1052
1981,2022-06-05,2022,248481,248481,639801418.5833342,4045686.9666666603,191540,0,43,0.883890518792181,68113673,14156360238,249545,249545,72015,321560,596463710.366681,4040855.8833331303,192554,0,45,0.689037815648701,12729301132,-1064,-1064,43337708.21665323,4831.083333529998,-1014,0,-2,0.1948527031434799,-12661187459,2574.850465763315,2390.2050145932835,184.64545117003127,0.7708436459930538,0.7716203490352441,-1014
1982,2022-06-06,2022,247997,247997,640752530.7000002,4022483.6166666676,190655,0,37,0.8761517276418661,66891034,14181211372,249091,249091,74249,323340,597412723.6833428,4017768.4666663324,191614,0,37,0.6772623244881695,12753388766,-1094,-1094,43339807.01665735,4715.150000335183,-959,0,0,0.19888940315369663,-12686497732,2583.7108138404906,2398.3713730457657,185.33944079472485,0.7687794610418675,0.7692530039222614,-959
1983,2022-06-07,2022,243275,243275,641025839.4500006,4022161.1500000055,186834,0,47,0.8726379611550716,66544363,14194768657,244451,244451,71047,315498,597828439.166668,4017875.78333301,187836,0,47,0.6784480408750622,12774366131,-1176,-1176,43197400.28333259,4285.366666995455,-1002,0,0,0.19418992028000948,-12707821768,2634.984439214883,2445.5962101470973,189.3882290677857,0.7679950673106567,0.7683993929253715,-1002
1984,2022-06-08,2022,244509,244509,641044324.4833332,4032111.399999999,187439,0,67,0.8755137847686588,67136426,14200433609,245590,245590,66350,311940,597980182.0500023,4027606.5499997437,188360,0,68,0.6919631980509036,12782643241,-1081,-1081,43064142.43333089,4504.8500002552755,-921,0,-1,0.18355058671775526,-12715506815,2621.7616712813565,2434.871867950659,186.8898033306973,0.7665934587274906,0.7669693391424732,-921
1985,2022-06-09,2022,247182,247182,641864698.8333342,4059219.800000001,191006,0,79,0.8795179260625767,68049118,14214269374,248479,248479,65732,314211,598890545.8500056,4054174.399999723,192089,0,63,0.6982473560760137,12805874412,-1297,-1297,42974152.98332858,5045.400000278372,-1083,0,16,0.181270569986563,-12737825294,2596.7291260420834,2410.2259983741305,186.50312766795287,0.7727342605853177,0.773059292737012,-1083
1986,2022-06-10,2022,245865,245865,642001893.9999999,4062303.200000001,191198,0,73,0.8846643483212323,68003140,14223064896,246787,246787,68121,314908,599099455.0666655,4057756.9999997113,192052,0,73,0.6954888411853799,12823561206,-922,-922,42902438.93333435,4546.200000289828,-854,0,0,0.1891755071358524,-12755558066,2611.1967705854836,2427.597300776238,183.59946980924542,0.7776544038395055,0.7782095491253591,-854
1987,2022-06-11,2022,246877,246877,642278832.6,4090012.583333326,192537,0,88,0.8920717604313071,69258451,14230116349,247942,247942,67592,315534,599509781.1833366,4085479.2166664205,193533,0,89,0.7034772797860199,12837330869,-1065,-1065,42769051.41666341,4533.366666905582,-996,0,-1,0.18859448064528717,-12768072418,2601.61470124799,2417.943636751081,183.6710644969089,0.7798903907613913,0.7805575497495382,-996
1988,2022-06-12,2022,248078,248078,643087748.8999999,4073948.266666665,192872,0,72,0.8864268496198779,68250548,14248594811,249218,249218,66152,315370,600312505.2833419,4069139.7999996776,193864,0,74,0.7030694105336702,12850760403,-1140,-1140,42775243.61665797,4808.4666669876315,-992,0,-2,0.18335743908620772,-12782509855,2592.280447681777,2408.7846996739477,183.4957480078292,0.7774651520892623,0.7778892375350095,-992
1989,2022-06-13,2022,245365,245365,644134140.433333,4049227.2166666663,188889,0,67,0.8729892201414224,67255747,14274872407,246390,246390,70590,316980,601415155.516671,4044667.116666408,189740,0,68,0.6809577891349675,12875219181,-1025,-1025,42718984.9166621,4560.100000258535,-851,0,-1,0.19203143100645492,-12807963434,2625.207916505341,2440.9073238226833,184.30059268265768,0.7698286226641942,0.7700799545436098,-851
1990,2022-06-14,2022,249493,249493,644553822.3833339,4097852.6999999993,193886,0,83,0.8775075853831573,68157661,14287231069,250440,250440,65890,316330,601866927.6666726,4093561.583333042,194642,0,83,0.6970442259665564,12894196891,-947,-947,42686894.716661334,4291.11666695727,-756,0,0,0.18046335941660097,-12826039230,2583.454535330987,2403.2380117659823,180.21652356500454,0.7771199993586995,0.7772001277751158,-756
1991,2022-06-15,2022,255568,255568,645737176.4333328,4158987.6166666746,196929,0,71,0.8703750078257056,69592241,14312065404,256582,256582,65801,322383,603021046.5166568,4154223.5499997493,197801,0,72,0.6950676679601595,12913785578,-1014,-1014,42716129.916676044,4764.066666925326,-872,0,-1,0.17530733986554614,-12844193337,2526.6746088451323,2350.2079121553998,176.46669668973254,0.7705542164903274,0.7709075461256051,-872
1992,2022-06-16,2022,259959,259959,646577812.5666652,4174806.9499999965,198051,0,86,0.8646632738239494,70938832,14324576860,261055,261055,69320,330375,603944378.9333366,4171427.583333085,198998,0,86,0.6846220204313326,12936728025,-1096,-1096,42633433.63332856,3379.3666669116355,-947,0,0,0.18004125339261678,-12865789193,2487.229957672807,2313.475623655309,173.75433401749797,0.761854754018903,0.7622838099251116,-947
1993,2022-06-17,2022,260778,260778,647579202.4666665,4180572.0999999996,201244,0,47,0.8799553643328815,70232269,14350617923,261835,261835,73221,335056,605010173.5166678,4175470.816666588,202226,0,47,0.6896399407860215,12954899284,-1057,-1057,42569028.94999862,5101.28333341144,-982,0,0,0.19031542354685993,-12884667015,2483.2585665457455,2310.654318623056,172.6042479226894,0.7717062022103092,0.7723413600168044,-982
1994,2022-06-18,2022,257050,257050,647801332.2833343,4160519.25,199734,0,52,0.8874965959929979,69542723,14360236427,258184,258184,75590,333774,605312878.0666729,4155503.8833330423,200768,0,53,0.6895833707838478,12981671780,-1134,-1134,42488454.216661334,5015.366666957736,-1034,0,-1,0.1979132252091501,-12912129057,2520.137452959869,2344.5018981295234,175.63555483034543,0.7770239253063607,0.7776159638087565,-1034
1995,2022-06-19,2022,249386,249386,648082151.4833337,4082577.5500000045,194122,0,53,0.8886625552356586,67879811,14375636317,250440,250440,75479,325919,605647423.6166743,4077360.1166665303,195051,0,53,0.6853113810486707,12995251062,-1054,-1054,42434727.8666594,5217.433333474211,-929,0,0,0.2033511741869879,-12927371251,2598.7110402481844,2418.333427634061,180.37761261412334,0.7783997497854731,0.778833253473886,-929
1996,2022-06-20,2022,254039,254039,648895019.3666667,4142238.100000001,195324,0,41,0.8747633237416299,67718849,14398471681,255105,255105,71896,327001,606506935.3000075,4137408.9499996947,196225,0,41,0.6844566224568145,13009739210,-1066,-1066,42388084.06665921,4829.150000306312,-901,0,0,0.19030670128481542,-12942020361,2554.3126030517624,2377.479607612581,176.83299543918156,0.7688740705167317,0.7691930773603026,-901
1997,2022-06-21,2022,256075,256075,649840261.2000005,4174049.5833333307,196581,0,38,0.8795391975007316,69020172,14417429943,257245,257245,69292,326537,607464970.0000011,4169228.416666444,197567,0,38,0.6951677757803636,13034662188,-1170,-1170,42375291.19999945,4821.166666886769,-986,0,0,0.18437142172036802,-12965642016,2537.695054964368,2361.425761433657,176.2692935307109,0.7676696280386606,0.7680110400590876,-986
1998,2022-06-22,2022,257464,257464,649916590.2666677,4163821.6666666646,197326,0,33,0.8723976944349502,68330197,14411298860,258491,258491,70939,329430,607510839.9833257,4159233.649999849,198103,0,33,0.6855416932276978,13037069454,-1027,-1027,42405750.283342004,4588.016666815616,-777,0,0,0.18685600120725243,-12968739257,2524.300835327144,2350.2204718281323,174.08036349901158,0.7664217133269117,0.7663825819854463,-777
1999,2022-06-23,2022,255221,255221,650480458.9500004,4138484.116666663,198694,0,43,0.8922306550009604,68850692,14425671137,256404,256404,73067,329471,608007291.8166537,4133436.1499996246,199741,0,43,0.6963920952071575,13045708960,-1183,-1183,42473167.13334668,5047.966667038389,-1047,0,0,0.19583855979380294,-12976858268,2548.6948916821125,2371.2862974706077,177.4085942115048,0.7785174417465648,0.7790089078173508,-1047
2000,2022-06-24,2022,255376,255376,650646575.2166663,4166138.6166666653,199525,0,109,0.8940660046363008,68720554,14426417984,256881,256881,71845,328726,608163317.200014,4161499.549999727,200809,0,109,0.7016055924995398,13049571677,-1505,-1505,42483258.016652346,4639.0666669383645,-1284,0,0,0.19246041213676102,-12980851123,2547.7984431452696,2367.4904613420767,180.3079818031929,0.7812989474343712,0.7817199403614904,-1284
2001,2022-06-25,2022,256921,256921,650898261.9166663,4189312.716666667,201751,0,49,0.8952907703146098,69292217,14430948425,258134,258134,70658,328792,608416043.6666758,4184831.6666668607,202824,0,50,0.705388208958859,13055804165,-1213,-1213,42482218.24999046,4481.049999806099,-1073,0,-1,0.1899025613557508,-12986511948,2533.4568288176765,2356.977553002223,176.47927581545355,0.7852647311819586,0.7857314418092929,-1073
2002,2022-06-26,2022,253593,253593,651281214.7333322,4107136.2666666643,197207,0,37,0.8891373184591056,68360820,14445307010,254584,254584,72487,327071,608863607.6333307,4102651.71666639,198197,0,37,0.695066208865969,13068225135,-991,-991,42417607.100001454,4484.550000274088,-990,0,0,0.19407110959313656,-12999864315,2568.214480420722,2391.602015968524,176.61246445219786,0.7776515913294136,0.778513182289539,-990
2003,2022-06-27,2022,248680,248680,651504108.4666674,4097565.449999999,191956,0,63,0.8826403410004818,67927552,14462328578,249886,249886,75018,324904,609110985.7166713,4092721.099999743,193020,0,63,0.6819152734346036,13085506670,-1206,-1206,42393122.749996066,4844.350000255741,-1064,0,0,0.20072506756587827,-13017579118,2619.849237842478,2437.5554681601666,182.29376968231145,0.7718996300466463,0.772432229096468,-1064
2004,2022-06-28,2022,248575,248575,651205976.4499997,4092589.583333332,192698,0,81,0.8821844513728251,67422419,14458545728,249747,249747,68445,318192,608947899.0166858,4087963.8999997303,193697,0,81,0.6945492029969316,13097960345,-1172,-1172,42258077.43331385,4625.683333601803,-999,0,0,0.18763524837589352,-13030537926,2619.756517952327,2438.2591142904053,181.4974036619219,0.7752107009956754,0.7755728797543113,-999
2005,2022-06-29,2022,251427,251427,651674411.5499998,4122974.8500000024,195222,0,41,0.8822958552581867,68548212,14472300980,252616,252616,67555,320171,609513905.5333353,4118475.94999982,196197,0,42,0.6985329714433856,13102327187,-1189,-1189,42160506.016664505,4498.900000182446,-975,0,-1,0.1837628838148011,-13033778975,2591.9030635134645,2412.8079992294047,179.09506428405984,0.776455989213569,0.7766610190961776,-975
2006,2022-06-30,2022,255725,255725,652448470.2833334,4121757.2833333327,194989,0,63,0.8711623814644641,67889561,14489781526,256674,256674,68721,325395,610291706.0333307,4118661.8833330167,195804,0,63,0.6888735229490431,13118427372,-949,-949,42156764.25000274,3095.400000316091,-815,0,0,0.18228885851542098,-13050537811,2551.3675639195753,2377.691959580365,173.67560433921017,0.7624948675334833,0.7628509315318264,-815
2007,2022-07-01,2022,257755,257755,652506278.116668,4143915.316666666,197031,0,39,0.8699617854163841,69034309,14495503652,258562,258562,71790,330352,610472576.3166759,4138930.3833330306,197752,0,39,0.682623383542414,13132573652,-807,-807,42033701.799992085,4984.93333363533,-721,0,0,0.1873384018739701,-13063539343,2531.4980431676126,2361.0297581109207,170.4682850566919,0.7644119415724234,0.7648146285997169,-721
2008,2022-07-02,2022,258709,258709,652554173.416667,4179577.033333333,197902,0,55,0.8760074060044302,69507448,14509568689,259719,259719,75942,335661,610540911.1166615,4174132.36666638,198751,0,56,0.6797989638355227,13146783059,-1010,-1010,42013262.300005436,5444.666666953359,-849,0,-1,0.19620844216890743,-13077275611,2522.3481727217336,2350.774918726245,171.5732539954888,0.764959858373694,0.7652539860387573,-849
2009,2022-07-03,2022,261521,261521,652915742.9333339,4181709.083333334,199344,0,57,0.872128815659163,69222646,14519527285,262436,262436,74988,337424,610978291.8000088,4176681.3500001696,200181,0,57,0.6804880506425259,13157473540,-915,-915,41937451.1333251,5027.73333316436,-837,0,0,0.19164076501663707,-13088250894,2496.6092318908763,2328.1039636330715,168.5052682578048,0.7622485383582963,0.7627802588059565,-837
2010,2022-07-04,2022,262712,262712,654049348.4499997,4224042.449999999,198826,0,36,0.8628574256219728,67111741,14539564080,263515,263515,78270,341785,612153967.0333227,4219468.666666307,199564,0,36,0.667039220562641,13174855093,-803,-803,41895381.416677,4573.7833336927,-738,0,0,0.19581820505933178,-13107743352,2489.605912367915,2323.0327193265002,166.57319304141492,0.756821157769725,0.7573155228355122,-738
2011,2022-07-05,2022,263707,263707,654982991.1166662,4243690.5333333295,198682,0,47,0.8588130007925459,68928418,14555489941,264605,264605,74014,338619,613148611.2999904,4238470.099999767,199440,0,47,0.6729185308562068,13190516979,-898,-898,41834379.81667578,5220.433333562687,-758,0,0,0.18589446993633907,-13121588561,2483.7527677182106,2317.22231741649,166.53045030172052,0.7534195148403342,0.7537272538311823,-758
2012,2022-07-06,2022,259630,259630,655673040.6166669,4239347.016666668,199539,0,47,0.8717367022300966,69311829,14572598390,260631,260631,76731,337362,613919021.5833393,4234493.699999744,200396,0,48,0.6750493535134381,13211623680,-1001,-1001,41754019.03332758,4853.316666923463,-857,0,-1,0.1966873487166585,-13142311851,2525.4132442963714,2355.5103636303406,169.9028806660308,0.7685514000693294,0.7688878145730937,-857
2013,2022-07-07,2022,262080,262080,656843304.0500002,4251298.05,201728,0,36,0.8792925824175835,68888663,14592369867,263122,263122,71461,334583,615073402.7666707,4246342.766666436,202635,0,36,0.6934482624640127,13232285068,-1042,-1042,41769901.28332949,4955.283333564177,-907,0,0,0.18584431995357076,-13163396405,2506.2702382860202,2337.5977788503837,168.67245943563648,0.7697191697191698,0.7701180441012154,-907
2014,2022-07-08,2022,264337,264337,657411469.2833338,4261707.783333336,205008,0,35,0.8847796562721072,69860715,14604038524,265442,265442,73433,338875,615715667.3833401,4256590.599999968,206004,0,36,0.6953566949465065,13255706952,-1105,-1105,41695801.89999366,5117.183333368041,-996,0,-1,0.18942296132560066,-13185846237,2487.020240387588,2319.58645347511,167.4337869124779,0.7755554462674541,0.7760791434663693,-996
2015,2022-07-09,2022,260459,260459,657652424.6833344,4289212.75,203945,0,33,0.8966401621752369,70630734,14615474801,261446,261446,74929,336375,616004645.733331,4283661.849999918,204849,0,33,0.6993236714975828,13268044850,-987,-987,41647778.950003386,5550.900000082329,-904,0,0,0.1973164906776541,-13197414116,2524.974850872246,2356.1448472469688,168.8300036252772,0.7830215120230055,0.783523174957735,-904
2016,2022-07-10,2022,257979,257979,658655747.1833339,4231542.766666668,203048,0,43,0.8959954104791475,70159148,14636230316,259014,259014,71935,330949,617077565.6499915,4226676.966666493,203988,0,44,0.7035857488616136,13284235180,-1035,-1035,41578181.53334236,4865.800000174902,-940,0,-1,0.19240966161753392,-13214076032,2553.137066130708,2382.4100845899893,170.7269815407185,0.7870718159230015,0.7875558850100767,-940
2017,2022-07-11,2022,259768,259768,659682092.000001,4242880.633333337,203127,0,80,0.8928659419174038,70020307,14664616627,260696,260696,73668,334364,618117231.2333316,4238028.083333117,203981,0,79,0.6987654173296087,13312352303,-928,-928,41564860.76666939,4852.550000219606,-854,0,1,0.19410052458779503,-13242331996,2539.504835083617,2371.026909631646,168.4779254519708,0.7819554371593114,0.7824477552398196,-854
2018,2022-07-12,2022,258479,258479,660492676.8999997,4237511.400000003,201161,0,47,0.8869192468246933,70174597,14682884407,259342,259342,69454,328796,619046518.8333449,4232862.749999805,201961,0,47,0.7016539130646234,13340570599,-863,-863,41446158.0666548,4648.650000197813,-800,0,0,0.18526533376006982,-13270396002,2555.3049837704407,2386.9890678461065,168.31591592433415,0.7782489099694753,0.7787438980188323,-800
2019,2022-07-13,2022,258019,258019,661206234.7000003,4231782.166666663,201742,0,46,0.8914886113038184,69707567,14701898379,259060,259060,70563,329623,619828712.0833383,4226753.899999885,202722,0,47,0.7034278554591246,13364011505,-1041,-1041,41377522.616662025,5028.266666778363,-980,0,-1,0.18806075584469384,-13294303938,2562.6261426484107,2392.6067786742,170.0193639742106,0.7818881555234305,0.7825291438276847,-980
2020,2022-07-14,2022,261549,261549,662143668.083333,4270055.999999997,206197,0,78,0.901093103013203,71991442,14722907642,262718,262718,69279,331997,620807609.5666636,4265142.116666613,207256,0,77,0.7167384042626762,13383235965,-1169,-1169,41336058.51666939,4913.883333384059,-1059,0,1,0.1843546987505268,-13311244523,2531.6237801839543,2363.018938811439,168.60484137251524,0.7883685275034505,0.788891511049871,-1059
2021,2022-07-15,2022,266325,266325,663191549.0000001,4296210.116666666,211666,0,58,0.9110597953628086,74546237,14748031205,267507,267507,70759,338266,621844707.733338,4291081.233333293,212793,0,59,0.7248467182631322,13410865430,-1182,-1182,41346841.26666212,5128.8833333728835,-1127,0,-1,0.18621307709967638,-13336319193,2490.158824744204,2324.59228256957,165.56654217463392,0.7947657936731437,0.7954670345075082,-1127
2022,2022-07-16,2022,262493,262493,663727841.200001,4312251.166666665,211411,0,57,0.919830243092196,75597092,14770877454,263733,263733,74216,337949,622398447.2833385,4307061.56666665,212550,0,57,0.7221858919541229,13439243667,-1240,-1240,41329393.916662455,5189.60000001546,-1139,0,0,0.1976443511380731,-13363646575,2528.554442213701,2359.9566504128743,168.5977918008266,0.8053967153409806,0.8059287233679516,-1139
2023,2022-07-17,2022,263299,263299,664742642.8833338,4267195.233333334,210964,0,43,0.915199070258527,75762960,14802854335,264412,264412,72030,336442,623498285.6166571,4262156.783333074,211971,0,45,0.7230488464579313,13466490690,-1113,-1113,41244357.266676664,5038.450000260025,-1007,0,-2,0.19215022380059565,-13390727730,2524.6683158057335,2358.0559339843016,166.61238182143188,0.8012335785551787,0.80166936447665,-1007
2024,2022-07-18,2022,262920,262920,665443253.8999999,4280457.833333334,209057,0,30,0.9093260307317821,75224489,14829579807,264064,264064,76451,340515,624279661.5833244,4275273.166666583,210147,0,30,0.7085179801183455,13499873697,-1144,-1144,41163592.316675425,5184.666666750796,-1090,0,0,0.20080805061343654,-13424649208,2530.9723638369082,2364.122567193273,166.84979664363527,0.795135402403773,0.7958184379544353,-1090
2025,2022-07-19,2022,265871,265871,666378759.2333341,4322215.483333335,210117,0,48,0.9031936540653173,76255860,14856839343,274997,274997,70917,345914,625291235.7333275,4321980.949999938,214261,0,49,0.7101447180513062,13528446243,-9126,-9126,41087523.50000656,234.53333339747041,-4144,0,-1,0.19304893601401107,-13452190383,2506.39881458803,2273.8111169697395,232.58769761829035,0.7902967980712451,0.7791394087935505,-4144
2026,2022-07-20,2022,268734,268734,667619311.7333336,4325943.249999998,209920,0,89,0.891725646922236,76790334,14886664085,269700,269700,80755,350455,624960485.5000086,4321172.283333355,210811,0,89,0.6885220641737154,13488400281,-966,-966,42658826.233325005,4770.966666643508,-891,0,0,0.20320358274852057,-13411609947,2484.312784140948,2317.2431794586896,167.0696046822586,0.7811441797465152,0.7816499814608825,-891
2027,2022-07-21,2022,270193,270193,668190663.5499992,4315857.416666667,210194,0,124,0.8911000655087287,75117695,14895517507,271514,271514,76483,347997,625510926.8666615,4311191.433333154,211268,0,125,0.6977071641422182,13507305694,-1321,-1321,42679736.68333769,4665.983333513141,-1074,0,-1,0.19339290136651044,-13432187999,2473.0124894057185,2303.7888538589596,169.22363554675894,0.7779402131069273,0.7781108893095752,-1074
2028,2022-07-22,2022,272048,272048,669163189.5833337,4348779.133333335,214609,0,122,0.9019364229841791,75452105,14915611082,273098,273098,78281,351379,626437742.2666675,4343981.516666647,215549,0,123,0.7034654888311498,13522402946,-1050,-1050,42725447.316666245,4797.6166666876525,-940,0,-1,0.1984709341530293,-13446950841,2459.724716165286,2293.8203218868957,165.9043942783901,0.7888644650943951,0.7892734476268592,-940
2029,2022-07-23,2022,270044,270044,669177995.2333337,4367726.083333335,214276,0,135,0.9047229340403781,75939501,14923475838,270946,270946,77246,348192,626463629.9666538,4362348.900000089,215125,0,136,0.7064694191710411,13531747017,-902,-902,42714365.26667988,5377.183333246037,-849,0,-1,0.19825351486933696,-13455807516,2478.033191751469,2312.1346318700175,165.89855988145155,0.7934855060656781,0.7939773977102449,-849
2030,2022-07-24,2022,272731,272731,669843578.0166671,4357153.100000001,216396,0,126,0.9079239250396919,76085369,14942670971,273903,273903,75916,349819,627271152.5333343,4351595.666666732,217448,0,127,0.7141293068701309,13550394594,-1172,-1172,42572425.48333287,5557.433333268389,-1052,0,-1,0.193794618169561,-13474309225,2456.0595532472184,2290.1215121168234,165.93804113039505,0.7934411563041972,0.7938868869636331,-1052
2031,2022-07-25,2022,270828,270828,670465156.5333332,4344496.4833333315,210746,0,136,0.8923154179036135,75175428,14960447535,272166,272166,79566,351732,627899037.8166783,4339075.216666722,211860,0,137,0.6942558538887842,13567789683,-1338,-1338,42566118.7166549,5421.266666609794,-1114,0,-1,0.19805956401482927,-13492614255,2475.6124054135216,2307.04436930652,168.56803610700172,0.7781544005789652,0.7784219924604837,-1114
2032,2022-07-26,2022,269036,269036,670356398.2833338,4336421.633333335,209638,0,131,0.8904793410547279,73664605,14963635127,270211,270211,77424,347635,627766291.4666672,4331316.166666664,210608,0,133,0.6945618249025588,13586298671,-1175,-1175,42590106.8166666,5105.466666670516,-970,0,-2,0.19591751615216912,-13512634066,2491.6977589740177,2323.2447660038533,168.45299297016436,0.7792191379592323,0.779420526921554,-970
2033,2022-07-27,2022,273304,273304,670827672.2833325,4361546.200000003,212742,0,126,0.894202060708954,73124812,14970703252,274342,274342,75051,349393,628375861.633341,4356515.266666697,213688,0,128,0.7050112623893706,13600192624,-1038,-1038,42451810.64999151,5030.933333305642,-946,0,-2,0.1891907983195834,-13527067812,2454.5109924601634,2290.4836358754437,164.02735658471966,0.7784079267043292,0.7789109943063767,-946
2034,2022-07-28,2022,274521,274521,671310822.5000007,4363482.249999994,213446,0,129,0.8887480374907556,73501122,14977436254,275460,275460,76763,352223,628925460.1000168,4358398.883333263,214291,0,130,0.697714232176773,13605341921,-939,-939,42385362.39998388,5083.366666731425,-845,0,-1,0.19103380531398262,-13531840799,2445.389687856305,2283.1825314020793,162.2071564542257,0.77752157394152,0.7779387206853989,-845
2035,2022-07-29,2022,273619,273619,671706171.6833342,4339277.333333329,213712,0,124,0.8927267477770193,73225165,14992023765,292029,292028,78948,370977,629457814.7833359,4389083.533334411,223722,0,125,0.6907247619124626,13622260432,-18410,-18409,42248356.89999831,-49806.20000108145,-10010,0,-1,0.20200198586455675,-13549035267,2454.8959380866613,2155.470758911255,299.42517917540636,0.7810568710506215,0.766095148084608,-10010
2036,2022-07-30,2022,269299,269299,671694738.0000004,4337352.166666668,212241,0,130,0.9007311575609274,74525731,14997932941,270333,270333,93266,363599,621844451.1833417,4332563.333333254,213199,0,131,0.6730244032574322,13230609588,-1034,-1034,49850286.816658616,4788.833333414048,-958,0,-1,0.22770675430349518,-13156083857,2494.2340595397695,2300.290571936618,193.94348760315142,0.7881239811510625,0.7886532535798442,-958
2037,2022-07-31,2022,268166,268166,672102536.9166657,4303070.1666666595,211361,0,139,0.9034739676170739,73708388,15000139653,269256,269256,78664,347920,622089565.7000012,4297901.900000012,212470,0,139,0.7031817659231806,13209041689,-1090,-1090,50012971.21666443,5168.266666647978,-1109,0,0,0.20029220169389328,-13135333301,2506.2928817100815,2310.4018692248314,195.89101248525003,0.7881722515158521,0.789100335739965,-1109
2038,2022-08-01,2022,279072,279072,672763214.8833325,4402699.833333333,216670,0,123,0.8933859362458425,74271374,15022678177,280304,280304,78295,358599,622724927.7333428,4397440.266666735,217805,0,124,0.7022942060630449,13226271952,-1232,-1232,50038287.149989724,5259.566666598432,-1135,0,-1,0.19109173018279757,-13152000578,2410.7155676074008,2221.6055701429264,189.10999746447442,0.7763946221763559,0.7770313659455448,-1135
2039,2022-08-02,2022,283361,283361,673339750.3666666,4475855.583333333,217094,0,130,0.8842889459029295,74803995,15038386396,284820,284820,77829,362649,623373459.7333308,4469809.900001715,218356,0,131,0.6973961047734819,13244354571,-1459,-1459,49966290.63333571,6045.6833316180855,-1262,0,-1,0.1868928411294476,-13169550576,2376.2612016708954,2188.6576073777505,187.60359429314485,0.76613930639714,0.7666456007302858,-1262
2040,2022-08-03,2022,285845,285845,674128914.5499997,4500097.849999994,218421,0,132,0.8822438734279073,73608535,15055656282,287191,287191,80279,367470,624068036.466671,4493396.333335033,219608,0,133,0.692725936811169,13253216207,-1346,-1346,50060878.083328724,6701.516664961353,-1187,0,-1,0.18951793661673833,-13179607672,2358.3722456226265,2173.0069412574594,185.36530436516705,0.7641239133096608,0.7646757732658753,-1187
2041,2022-08-04,2022,285415,285415,674781888.7166663,4484875.083333328,220047,0,130,0.8878685422980559,73587399,15070775087,286799,286799,81365,368164,624618972.2333481,4479044.850000165,221233,0,130,0.6949375821644623,13269258389,-1384,-1384,50162916.48331821,5830.233333162963,-1186,0,0,0.19293096013359357,-13195670990,2364.213123755466,2177.8980130103246,186.31511074514128,0.7709720932676979,0.7713869295220694,-1186
2042,2022-08-05,2022,281980,281980,674885809.6166667,4455450.149999998,219293,0,126,0.8936343003049869,73514348,15081740507,283378,283378,82744,366122,624696585.3499848,4449702.316668148,220414,0,126,0.6938042510419943,13279847152,-1398,-1398,50189224.26668191,5747.833331849426,-1121,0,0,0.19983004926299264,-13206332804,2393.3818342317422,2204.463950447758,188.91788378398405,0.7776899070856089,0.7778091453817869,-1121
2043,2022-08-06,2022,279534,279534,674771109.2500004,4453340.3500000015,219252,0,124,0.9003985203946564,74384955,15089985400,280922,280922,82673,363595,624880908.3999923,4448964.150001604,220607,0,125,0.6993275485086272,13299209501,-1388,-1388,49890200.85000801,4376.19999839738,-1355,0,-1,0.20107097188602918,-13224824546,2413.914261771378,2224.392921878644,189.52133989273398,0.7843482367082358,0.7852962744106905,-1355
2044,2022-08-07,2022,270392,270392,675095691.300001,4350718.650000002,212886,0,129,0.9024675286251072,73257203,15107658433,271710,271710,83333,355043,625351865.049998,4346224.000001129,214160,0,130,0.6943750475294344,13320727621,-1318,-1318,49743826.25000298,4494.649998873472,-1274,0,-1,0.2080924810956728,-13247470418,2496.7295308293183,2301.541588642295,195.18794218702305,0.7873235894553093,0.7881932943211513,-1274
2045,2022-08-08,2022,273370,273370,675645856.2499999,4359672.48333333,213541,0,119,0.8975820316786765,73274407,15130497750,274588,274588,79365,353953,625906783.7166619,4354512.366667804,214586,0,119,0.6985418968055239,13343977018,-1218,-1218,49739072.53333795,5160.116665525362,-1045,0,0,0.19904013487315253,-13270702611,2471.5435353184325,2279.4396831495255,192.103852168907,0.7811427735303801,0.7814835316911154,-1045
2046,2022-08-09,2022,271345,271345,675883497.6833344,4345772.366666661,212138,0,124,0.8965965836849767,73911986,15146783727,272682,272682,78868,351550,626156407.9166697,4340775.700001168,213279,0,125,0.6979860617266321,13366388742,-1337,-1337,49727089.766664624,4996.666665492579,-1141,0,-1,0.1986105219583446,-13292476756,2490.8640206502214,2296.28801283792,194.5760078123012,0.7818017652803626,0.7821528373710036,-1141
2047,2022-08-10,2022,279602,279602,676141220.5999998,4404193.899999995,216248,0,128,0.8906552885887802,74015290,15157167148,280969,280969,75443,356412,626553292.7666748,4399035.366667887,217468,0,130,0.7048724509836971,13383796878,-1367,-1367,49587927.83332503,5158.533332107589,-1220,0,-2,0.18578283760508307,-13309781588,2418.2274111057854,2229.973031781708,188.2543793240775,0.7734136379568101,0.7739928604223242,-1220
2048,2022-08-11,2022,280334,280334,676571621.8166667,4420519.866666664,216292,0,126,0.8874271404824255,74970145,15171435968,281652,281652,80637,362289,626937959.7333355,4414483.150001612,217424,0,126,0.692717692229116,13400764242,-1318,-1318,49633662.08333123,6036.716665052809,-1132,0,0,0.1947094482533095,-13325794097,2413.448321704348,2225.9311481307977,187.51717357355028,0.7715510783565318,0.7719597233465412,-1132
2049,2022-08-12,2022,287223,287223,677521485.6833326,4437713.9,220495,0,125,0.8825477068340635,75532626,15193624659,299003,299003,82441,381444,627953882.8166617,4442554.083334948,226667,0,126,0.6850940111785733,13418016691,-11780,-11780,49567602.86667085,-4840.183334947564,-6172,0,-1,0.1974536956554902,-13342484065,2358.869191127913,2100.159138258351,258.7100528695619,0.7676787722431699,0.7580760059263619,-6172
2050,2022-08-13,2022,284877,284877,677848765.6500009,4452672.149999999,219570,0,131,0.8873162803595926,74883887,15205171218,297405,297405,90492,387897,625165609.0499477,4460504.166666313,226032,0,131,0.6722145311771045,13351540473,-12528,-12528,52683156.60005319,-7832.016666313633,-6462,0,0,0.21510174918248814,-13276656586,2379.443639360148,2102.0682538960264,277.3753854641218,0.7707536936993861,0.7600141221566551,-6462
2051,2022-08-14,2022,284336,284336,678483100.3499991,4446095.433333334,219501,0,121,0.8915016037364251,74821128,15220436317,285700,285700,93995,379695,617206236.4166662,4440518.533334904,220758,0,122,0.6738908861059624,13119585606,-1364,-1364,61276863.93333292,5576.899998429231,-1257,0,-1,0.2176107176304627,-13044764478,2386.2018891381995,2160.3298439505293,225.8720451876702,0.7719775195543301,0.7726916345817291,-1257
2052,2022-08-15,2022,275595,275595,679105250.3333329,4363329.249999997,214380,0,66,0.8999328725122007,73101701,15245184844,276963,276963,91624,368587,617785771.1000013,4358106.966666586,215613,0,68,0.6792751779091439,12990985075,-1368,-1368,61319479.23333156,5222.28333341144,-1233,0,-2,0.22065769460305673,-12917883374,2464.142130057994,2230.5714882493376,233.57064180865655,0.7778805856419746,0.77849026765308,-1233
2053,2022-08-16,2022,284195,284195,679451303.2166662,4479838.533333331,218648,0,64,0.8899663963123919,72937837,15254140027,285813,285813,79770,365583,618164671.3833246,4474009.000001685,219871,0,64,0.6990095272482612,13007697496,-1618,-1618,61286631.8333416,5829.533331646584,-1223,0,0,0.19095686906413079,-12934759659,2390.7926009136904,2162.8290923902155,227.96350852347496,0.7693590668379106,0.7692827128227198,-1223
2054,2022-08-17,2022,287994,287994,679768956.6999998,4549609.933333334,221069,0,73,0.891466488885186,73359116,15262931312,289641,289641,80035,369676,618625735.1833401,4543947.983335307,222506,0,73,0.702631493524056,13019204691,-1647,-1647,61143221.51665974,5661.949998026714,-1437,0,0,0.18883499536113002,-12945845575,2360.358051556629,2135.8362082140998,224.52184334252934,0.7676166864587457,0.7682130637582386,-1437
2055,2022-08-18,2022,286920,286920,680805150.6833332,4576926.633333334,221806,0,61,0.8984351038617032,73966457,15282470955,288676,288676,80321,368997,619776677.2333332,4570725.066668675,223409,0,62,0.7075829884795802,13042395452,-1756,-1756,61028473.44999993,6201.566664658487,-1603,0,-1,0.190852115382123,-12968428995,2372.8047911729163,2146.9629523525796,225.84183882033676,0.7730586923184163,0.7739091576715764,-1603
2056,2022-08-19,2022,287597,287597,681231872.8166667,4523310.683333334,221711,0,52,0.8910002538274042,73785484,15295887638,289341,289341,83118,372459,620372994.2833403,4517116.983335188,223302,0,55,0.6966753387621114,13066440435,-1744,-1744,60858878.53332639,6193.699998145923,-1591,0,-3,0.1943249150652928,-12992654951,2368.702986528603,2144.0894801750887,224.61350635351437,0.770908597794831,0.7717606561116468,-1591
2057,2022-08-20,2022,284494,284494,681319422.316666,4529618.050000003,221242,0,49,0.8994565790491192,73963167,15306029604,286294,286294,85915,372209,620546735.9000049,4523669.100001879,222762,0,50,0.6954426142301762,13077574791,-1800,-1800,60772686.41666114,5948.949998123571,-1520,0,-1,0.20401396481894307,-13003611624,2394.8463669415382,2167.515686322469,227.33068061906943,0.7776684218296344,0.778088258922646,-1520
2058,2022-08-21,2022,282589,282589,681701990.2166668,4494206.6999999955,220482,0,50,0.9027138352872897,74127431,15315572380,284407,284407,81527,365934,621095660.2166678,4488149.733335185,222080,0,52,0.7055315985943028,13093465304,-1818,-1818,60606329.99999905,6056.966664810665,-1598,0,-2,0.19718223669298685,-13019337873,2412.34439492219,2183.826910788651,228.51748413353926,0.7802214523566027,0.7808527919495653,-1598
2059,2022-08-22,2022,281228,281228,682614546.7166665,4490234.466666664,217418,0,58,0.8990889954058622,74417247,15337613295,283029,283029,83605,366634,622149295.2666758,4484843.183334988,218936,0,58,0.6976603370118291,13119684444,-1801,-1801,60465251.44999063,5391.283331676386,-1518,0,0,0.20142865839403312,-13045267197,2427.263809850607,2198.182148354677,229.0816614959299,0.7731022515538993,0.7735461737136478,-1518
2060,2022-08-23,2022,278877,278877,682873263.3000004,4443657.416666664,214509,0,47,0.8934225482918987,73149625,15352083771,280763,280763,80203,360966,622557374.466667,4437635.516668121,216071,0,49,0.6986198146085605,13141077655,-1886,-1886,60315888.83333337,6021.899998542853,-1562,0,-2,0.19480273368333823,-13067928030,2448.6539345302785,2217.3768426276506,231.27709190262794,0.769188567002657,0.7695850236676485,-1562
2061,2022-08-24,2022,274395,274395,682522663.0166653,4413204.966666661,212664,0,51,0.8949397765994277,73131915,15356391374,276143,276143,81004,357147,622222461.0333204,4407959.716668047,213989,0,51,0.6949071390771601,13151759698,-1748,-1748,60300201.98334491,5245.249998614192,-1325,0,0,0.20003263752226763,-13078627783,2487.372812976422,2253.2617558052184,234.1110571712038,0.7750286995025419,0.7749209648624082,-1325
2062,2022-08-25,2022,281084,281084,682368847.8000002,4431609.349999996,218559,0,55,0.8961520399595856,73128555,15360116601,282170,282170,78497,360667,622234075.6499912,4425350.816668095,219501,0,59,0.7043782769147066,13166237977,-1086,-1086,60134772.150009036,6258.533331900835,-942,0,-4,0.19177376304487903,-13093109422,2427.6331907899425,2205.174453875292,222.45873691465067,0.7775575984403239,0.7779033915724564,-942
2063,2022-08-26,2022,288611,288611,680898547.6166674,4472928.2499999935,223408,0,47,0.8834382611889355,73139012,15329870232,290060,290060,80758,370818,621848968.2499998,4467036.700001633,224760,0,47,0.6948206397747698,13161480724,-1449,-1449,59049579.36666763,5891.549998360686,-1352,0,0,0.18861762141416571,-13088341712,2359.225904822295,2143.8632291594836,215.3626756628114,0.7740799900211703,0.774874163966076,-1352
2064,2022-08-27,2022,284825,284825,680308963.2166666,4525703.416666671,220625,0,50,0.8866988501711567,73852030,15325473955,286608,286608,86655,373263,621532640.2333267,4519634.066668446,222292,0,50,0.6851388967028548,13166802062,-1783,-1783,58776322.983339906,6069.349998224527,-1667,0,0,0.2015599534683019,-13092950032,2388.515626144708,2168.5809196998225,219.9347064448857,0.7745984376371456,0.7755959359124658,-1667
2065,2022-08-28,2022,282179,282179,680588522.4500011,4451358.799999998,217394,0,61,0.8806076993681308,73324343,15337652160,283850,283850,82361,366211,621830744.0333285,4445058.216668158,218813,0,61,0.6854490990166798,13180223250,-1671,-1671,58757778.41667259,6300.583331840113,-1419,0,0,0.19515860035145094,-13106898907,2411.9035167393786,2190.7019342375497,221.20158250182885,0.7704116890342655,0.7708754623921085,-1419
2066,2022-08-29,2022,286500,286500,681095715.8000002,4487917.016666659,216434,0,38,0.8694938917975565,73345081,15362467741,288234,288233,85955,374189,622355026.8500217,4482225.550000064,217994,0,38,0.6741700049974684,13193056804,-1734,-1733,58740688.94997847,5691.466666595079,-1560,0,0,0.19532388680008816,-13119711723,2377.2974373472957,2159.2080950134846,218.08934233381115,0.7554415357766143,0.7563091099592693,-1560
2067,2022-08-30,2022,286086,286086,681543418.7833345,4501495.616666665,215359,0,43,0.8703956153044878,73513806,15371430667,287850,287850,83760,371610,622999107.5500001,4495371.433335032,216698,0,43,0.6776190091763012,13217173688,-1764,-1764,58544311.23333442,6124.183331632987,-1339,0,0,0.1927766061281866,-13143659882,2382.302590071987,2164.318594927914,217.9839951440731,0.7527771369448347,0.7528157026228939,-1339
2068,2022-08-31,2022,286244,286244,682076802.4999998,4474891.566666662,216656,0,71,0.875641061472031,73210380,15387764274,287978,287978,86557,374535,623627704.0500003,4468803.216668287,218110,0,71,0.6764788337538639,13233344768,-1734,-1734,58449098.44999945,6088.34999837447,-1454,0,0,0.19916222771816716,-13160134388,2382.851002990455,2165.539395544105,217.31160744635008,0.7568927208954598,0.7573842446297981,-1454
2069,2022-09-01,2022,287892,287892,681931417.5500011,4518696.9666666705,217126,0,105,0.8681936281661183,73978589,15399111297,289470,289470,89074,378544,623588307.4999918,4513278.500001804,218387,0,105,0.6667177395494287,13253938385,-1578,-1578,58343110.05000937,5418.466664866544,-1261,0,0,0.20147588861668964,-13179959796,2368.7056866811204,2154.2415708017816,214.4641158793388,0.7541925444263821,0.7544374201126196,-1261
2070,2022-09-02,2022,283548,283548,682120169.1499999,4515067.650000005,217424,0,48,0.8804964238859033,73142706,15412985297,284935,284935,86772,371707,623914054.9833301,4509360.183335253,218520,0,38,0.6773399478621616,13270427985,-1387,-1387,58206114.16666973,5707.466664751992,-1096,0,10,0.20315647602374176,-13197285279,2405.660308483925,2189.671521516592,215.988786967333,0.7667978613850213,0.7669117518030428,-1096
2071,2022-09-03,2022,277498,277498,682222614.7166666,4489977.533333333,213474,0,54,0.8923667918327337,73117909,15425245161,279034,279034,82758,361792,624049360.4833277,4484348.216666723,214833,0,51,0.6913972669379007,13285362380,-1536,-1536,58173254.23333883,5629.316666610539,-1359,0,3,0.200969524894833,-13212244471,2458.4775916102694,2236.463515139115,222.01407647115457,0.7692812200448291,0.7699169276862318,-1359
2072,2022-09-04,2022,274028,274028,682560688.8166659,4423098.883333331,211545,0,74,0.9009225334637347,73028329,15439481201,275585,275585,80381,355966,624503456.5833308,4416960.266668287,212957,0,45,0.701190563143646,13305683998,-1557,-1557,58057232.23333514,6138.616665043868,-1412,0,29,0.19973197032008871,-13232655669,2490.842865753375,2266.1010453519993,224.74182040137566,0.7719831550060577,0.7727452510114846,-1412
2073,2022-09-05,2022,271327,271327,682289483.3166665,4369896.299999999,206615,0,50,0.8905858981966407,71503645,15447727235,273042,273042,83570,356612,624323937.4833364,4364246.966667811,208135,0,50,0.6859976669321136,13329862464,-1715,-1715,57965545.833330035,5649.333332187496,-1520,0,0,0.20458823126452708,-13258358819,2514.639100851248,2286.5490931187746,228.09000773247317,0.7614981185064517,0.7622819932464603,-1520
2074,2022-09-06,2022,291863,291863,682328083.9666669,4555018.416666662,220681,0,49,0.8847507220853615,72739613,15451247632,293751,293750,76462,370213,624374446.9999903,4548776.333335436,222207,0,47,0.7060448984773731,13340763663,-1888,-1887,57953636.96667659,6242.083331226371,-1526,0,2,0.17870582360798848,-13268024050,2337.836875406156,2125.5300323403926,212.3068430657636,0.7561116003056229,0.7564467865641309,-1526
2075,2022-09-07,2022,291547,291547,682760899.3166661,4627701.766666662,222320,0,62,0.8888309603597359,73344260,15466170122,293606,293606,82851,376457,624832846.8166662,4621756.650002319,223969,0,34,0.6962946631354986,13329734191,-2059,-2059,57928052.49999988,5945.116664342582,-1649,0,28,0.19253629722423726,-13256389931,2341.855341734493,2128.133780701574,213.721561032919,0.7625528645467111,0.7628216044631241,-1649
2076,2022-09-08,2022,289899,289899,683340519.0999994,4592870.93333333,219751,0,40,0.8795304571592178,72832605,15474400250,291956,291956,84112,376068,625475519.8666657,4586703.18333551,221405,0,41,0.6870113915568457,13344290716,-2057,-2057,57864999.23333371,6167.749997819774,-1654,0,-1,0.1925190656023722,-13271458111,2357.167562150954,2142.3622733105867,214.8052888403672,0.7580260711489174,0.7583505733740701,-1654
2077,2022-09-09,2022,287832,287832,683547677.7000008,4556083.116666666,221948,0,63,0.8931043108479945,73003443,15480254581,289836,289835,84339,374175,625770764.1000032,4551065.416668821,223648,0,63,0.6956584485868886,13364296485,-2004,-2003,57776913.59999752,5017.699997845106,-1700,0,0,0.19744586226110583,-13291293042,2374.8147450596207,2159.05865095659,215.7560941030306,0.7711025876205564,0.7716363736733877,-1700
2078,2022-09-10,2022,287041,287041,683119169.4166676,4593879.333333334,221972,0,45,0.8993175191000592,74407970,15485857938,289130,289130,83797,372927,625470097.2999963,4588202.650002154,223784,0,39,0.7028024251394943,13371158287,-2089,-2089,57649072.116671324,5676.683331180364,-1812,0,6,0.19651509396056488,-13296750317,2379.866184331394,2163.2832888320004,216.58289549939354,0.773311129768918,0.7739909383322381,-1812
2079,2022-09-11,2022,295558,295558,683784524.9333348,4655110.383333327,227531,0,60,0.8976546058641626,74898871,15504621971,297713,297713,82083,379796,626365461.7666603,4648957.533336107,229269,0,60,0.7081222551053774,13391916385,-2155,-2155,57419063.166674495,6152.849997220561,-1738,0,0,0.18953235075878516,-13317017514,2313.5375287873608,2103.9237848755693,209.61374391179152,0.7698353622639211,0.7701007346001014,-1738
2080,2022-09-12,2022,290836,290836,684833573.0166662,4601080.333333335,221709,0,46,0.8899414102793324,73900436,15536187977,292715,292715,87966,380681,627490607.6999959,4595171.983335528,223238,0,36,0.6883926437095508,13415900278,-1879,-1879,57342965.3166703,5908.349997807294,-1529,0,10,0.2015487665697816,-13341999842,2354.7070273854206,2143.691330133392,211.01569725202853,0.7623162194501368,0.7626462600140068,-1529
2081,2022-09-13,2022,282541,282541,684273215.2666663,4495583.599999992,214633,0,57,0.8880268704365017,72242898,15534131102,284268,284268,87231,371499,627179631.2666612,4490339.033335019,216062,0,42,0.6834042621918083,13431352255,-1727,-1727,57093584.000005126,5244.566664973274,-1429,0,15,0.20462260824469347,-13359109357,2421.854581340996,2206.296984770221,215.55759657077488,0.7596525813952665,0.7600644462268,-1429
2082,2022-09-14,2022,271512,271512,683349639.6166662,4388098.050000004,206393,0,44,0.8859571584313026,72129713,15538543215,273052,273052,85842,358894,626402110.2166864,4382471.450000009,207820,0,44,0.6774395782598895,13445978418,-1540,-1540,56947529.39997983,5626.599999994971,-1427,0,0,0.20851758017141309,-13373848705,2516.830341261772,2294.076257330788,222.75408393098405,0.7601616134830136,0.7611004497311867,-1427
2083,2022-09-15,2022,280007,280007,683340344.1333334,4449912.633333337,213261,0,73,0.8810529736756578,70676944,15549335189,281623,281623,78778,360401,626608112.2000028,4444239.349999448,214679,0,61,0.6920458045343914,13456057142,-1616,-1616,56732231.933330655,5673.283333888277,-1418,0,12,0.18900716914126647,-13385380198,2440.4402180421685,2224.989124467827,215.45109357434148,0.7616273878867315,0.7622921423321248,-1418
2084,2022-09-16,2022,293829,293829,683508738.2499998,4628581.51666667,225151,0,109,0.8995742421612567,73421082,15544860523,295583,295583,79869,375452,626911649.3166504,4622548.816669049,226483,0,109,0.7103997315236078,13464471322,-1754,-1754,56597088.93334937,6032.699997621588,-1332,0,0,0.1891745106376489,-13391050240,2326.212655149763,2120.9326967946413,205.27995835512183,0.7662654128761966,0.766224715223812,-1332
2085,2022-09-17,2022,286102,286102,683422829.5000006,4606835.199999998,221940,0,113,0.9065543058070202,73205647,15550631577,288002,288002,85241,373243,626881677.816662,4600217.8833356295,223755,0,113,0.7040560707099831,13471503918,-1900,-1900,56541151.68333864,6617.3166643688455,-1815,0,0,0.20249823509703713,-13398298271,2388.7383852612024,2176.6573767427376,212.08100851846484,0.7757373244507204,0.776921688043833,-1815
2086,2022-09-18,2022,275139,275139,683822921.1499997,4406657.600000001,211908,0,220,0.9002685915119262,71023984,15569243900,276755,276755,86922,363677,627282154.6666626,4400413.883334592,213497,0,222,0.6893479653648794,13483682206,-1616,-1616,56540766.483337164,6243.716665408574,-1589,0,-2,0.21092062614704676,-13412658222,2485.3725613235483,2266.561235268243,218.81132605530547,0.7701852518181719,0.771429603801196,-1589
2087,2022-09-19,2022,271594,271594,683891977.4333348,4347763.533333339,208559,0,67,0.8938378609247634,70903870,15587825544,273138,273138,87024,360162,627512030.8000042,4341999.616667845,209837,0,70,0.6813600546420941,13511553169,-1544,-1544,56379946.63333058,5763.916665493511,-1278,0,-3,0.2124778062826692,-13440649299,2518.0673263523304,2297.417535458282,220.64979089404824,0.7679072439008225,0.7682453558274572,-1278
2088,2022-09-20,2022,289560,289560,684174739.4500005,4587906.266666672,224460,0,56,0.9058468020444805,72804672,15599400322,291706,291706,79228,370934,627915246.3499992,4581877.86666885,226276,0,56,0.7170601778214059,13529055087,-2146,-2146,56259493.100001335,6028.399997822009,-1816,0,0,0.18878662422307468,-13456250415,2362.8081898397586,2152.5619848408987,210.24620499885987,0.775176129299627,0.7756988200448397,-1816
2089,2022-09-21,2022,287482,287482,684981782.9999998,4430382.283333335,219952,0,69,0.8892730675311837,70788132,15615702926,289281,289281,79099,368380,628840431.1833344,4424642.450001043,221560,0,53,0.7025082794939992,13539778980,-1799,-1799,56141351.81666541,5739.833332291804,-1608,0,16,0.18676478803718455,-13468990848,2382.694509569294,2173.804816712243,208.88969285705116,0.7650983365915084,0.7658989010685112,-1608
2090,2022-09-22,2022,284736,284736,684620311.0666673,4206023.199999997,215444,0,57,0.8798465947403913,69521589,15624667051,286064,286064,95077,381141,628607819.7833378,4201252.916667107,216392,0,49,0.6618784124510341,13558885904,-1328,-1328,56012491.28332949,4770.283332890831,-948,0,8,0.21796818228935722,-13489364315,2404.4037672323393,2197.4377054901624,206.96606174217686,0.7566447516295797,0.7564461099614073,-948
2091,2022-09-23,2022,291474,291474,684936023.983334,4542516.199999999,221928,0,47,0.8881375354234,71894127,15629076177,293283,293283,87566,380849,628993066.9333333,4536472.433335321,223418,0,38,0.6863927698378944,13568388601,-1809,-1809,55942957.05000067,6043.766664678231,-1490,0,9,0.20174476558550558,-13496494474,2349.9043619099266,2144.6625509604487,205.2418109494779,0.7613989583976616,0.761782987762673,-1490
2092,2022-09-24,2022,287474,287474,684986047.7000002,4622899.549999987,220725,0,43,0.8980986106569635,72305928,15630906042,297885,297885,86697,384582,629122858.766661,4629579.550002494,226987,0,44,0.6933631839243423,13574090711,-10411,-10411,55863188.93333912,-6680.00000250712,-6262,0,-1,0.20473542673262124,-13501784783,2382.775651711112,2111.965553037787,270.81009867332523,0.7678085670356276,0.761995400909747,-6262
2093,2022-09-25,2022,291697,291697,685215451.5499996,4525439.999999995,223385,0,53,0.8862518298096991,70030875,15637281531,298554,298554,88709,387263,628158370.8499981,4525003.950001917,227682,0,43,0.6857871782225461,13537239677,-6857,-6857,57057080.70000148,436.04999807849526,-4297,0,10,0.200464651587153,-13467208802,2349.065816755056,2104.002528353323,245.06328840173273,0.7658117841458774,0.7626158081955023,-4297
2094,2022-09-26,2022,286708,286708,685661081.3166655,4557364.449999992,217973,0,51,0.8841887913835684,72062485,15655204802,288558,288558,92543,381101,627049720.9666655,4551126.483335405,219519,0,41,0.6731732532845711,13483808815,-1850,-1850,58611360.350000024,6237.9666645871475,-1546,0,10,0.2110155380989973,-13411746330,2391.496160960509,2173.045699535849,218.4504614246598,0.7602613111597862,0.7607448069365604,-1546
2095,2022-09-27,2022,282097,282097,685993627.0833329,4548453.316666667,213748,0,50,0.886308610158917,71868056,15664636729,284072,284072,81098,365170,627509801.2333292,4542435.3000020785,215437,0,50,0.6937700249198905,13495612237,-1975,-1975,58483825.85000372,6018.016664588824,-1689,0,0,0.19253858523902656,-13423744181,2431.765056286784,2208.9815301519657,222.7835261348182,0.757711000116981,0.7583887183530936,-1689
2096,2022-09-28,2022,287195,287195,686810852.9166663,4598492.866666668,218087,0,69,0.8859485715280551,72210829,15679631489,289272,289272,78054,367326,628340563.4999993,4593018.100002429,219955,0,58,0.7023597567283514,13515198772,-2077,-2077,58470289.416666985,5474.766664238647,-1868,0,11,0.18358881479970368,-13442987943,2391.4443249940505,2172.144429810003,219.29989518404727,0.7593690697957833,0.7603743189800602,-1868
2097,2022-09-29,2022,290362,290362,686975375.9166664,4583286.150000001,221012,0,59,0.885749512677278,72572027,15682083883,292471,292471,79687,372158,628667582.7333354,4577557.566668751,222740,0,40,0.7000951208895111,13527329143,-2109,-2109,58307793.18333101,5728.583331250586,-1728,0,19,0.18565439178776688,-13454757116,2365.9272766982813,2149.5039943561424,216.42328234213892,0.7611602069141279,0.7615797805594401,-1728
2098,2022-09-30,2022,293244,293244,687228648.0500001,4611881.849999999,223246,0,45,0.8842977179413735,73851009,15683478556,295277,295272,83044,378321,629071294.199996,4605459.216668974,224971,0,51,0.6943495074288691,13538743588,-2033,-2028,58157353.85000408,6422.633331025019,-1725,0,-6,0.18994821051250432,-13464892579,2343.538650577676,2130.480689669173,213.057960908503,0.7612977588629264,0.7618981498728312,-1725
2099,2022-10-01,2022,287084,287084,687040822.0166672,4558450.383333333,219724,0,47,0.8874406097170167,74052100,15689191510,289217,289215,85336,374553,628987607.449996,4551620.833335536,221581,0,47,0.6903909460076675,13546740540,-2133,-2131,58053214.56667125,6829.549997797236,-1857,0,0,0.19704966370934918,-13472688440,2393.170019982539,2174.80976937571,218.36025060682914,0.7653648409524738,0.7661409944781946,-1857
2100,2022-10-02,2022,275261,275261,686548062.9666653,4443402.899999998,210683,0,41,0.8902060226475954,72219339,15699670302,277333,277333,86809,364142,628577994.7833322,4437240.9666682705,212573,0,41,0.6833625343959283,13564973332,-2072,-2072,57970068.18333304,6161.93333172705,-1890,0,0,0.2068434882516671,-13492753993,2494.171215561468,2266.5099168989345,227.66129866253368,0.765393571919015,0.7664901039544518,-1890
2101,2022-10-03,2022,274551,274551,686948543.1166661,4396371.6,208492,0,69,0.8851943719017589,72134570,15722018365,276698,276698,81866,358564,629031599.3999987,4391414.516668092,210384,0,69,0.688412668310255,13587812939,-2147,-2147,57916943.71666741,4957.083331907168,-1892,0,0,0.19678170359150382,-13515678369,2502.079916360407,2273.3507267851546,228.72918957525235,0.759392608294998,0.7603379858184736,-1892
2102,2022-10-04,2022,269454,269454,686801413.0333326,4318697.066666664,205568,0,47,0.8917737350345515,71097024,15728307371,286841,286841,80627,367468,629040256.8166595,4333387.266667694,216159,0,39,0.688596013802567,13605084802,-17387,-17387,57761156.216673136,-14690.200001030229,-10591,0,8,0.20317772123198452,-13533987778,2548.8633051776283,2192.992831626788,355.8704735508404,0.7629057278793412,0.7535847385833964,-10591
2103,2022-10-05,2022,274826,274826,686605743.2999988,4398525.66666667,209891,0,69,0.8925611113941193,71164767,15736462500,276948,276948,87946,364894,613395050.7833395,4392041.283334761,211568,0,50,0.6809731045179952,13052415365,-2122,-2122,73210692.51665926,6484.383331908844,-1677,0,19,0.2115880068761241,-12981250598,2498.328918297391,2214.8383479329677,283.4905703644231,0.7637232285154971,0.7639268021433626,-1677
2104,2022-10-06,2022,278624,278624,687140570.0666661,4501558.58333333,213338,0,57,0.8979664350522563,70722464,15739853061,280764,280764,75926,356690,614097117.4333388,4494657.816668472,215009,0,43,0.7115562533292171,13059898245,-2140,-2140,73043452.63332736,6900.766664857976,-1671,0,14,0.18641018172303914,-12989175781,2466.1930417575877,2187.235961281855,278.9570804757327,0.7656842195934306,0.7657997464062344,-1671
2105,2022-10-07,2022,279241,279241,687731268.4333335,4454352.699999998,212761,0,50,0.8946107484216145,70857509,15744285041,313398,313398,75956,389354,614871056.8166546,4488523.966668335,232773,0,51,0.7030542899263782,13071197492,-34157,-34157,72860211.61667895,-34171.266668336466,-20012,0,-1,0.19155645849523628,-13000339983,2462.859209189673,1961.9495236620992,500.90968552757386,0.7619260781905236,0.7427392644496774,-20012
2106,2022-10-08,2022,276943,276943,687571651.9833331,4417206.016666659,212298,0,146,0.8984159195213447,70481375,15742888571,278779,278779,91936,370715,582145828.599992,4411080.6500013955,213747,0,146,0.6786722954291128,11850997241,-1836,-1836,105425823.38334107,6125.36666526366,-1449,0,0,0.21974362409223192,-11780515866,2482.719014321839,2088.198281075662,394.52073324617686,0.7665765157451172,0.7667256141961912,-1449
2107,2022-10-09,2022,260539,260539,687207876.4666668,4225571.399999998,200273,0,91,0.8925957342278891,69689742,15750717014,262205,262205,83340,345545,581914514.3833482,4219769.566666361,201757,0,92,0.6805191798463393,11842720766,-1666,-1666,105293362.08331859,5801.833333636634,-1484,0,-1,0.21207655438154982,-11773031024,2637.6391882469297,2219.3112808045166,418.3279074424131,0.7686872214908325,0.7694628248889228,-1484
2108,2022-10-10,2022,282763,282763,687548852.4499997,4376768.6,221260,0,57,0.9169304329067103,71102916,15769600537,284314,284314,84732,369046,582404070.7833326,4371574.616667788,222535,0,48,0.7087951095527439,11860650265,-1551,-1551,105144781.6666671,5193.983332212083,-1275,0,9,0.20813532335396634,-11789547349,2431.537550705006,2048.453719420544,383.0838312844621,0.7824927589536114,0.7827085546262231,-1275
2109,2022-10-11,2022,273668,273668,687530490.2999996,4403786.516666668,207818,0,55,0.8949310843796136,68717221,15769439915,275504,275504,85855,361359,582441323.699995,4397082.216667997,209433,0,56,0.6863202521592087,11873869886,-1836,-1836,105089166.60000455,6704.299998670816,-1615,0,-1,0.20861083222040488,-11805152665,2512.279441878479,2114.0938922846676,398.1855495938112,0.7593799786602745,0.760181340379813,-1615
2110,2022-10-12,2022,276489,276489,687955382.0333331,4436862.033333335,208501,0,46,0.8870153966342239,68920396,15777386732,278408,278408,79727,358135,583047201.6166643,4431173.050001589,210145,0,41,0.6931966995686013,11887409904,-1919,-1919,104908180.41666877,5688.983331746422,-1644,0,5,0.1938186970656226,-11818489508,2488.18355172659,2094.218562744836,393.9649889817538,0.7541023331850454,0.7548094882330968,-1644
2111,2022-10-13,2022,289424,289424,688987765.2499995,4484152.416666668,222234,0,60,0.9016356625573545,70989771,15794653674,291237,291237,73789,365026,584286780.9999912,4476964.766668359,223814,0,49,0.7233210784985203,11905095609,-1813,-1813,104700984.25000834,7187.649998309091,-1580,0,11,0.17831458405883416,-11834105838,2380.548141308252,2006.2244186006283,374.3237227076238,0.7678492453977556,0.7684943877323279,-1580
2112,2022-10-14,2022,271509,271509,688880603.8166673,4305732.050000002,207123,0,75,0.8896979473976929,69202509,15801866440,273322,273322,87371,360693,584407962.4333365,4299654.216667662,208649,0,76,0.677892279584036,11918054776,-1813,-1813,104472641.38333082,6077.833332339302,-1526,0,-1,0.21180566781365695,-11848852267,2537.2293508379735,2138.1665670284006,399.0627838095729,0.7628586897671901,0.763381652409978,-1526
2113,2022-10-15,2022,259584,259584,688413025.2499992,4226839.233333335,195692,0,48,0.8764330621301777,70054623,15807477097,261277,261277,84050,345327,584124659.9999942,4220913.133333113,197243,0,34,0.6669475598490554,11941093236,-1693,-1693,104288365.250005,5926.100000222214,-1551,0,14,0.20948550228112228,-11871038613,2651.9855817384705,2235.6528129150065,416.332768823464,0.7538677268244576,0.7549191088385124,-1551
2114,2022-10-16,2022,246888,246888,687561474.25,4026982.3999999994,187018,0,75,0.8802574446712672,68393994,15813877097,248127,248127,79179,327306,583504180.4333427,4021137.8666663226,188224,0,75,0.6703237948586331,11954288606,-1239,-1239,104057293.8166573,5844.533333676867,-1206,0,0,0.20993364981263407,-11885894612,2784.91248764622,2351.635172445331,433.277315200889,0.757501377142672,0.7585792759353073,-1206
2115,2022-10-17,2022,270713,270713,687170700.6666669,4270563.233333328,211220,0,96,0.9037504663610532,71348366,15828712733,271905,271905,80036,351941,583216562.5166457,4265797.366666429,212219,0,96,0.7012510619677633,11979371496,-1192,-1192,103954138.1500212,4765.866666899063,-999,0,0,0.20249940439328984,-11908023130,2538.3734828643874,2144.9276862015986,393.4457966627888,0.7802358955794513,0.7804895092035822,-999
2116,2022-10-18,2022,288486,288486,688287323.2666659,4798984.099999999,226814,0,53,0.9231539832088906,76036638,15844127399,289946,289946,65177,355123,584735780.8833276,4793072.98333625,228118,0,42,0.7570025033579866,11997070667,-1460,-1460,103551542.38333833,5911.116663748398,-1304,0,11,0.16615147985090406,-11921034029,2385.860399695881,2016.705803436942,369.1545962589389,0.7862218617194595,0.7867602932959931,-1304
2117,2022-10-19,2022,299088,299088,690019660.4833324,4901689.516666668,236547,0,46,0.9300540309206645,76569017,15873357343,300647,300647,70651,371298,586577259.4333262,4895488.250003478,238010,0,39,0.7560477029232552,12025529665,-1559,-1559,103442401.05000615,6201.266663189977,-1463,0,7,0.17400632799740934,-11948960648,2307.0790552724698,1951.0497674459623,356.02928782650747,0.790894318728936,0.7916593213968541,-1463
2118,2022-10-20,2022,339698,339698,691214404.7333323,5128549.399999996,285329,0,177,1.1751997362363038,92353333,15898123588,350345,350343,75002,425347,588047253.2833258,5119576.150003632,295522,0,42,1.0788532656866059,12072692647,-10647,-10645,103167151.45000648,8973.249996364117,-10193,0,135,0.09634647054969792,-11980339314,2034.7909164414634,1678.4900890936192,356.30082734784423,0.8399490135355522,0.843517104568354,-10193
2119,2022-10-21,2022,381554,381554,693432739.6666679,5541238.833333328,325280,0,231,1.3354492417849118,102143936,15940986256,400827,400827,88537,489364,590441641.8166581,5530374.250005507,344125,0,56,1.3652046329521537,12126358393,-19273,-19273,102991097.8500098,10864.583327821456,-18845,0,175,-0.029755391167241907,-12024214457,1817.390827161209,1473.0585559771625,344.3322711840465,0.8525136677901424,0.8585374737729744,-18845
2120,2022-10-22,2022,382864,382864,695134066.9166659,5574012.866666662,324190,0,195,1.2909806093025205,101569894,15983801351,401200,401200,117155,518355,592286275.783318,5562239.1833390305,342167,0,78,1.2361354670062332,12177575069,-18336,-18336,102847791.13334787,11773.683327631094,-17977,0,117,0.05484514229628723,-12076005175,1815.6161637465677,1476.286828971381,339.3293347751867,0.8467497597057964,0.8528589232303091,-17977
2121,2022-10-23,2022,367879,367879,695957734.5833346,5486050.183333336,314178,0,184,1.2962658917741974,103016051,16019563614,384636,384636,128908,513544,593239869.616561,5474061.016666665,330780,0,49,1.205727259981629,12225429567,-16757,-16757,102717864.96677351,11989.166666671634,-16602,0,135,0.09053863179256827,-12122413516,1891.8115320073573,1542.3409915259128,349.47054048144446,0.8540253724730142,0.8599819049698936,-16602
2122,2022-10-24,2022,375390,375390,697221783.9666666,5505957.500000011,323136,0,189,1.3125309677934942,104478610,16069292576,392371,392371,123254,515625,594623516.1332314,5493853.14999994,339787,0,96,1.222239030303047,12278585841,-16981,-16981,102598267.83343518,12104.35000007134,-16651,0,93,0.09029193749044717,-12174107231,1857.3264710478877,1515.4624478700807,341.864023177807,0.8608007672021099,0.8659839794480224,-16651
2123,2022-10-25,2022,382755,382755,698547335.8000003,5612963.33333333,327035,0,171,1.3155282099515364,104491168,16107075854,401301,401301,118497,519798,596155964.3666716,5600786.10000569,345161,0,45,1.26389289685605,12321772352,-18546,-18546,102391371.43332875,12177.23332764022,-18126,0,126,0.0516353130954863,-12217281184,1825.0508440124893,1485.5581330888076,339.49271092368167,0.8544238481535186,0.8601050084599839,-18126
2124,2022-10-26,2022,398267,398267,699850784.9166662,5825561.850000007,342130,0,196,1.3707462581634922,103942580,16142056531,417404,417404,118939,536343,597655886.1333181,5814488.133339814,360872,0,55,1.3031828512723873,12365140356,-19137,-19137,102194898.78334808,11073.716660193168,-18742,0,141,0.06756340689110485,-12261197776,1757.2402054819158,1431.8403420506704,325.3998634312454,0.8590468203491628,0.8645628695460513,-18742
2125,2022-10-27,2022,376907,376907,699718461.0000008,5131288.6499999985,315952,0,191,1.2794853902952195,99014408,16169946145,394414,394414,131935,526349,597630192.7499508,5119091.916665967,333423,0,86,1.192877729415287,12400755516,-17507,-17507,102088268.25005007,12196.733334031887,-17471,0,105,0.08660766087993244,-12301741108,1856.4751012849347,1515.235749111215,341.2393521737197,0.8382757550271022,0.8453629942142014,-17471
2126,2022-10-28,2022,344598,344598,695767845.0166662,4951698.633333331,287917,0,159,1.271763039831923,95860385,16152653952,359801,359801,150028,509829,593742372.7833015,4940575.433332703,302782,0,67,1.0513740881746336,12415434306,-15203,-15203,102025472.2333647,11123.200000627898,-14865,0,92,0.22038895165728944,-12319573921,2019.071048052125,1650.1965608302964,368.87448722182853,0.8355155862773435,0.8415262881426122,-14865
2127,2022-10-29,2022,355133,355133,695093581.1666658,5188980.700000005,298763,0,152,1.2705746861035134,101390506,16164350693,372208,372208,133965,506173,593029977.566672,5177767.733337648,315588,0,67,1.1232226926366706,12429172870,-17075,-17075,102063603.59999382,11212.96666235663,-16825,0,85,0.1473519934668428,-12327782364,1957.2767981760799,1593.2757425059965,364.00105567008336,0.8412707351893516,0.8478807548467524,-16825
2128,2022-10-30,2022,337500,337500,694744299.9000003,5199245.483333331,284937,0,146,1.231837037037039,101603140,16181733606,352846,352846,115033,467879,593201607.13331,5189157.166665934,299741,0,139,1.0970913419922632,12431296176,-15346,-15346,101542692.76669037,10088.316667396575,-14804,0,7,0.13474569504477585,-12329693036,2058.501629333334,1681.1912481176207,377.3103812157135,0.8442577777777778,0.8494952472183332,-14804
2129,2022-10-31,2022,337746,337746,695121497.2166659,5195056.71666667,286822,0,165,1.2414654799760756,103109655,16213645790,352454,352454,106004,458458,593704668.4666727,5184763.200004649,301054,0,122,1.122207486836341,12466692380,-14708,-14708,101416828.7499932,10293.516662020236,-14232,0,43,0.11925799313973462,-12363582725,2058.119110860427,1684.4883827866124,373.6307280738147,0.8492239730448325,0.8541653662605616,-14232
2130,2022-11-01,2022,333206,333206,695443785.6333337,5205913.133333331,284060,0,159,1.259458112999166,101019360,16238344480,347279,347279,103861,451140,594342393.1333245,5196342.833332725,297679,0,68,1.151930664538675,12511533273,-14073,-14073,101101392.50000918,9570.300000606105,-13619,0,91,0.1075274484604909,-12410513913,2087.1286400404965,1711.4262398052417,375.7024002352548,0.8525056571610355,0.8571753546860017,-13619
2131,2022-11-02,2022,354911,354911,696099754.6666669,5370155.6333333375,302736,0,165,1.2666753073305697,101054258,16271055582,371103,371103,94758,465861,595037134.6333399,5359629.766671681,318539,0,69,1.2131000448631568,12550884947,-16192,-16192,101062620.03332698,10525.866661656648,-15803,0,96,0.05357526246741284,-12449830689,1961.3360945889726,1603.4285215515365,357.9075730374361,0.8529913133151692,0.8583573832601731,-15803
2132,2022-11-03,2022,369149,369149,695496227.1666666,5449409.999999999,313427,0,165,1.2776439865745246,101074960,16280636461,385368,385368,104583,489951,594783460.8166766,5438549.366671723,329287,0,55,1.2116783106882105,12577311704,-16219,-16219,100712766.34999001,10860.633328275755,-15860,0,110,0.06596567588631408,-12476236744,1884.0528544481135,1543.4168400507479,340.63601439736567,0.8490528214894256,0.854474164954018,-15860
2133,2022-11-04,2022,362032,362032,694595135.2333326,5315341.466666657,306206,0,163,1.2618663543554167,97462070,16286585514,379754,379754,121915,501669,594254643.9333235,5306780.450004607,323346,0,65,1.1735108208799263,12607864017,-17722,-17722,100340491.30000913,8561.016662049107,-17140,0,98,0.08835553347549041,-12510401947,1918.6014916729257,1564.8410390234824,353.7604526494433,0.8457981614884872,0.8514617357552521,-17140
2134,2022-11-05,2022,384710,384710,694547437.9333332,5582956.183333337,327002,0,195,1.3336045332848112,97596205,16299412771,404282,404282,119872,524154,594417413.2665533,5573037.116666507,345931,0,71,1.288613651713027,12626635211,-19572,-19572,100130024.66677988,9919.066666830331,-18929,0,124,0.0449908815717841,-12529039006,1805.3792153396926,1470.303929600015,335.0752857396776,0.849996100959164,0.8556675785713932,-18929
2135,2022-11-06,2022,402642,402642,695869553.7999997,5862865.666666673,346408,0,229,1.4072178262575696,98463073,16326729446,422035,422035,114280,536315,595239945.9166709,5850701.950006461,365584,0,93,1.3334234544996186,12649210088,-19393,-19393,100629607.8833288,12163.716660211794,-19176,0,136,0.073794371757951,-12550747015,1728.2587355516805,1410.4042222011703,317.85451335051016,0.8603374710040185,0.8662409515798453,-19176
2136,2022-11-07,2022,396687,396687,696976652.833334,5677008.833333333,338302,0,219,1.3456705160491764,99063812,16360116596,414340,414340,127159,541499,596627741.2665824,5664955.833333008,355741,0,52,1.2260835200064715,12673873312,-17653,-17653,100348911.5667516,12053.000000325032,-17439,0,167,0.11958699604270495,-12574809500,1756.9939343445435,1439.9472444528224,317.04668989172114,0.8528184689692377,0.8585726697880968,-17439
2137,2022-11-08,2022,396852,396852,697956091.1499997,5850880.250000003,340026,0,200,1.365441020833961,100763356,16391403994,413588,413588,135173,548761,597781923.5832386,5839387.016666931,356408,0,52,1.2084331794715255,12714902747,-16736,-16736,100174167.56676114,11493.233333071694,-16382,0,148,0.1570078413624354,-12614139391,1758.7314443419707,1445.3560634816256,313.3753808603451,0.8568080795863445,0.8617464723347873,-16382
2138,2022-11-09,2022,395400,395400,699263339.6166667,5854022.583333337,338706,0,213,1.3891274658573596,100844141,16421946988,414117,414117,119096,533213,599315568.3666564,5842187.383339688,357089,0,72,1.3285234981142633,12749379677,-18717,-18717,99947771.25001025,11835.199993648566,-18383,0,141,0.06060396774309629,-12648535536,1768.4960536587423,1447.2131507923036,321.2829028664387,0.8566160849772383,0.8622901257374124,-18383
2139,2022-11-10,2022,389403,389403,699357655.2833319,5661514.933333342,331480,0,185,1.33934510006343,101659655,16452198025,407370,407370,129580,536950,599616932.4499928,5650276.133339221,349157,0,67,1.2253152062574961,12796032609,-17967,-17967,99740722.8333391,11238.799994121306,-17677,0,118,0.11402989380593387,-12694372954,1795.9739788428233,1471.922165230608,324.05181361221526,0.8512517879934156,0.8571004246753565,-17677
2140,2022-11-11,2022,389441,389441,700108321.2500004,5644435.249999995,333462,0,184,1.3285889261788046,103512371,16494541127,406928,406928,130872,537800,600475088.5665647,5633527.616666571,350507,0,57,1.1935366307177404,12838423780,-17487,-17487,99633232.68343568,10907.633333424106,-17045,0,127,0.13505229546106423,-12734911409,1797.7262826718306,1475.629813054311,322.0964696175197,0.8562580724679734,0.861348936421185,-17045
2141,2022-11-12,2022,362696,362696,699071472.7333322,5409655.666666676,310419,0,176,1.301635529479233,102841097,16522994417,379211,379211,137487,516698,599695893.1998936,5398833.133333086,326773,0,64,1.1381096888317959,12888943310,-16515,-16515,99375579.53343856,10822.533333590254,-16354,0,112,0.16352584064743714,-12786102213,1927.4308862886057,1581.4306367692225,346.00024951938326,0.8558655182301431,0.861718146361788,-16354
2142,2022-11-13,2022,373910,373910,699251940.1833328,5428694.650000002,321438,0,163,1.3304003637238917,100924624,16557032108,392603,392603,126794,519397,600088966.8499082,5417083.449999583,339946,0,67,1.2121325306076087,12926038204,-18693,-18693,99162973.33342457,11611.200000419281,-18508,0,96,0.11826783311628297,-12825113580,1870.1076199709364,1528.48798111555,341.6196388553865,0.8596667647294803,0.8658772347638709,-18508
2143,2022-11-14,2022,379448,379448,700270044.8833336,5489453.816666672,323027,0,214,1.3371133857603676,99511466,16598845121,399595,399595,125685,525280,601244330.9499966,5478015.8000053065,343023,0,72,1.2929218702405985,12967849815,-20147,-20147,99025713.93333697,11438.016661365516,-19996,0,142,0.04419151551976919,-12868338349,1845.496734422987,1504.634269572934,340.8624648500529,0.8513076890641141,0.8584266569902026,-19996
2144,2022-11-15,2022,374064,374064,700173992.4833337,5533292.333333332,316782,0,200,1.3462134821848657,97455761,16606402851,392879,392879,124254,517133,601297437.8332355,5522682.299999732,335474,0,53,1.2762152096269335,12989294049,-18815,-18815,98876554.6500982,10610.033333600499,-18692,0,147,0.06999827255793223,-12891838288,1871.8026660767507,1530.4901453965101,341.3125206802406,0.8468657769793404,0.8538863110525123,-18692
2145,2022-11-16,2022,369819,369819,700891251.7166674,5571998.866666665,311223,0,190,1.3546870225704999,98041091,16631964444,387966,387966,119441,507407,602336085.5999191,5560935.633333864,329263,0,75,1.2634906495180562,13022629034,-18147,-18147,98555166.11674833,11063.23333280161,-18040,0,115,0.09119637305244366,-12924587943,1895.2278052687057,1552.5486398290548,342.6791654396509,0.8415549228135926,0.8486903491543073,-18040
2146,2022-11-17,2022,360440,360440,701828144.733334,5518140.0333333295,306670,0,166,1.3315281322827655,100071914,16667997670,376996,376996,116035,493031,603329202.8999703,5507730.283334161,322899,0,54,1.2428569400301495,13060596054,-16556,-16556,98498941.83336365,10409.749999168329,-16229,0,112,0.088671192252616,-12960524140,1947.142783079941,1600.359693206215,346.7830898737259,0.8508212185107091,0.8565051088075205,-16229
2147,2022-11-18,2022,360830,360830,702471372.0833338,5412295.933333336,306852,0,172,1.2979464013524378,98558104,16702531759,377376,377376,117143,494519,604142831.1333399,5401683.050005016,323118,0,47,1.1815926182815626,13100491069,-16546,-16546,98328540.94999397,10612.883328320459,-16266,0,125,0.11635378307087518,-13001932965,1946.8208632412322,1600.9042205475173,345.91664269371495,0.8504060083695923,0.8562229712541338,-16266
2148,2022-11-19,2022,369392,369392,702984519.3000009,5484028.033333321,316059,0,183,1.3210112834062453,97213410,16718500357,386713,386713,111110,497823,604924287.5999981,5473858.533338717,333052,0,56,1.2160366234585345,13136898949,-17321,-17321,98060231.70000279,10169.499994603917,-16993,0,127,0.10497465994771082,-13039685539,1903.085392482785,1564.2719215542227,338.8134709285623,0.8556195044830424,0.8612381792181799,-16993
2149,2022-11-20,2022,372701,372701,703486920.7666671,5449416.416666663,320948,0,172,1.3283946112299143,96870982,16745473250,390040,390040,119016,509056,605675849.3166659,5441578.183338823,338144,0,52,1.2375789697007706,13174164988,-17339,-17339,97811071.45000124,7838.233327840455,-17196,0,120,0.09081564152914368,-13077294006,1887.5369821027234,1552.8557309934004,334.68125110932306,0.8611406999176283,0.8669469797969439,-17196
2150,2022-11-21,2022,370199,370199,704252458.4500004,5446078.899999998,317469,0,184,1.3106005148582252,96367350,16770927686,395985,395985,122962,518947,606762448.416663,5471671.600005218,337127,0,70,1.1614211085139863,13213077008,-25786,-25786,97490010.03333735,-25592.70000522025,-19658,0,114,0.14917940634423887,-13116709658,1902.3618606479229,1532.2864462458504,370.0754144020725,0.8575630944437992,0.85136305668144,-19658
2151,2022-11-22,2022,374063,374063,704472472.1999999,5508171.1499999985,322884,0,193,1.3463373816709996,95587608,16799155497,399348,399348,130256,529604,605953469.7999225,5517045.549998509,344716,0,69,1.2021982462367842,13202104939,-25285,-25285,98519002.40007746,-8874.399998510256,-21832,0,124,0.14413913543421542,-13106517331,1883.2989956237316,1517.3569663549647,365.9420292687669,0.8631808010950027,0.8631970111281388,-21832
2152,2022-11-23,2022,378618,378618,705183163.4166654,5498671.4333333345,326777,0,176,1.3350131266870564,96264413,16827613837,395151,395151,127301,522452,600350784.3666714,5487615.316672066,343214,0,52,1.2170055813739633,12927132457,-16533,-16533,104832379.04999399,11056.116661268286,-16437,0,124,0.1180075453130931,-12830868044,1862.5188538755829,1519.2946098242733,343.2242440513096,0.8630783533799238,0.8685641691404046,-16437
2153,2022-11-24,2022,389585,389585,706218702.7166661,5648341.316666669,336260,0,179,1.3437966040787006,97271111,16854253882,416945,416945,120192,537137,601639540.099945,5637962.633331941,359740,0,56,1.2344951101860477,12954801474,-27360,-27360,104579162.61672115,10378.683334727772,-23480,0,123,0.10930149389265287,-12857530363,1812.7461342625259,1442.9709916174675,369.7751426450584,0.8631235802199777,0.862799649833911,-23480
2154,2022-11-25,2022,390776,390776,707284546.6499995,5731279.533333343,337535,0,175,1.3857555223452833,98531236,16886515251,407438,407438,122820,530258,591814682.7666628,5719969.666672688,353933,0,58,1.2707021864827919,12537817740,-16662,-16662,115469863.88333666,11309.866660655476,-16398,0,117,0.11505333586249145,-12439286504,1809.948785621429,1452.52696794767,357.4218176737588,0.863755706594059,0.8686794064372985,-16398
2155,2022-11-26,2022,364824,364824,707759489.9833328,5495974.25,314833,0,179,1.3497028704251908,96956308,16914373948,382461,382461,127127,509588,592597948.783332,5487051.766665665,331905,0,52,1.1984524753330215,12576229417,-17637,-17637,115161541.20000076,8922.483334334567,-17072,0,127,0.1512503950921693,-12479273109,1940.0025491287106,1549.4336645653595,390.56888456335105,0.8629722825252725,0.8678139731894232,-17072
2156,2022-11-27,2022,352409,352409,707642437.0166674,5261390.916666668,301582,0,168,1.3086470549844051,97294204,16948967680,380795,380795,123675,504470,592633399.1666505,5260118.566665376,325787,0,53,1.2040260074929354,12617703989,-28386,-28386,115009037.85001683,1272.3500012923032,-24205,0,115,0.10462104749146972,-12520409785,2008.0146563131684,1556.3056215723698,451.70903474079864,0.8557726959300131,0.8555443217479222,-24205
2157,2022-11-28,2022,333496,333496,706783238.7499989,5120059.833333336,282454,0,142,1.2304795259913137,97940108,16985308135,346591,346591,125050,471641,584708621.2999947,5110440.700004041,295385,0,63,1.0482973278404593,12379915368,-13095,-13095,122074617.45000422,9619.133329294622,-12931,0,79,0.18218219815085446,-12281975260,2119.315490290735,1687.0277107599295,432.28777953080544,0.8469486890397486,0.8522581371126198,-12931
2158,2022-11-29,2022,307499,307499,705153759.9166669,4815362.183333325,257352,0,91,1.1529500908946027,98161927,16999934811,317598,317598,110177,427775,583446873.2833513,4807486.366667032,267234,0,72,0.9642685991467345,12407795848,-10099,-10099,121706886.63331556,7875.816666292958,-9882,0,19,0.1886814917478682,-12309633921,2293.1904166084014,1837.060917522627,456.12949908577434,0.8369197948611214,0.8414221752026146,-9882
2159,2022-11-30,2022,302554,302554,703794071.5333335,4818023.866666662,253835,0,103,1.1663967423997037,98532858,17011189868,317134,317134,100476,417610,582575495.2833656,4812222.2666669525,266397,0,68,1.0145446708651793,12443885648,-14580,-14580,121218576.24996793,5801.599999709055,-12562,0,35,0.1518520715345244,-12345352790,2326.176720629486,1837.00106353581,489.17565709367614,0.8389741996470051,0.8400140003910019,-12562
2160,2022-12-01,2022,307440,307440,704065696.5166669,4956952.800000003,260204,0,118,1.2146565183450435,97763594,17037273115,322763,322763,89658,412421,582740096.249997,4947677.88333691,275078,0,60,1.1947572989735857,12457024543,-15323,-15323,121325600.26666987,9274.916663092561,-14874,0,58,0.019899219371457777,-12359260949,2290.091388617834,1805.4736641126678,484.6177245051663,0.8463570127504554,0.852260017412157,-14874
2161,2022-12-02,2022,321056,321056,704912336.6500002,5056512.699999991,273269,0,122,1.2252815708163063,96151139,17061818807,338771,338771,84463,423234,583811442.8000152,5048852.583333849,289449,0,66,1.2201973376429631,12489209444,-17715,-17715,121100893.849985,7660.116666141897,-16180,0,56,0.005084233173343167,-12393058305,2195.6055537040274,1723.3217801996489,472.2837735043786,0.851156807535134,0.8544090255659428,-16180
2162,2022-12-03,2022,314237,314237,705212599.3499995,4933163.749999994,268781,0,132,1.2275734557038174,95863070,17089084995,327733,327733,98509,426242,583820861.6166658,4923946.46666582,282084,0,59,1.1301232633105067,12514441103,-13496,-13496,121391737.7333337,9217.283334174193,-13303,0,73,0.09745019239331065,-12418578033,2244.2061226080937,1781.3917476014494,462.81437500664424,0.8553448511792056,0.8607128363637473,-13303
2163,2022-12-04,2022,304799,304799,705464494.7999997,4902068.133333339,262658,0,118,1.2396562980849684,94985479,17119694760,318807,318807,99914,418721,584329501.3666401,4892422.683332625,276745,0,69,1.1364106409757149,12542110731,-14008,-14008,121134993.43335962,9645.45000071451,-14087,0,49,0.10324565710925349,-12447125252,2314.523652636655,1832.8628335219744,481.6608191146804,0.8617416723808149,0.8680643775073947,-14087
2164,2022-12-05,2022,332838,332838,707037910.1666664,5136165.0833333265,286690,0,135,1.271188986834434,96184334,17166323515,348965,348965,85268,434233,586123548.9166657,5126864.166670971,302568,0,82,1.270992761950385,12587744162,-16127,-16127,120914361.25000072,9300.916662355885,-15878,0,53,0.00019622488404902327,-12491559828,2124.2703963089143,1679.6055447298888,444.6648515790255,0.8613499660495496,0.8670439728912641,-15878
2165,2022-12-06,2022,351694,351694,708250328.0166672,5333817.583333332,301298,0,150,1.3164711368405493,98119204,17199811993,370565,370565,95555,466120,587519415.916663,5323576.850005008,319591,0,82,1.3333004376555888,12634384903,-18871,-18871,120730912.1000042,10240.733328323811,-18293,0,68,-0.016829300815039527,-12536265699,2013.825450581094,1585.4692588794492,428.3561917016448,0.85670497648524,0.8624424864733583,-18293
2166,2022-12-07,2022,372389,372389,710018463.2166673,5617914.200000003,321314,0,180,1.3896677936244082,98999298,17238242382,391768,391768,102508,494276,589482989.0000033,5607718.483339043,340312,0,181,1.3667363982875418,12682601752,-19379,-19379,120535474.21666396,10195.716660959646,-18998,0,-1,0.02293139533686639,-12583602454,1906.6579926277825,1504.673656347643,401.9843362801396,0.8628450357019138,0.8686569602417757,-18998
2167,2022-12-08,2022,372014,372014,711189591.1999991,5673281.099999996,321161,0,150,1.3958318772949398,98023941,17264897391,391254,391254,107151,498405,590998260.9166722,5662082.000005919,340059,0,106,1.331351009721018,12729161705,-19240,-19240,120191330.28332686,11199.099994077347,-18898,0,44,0.06448086757392191,-12631137764,1911.7280295902817,1510.5232429998728,401.20478659040896,0.8633035315875209,0.8691514974926774,-18898
2168,2022-12-09,2022,361232,361232,712471063.383333,5441754.13333334,310697,0,133,1.3368721486468542,97411821,17307284921,378735,378735,112875,491610,592426978.099955,5431243.249999026,328032,0,58,1.218667236223844,12767584627,-17503,-17503,120044085.283378,10510.88333431445,-17335,0,75,0.11820491242301023,-12670172806,1972.3365133303057,1564.2255880759765,408.11092525432923,0.8601037560349027,0.8661253911045982,-17335
2169,2022-12-10,2022,346076,346076,712467101.6000012,5270831.216666666,296905,0,157,1.2970676961129932,94957146,17329980872,359491,359491,114033,473524,592681916.1333234,5259978.350004769,310023,0,157,1.1134113582416012,12807485076,-13415,-13415,119785185.46667778,10852.86666189693,-13118,0,0,0.18365633787139202,-12712527930,2058.701272552853,1648.669691684419,410.03158086843405,0.8579184918919543,0.8623943297606894,-13118
2170,2022-12-11,2022,337268,337268,712074842.8833348,5154395.4499999955,291231,0,118,1.294869362050358,92217835,17352147146,367146,367146,116242,483388,592523250.5499729,5193892.783332125,313512,0,54,1.1181390518589522,12840771370,-29878,-29878,119551592.33336186,-39497.333332129754,-22281,0,64,0.17673031019140573,-12748553535,2111.302711444118,1613.8627427507665,497.4399686933514,0.8635002431300924,0.8539164256181465,-22281
2171,2022-12-12,2022,341326,341326,712574060.6833333,5195247.183333332,291664,0,117,1.2875110598079265,92020849,17382134902,365827,365827,112936,478763,588495611.749978,5191013.300000106,312512,0,109,1.1757383089336158,12668513212,-24501,-24501,124078448.93335533,4233.8833332257345,-20848,0,8,0.11177275087431071,-12576492363,2087.6641705681177,1608.6718906750402,478.99227989307747,0.8545027334571641,0.8542617138702173,-20848
2172,2022-12-13,2022,319445,319445,712027103.5500008,5008134.933333332,270670,0,99,1.2408646245832622,91845371,17389128368,335455,335455,115002,450457,584473174.8666874,5000151.633333729,285228,0,56,1.090259447627641,12552513514,-16010,-16010,127553928.68331337,7983.29999960307,-14558,0,43,0.15060517695562115,-12460668143,2228.9505346773335,1742.3295967169588,486.6209379603747,0.8473133090203321,0.8502720186016008,-14558
2173,2022-12-14,2022,328342,328342,711716451.0666671,5007634.566666665,279631,0,95,1.2434656547136824,93834245,17408884276,352389,352389,106624,459013,584516768.7333438,5014412.70000364,299360,0,37,1.1037922673213845,12566383813,-24047,-24047,127199682.33332324,-6778.133336975239,-19729,0,58,0.13967338739229795,-12472549568,2167.6071019445185,1658.7259214485805,508.881180495938,0.8516455403207631,0.8495157340325606,-19729
2174,2022-12-15,2022,327965,327965,712619536.183334,5016359.966666672,279667,0,103,1.2306770539539273,94727724,17439880423,341317,341317,108336,449653,583255943.7666628,5007031.650003856,292805,0,37,1.0739792684581082,12556373730,-13352,-13352,129363592.41667116,9328.31666281633,-13138,0,66,0.15669778549581914,-12461646006,2172.852396393926,1708.8394183901266,464.0129780037994,0.8527342856707271,0.8578681987712302,-13138
2175,2022-12-16,2022,300001,300001,712615768.3666673,4751378.050000002,253103,0,78,1.161642794524017,93633872,17465668658,308115,308115,106695,414810,583468136.8166647,4744088.933333383,261120,0,47,0.9476676068561551,12543628099,-8114,-8114,129147631.55000257,7289.116666618735,-8017,0,31,0.21397518766786194,-12449994227,2375.377976628969,1893.6700154704079,481.70796115856115,0.8436738544204853,0.8474757801470231,-8017
2176,2022-12-17,2022,268718,268718,711646356.5666652,4554284.33333333,225976,0,63,1.141080984526532,92756779,17478725519,275087,275087,96555,371642,582781888.7166692,4547776.716666402,232316,0,64,0.9029361589916968,12576140502,-6369,-6369,128864467.84999597,6507.616666927934,-6340,0,-1,0.23814482553483518,-12483383723,2648.3017757153043,2118.536640105382,529.7651356099223,0.8409410608891105,0.8445182796715222,-6340
2177,2022-12-18,2022,301567,301567,712131152.9000001,4747688.266666658,258976,0,103,1.217673021252327,93610388,17505177235,314402,314402,81175,395577,583598486.9,4739628.23333635,271550,0,83,1.134972457953784,12605463832,-12835,-12835,128532666.00000012,8060.033330308273,-12574,0,20,0.08270056329854292,-12511853444,2361.4359425931884,1856.2174760338673,505.2184665593211,0.8587677033627684,0.8637031571045986,-12574
2178,2022-12-19,2022,328037,328037,713603703.1,5102044.283333331,281968,0,129,1.275755478802696,94630724,17540257605,343475,343475,76680,420155,585347706.0833255,5094396.233337389,296909,0,60,1.237564708262475,12651603628,-15438,-15438,128255997.01667452,7648.049995942041,-14941,0,69,0.03819077054022091,-12556972904,2175.375653051333,1704.1930448601076,471.1826081912252,0.8595615738468526,0.8644268141786157,-14941
2179,2022-12-20,2022,324021,324021,712448579.3333322,5009386.8,276905,0,125,1.2451106564080736,95126306,17523157917,340778,340778,97274,438052,584882126.9166647,5001705.816665842,292620,0,45,1.1561321486946057,12656995538,-16757,-16757,127566452.41666746,7680.983334157616,-15715,0,80,0.08897850771346794,-12561869232,2198.7728552573203,1716.3142189832229,482.45863627409744,0.854589671657084,0.8586821919255351,-15715
2180,2022-12-21,2022,299920,299920,712607509.6666662,4826429.683333331,255600,0,100,1.181965190717524,92957240,17545562244,309735,309735,103653,413388,585025559.6499802,4818168.499999366,265216,0,57,0.9752169874306695,12682475065,-9815,-9815,127581950.01668596,8261.183333965018,-9616,0,43,0.2067482032868544,-12589517825,2375.991963412464,1888.7938387653323,487.19812464713164,0.8522272606028274,0.8562674544368574,-9616
2181,2022-12-22,2022,290182,290182,712907271.5666665,4653305.56666667,244897,0,101,1.1450262249209109,92249460,17567030513,297523,297523,92112,389635,585636775.3666825,4645881.066666344,251817,0,101,0.9267339946360058,12714968099,-7341,-7341,127270496.19998395,7424.500000325963,-6920,0,0,0.21829223028490508,-12622718639,2456.75910830674,1968.3747991472342,488.38430915950585,0.8439427669531535,0.8463782631930977,-6920
2182,2022-12-23,2022,282479,282479,712605201.4833331,4612227.000000002,240441,0,82,1.151005915483982,91392954,17568467003,289067,289067,89259,378326,585699079.949972,4604925.933332731,246943,0,62,0.9325370183386718,12752648083,-6588,-6588,126906121.53336108,7301.066667270847,-6502,0,20,0.21846889714531026,-12661255129,2522.6838153750655,2026.1706799806689,496.5131353943966,0.8511818577664181,0.8542759982979724,-6502
2183,2022-12-24,2022,283031,283031,712212696.4666668,4611027.633333329,243951,0,106,1.194915044641755,92219781,17573681653,291682,291682,82991,374673,585582624.7333207,4603223.399999839,252486,0,55,1.0256810605514568,12779581217,-8651,-8651,126630071.7333461,7804.233333489858,-8535,0,51,0.1692339840902981,-12687361436,2516.376992155159,2007.6063134966187,508.7706786585402,0.8619232522232547,0.8656207787933434,-8535
2184,2022-12-25,2022,301232,301232,712405119.6666654,4729583.150000001,261231,0,135,1.244807988527115,93936135,17593565730,314913,314913,81730,396643,586058035.5166562,4720927.716669826,274815,0,56,1.1698882874524723,12805539228,-13681,-13681,126347084.15000927,8655.433330175467,-13584,0,79,0.07491970107464274,-12711603093,2364.9715822577464,1861.0156948638391,503.95588739390723,0.8672086630902427,0.8726695944594222,-13584
2185,2022-12-26,2022,328042,328042,714143492.7499996,5060994.766666663,284406,0,130,1.3082654050395979,96386849,17649947997,343813,343813,83905,427718,587881096.7333229,5052220.816670819,299855,0,66,1.2506815238077353,12842280125,-15771,-15771,126262396.01667678,8773.949995843694,-15449,0,64,0.05758388123186253,-12745893276,2176.9879855323393,1709.8861786300195,467.1018069023198,0.8669804476256089,0.8721456140401904,-15449
2186,2022-12-27,2022,327628,327628,715386297.2166672,5060004.96666667,282638,0,125,1.2732611376317051,96917945,17683526596,342140,342140,93928,436068,589609206.3999765,5050276.183332425,296897,0,68,1.1719823513763654,12889647016,-14512,-14512,125777090.81669068,9728.783334244974,-14259,0,57,0.1012787862553397,-12792729071,2183.532229286469,1723.2980838252658,460.23414546120307,0.8626796244521225,0.8677646577424446,-14259
2187,2022-12-28,2022,313439,313439,715793875.9166667,4954777.183333333,269844,0,101,1.25239360768762,96328496,17703173344,327183,327183,98651,425834,590404814.8499768,4945635.783333745,283441,0,43,1.1206831770125996,12930393655,-13744,-13744,125389061.06668997,9141.399999587797,-13597,0,58,0.13171043067502053,-12834065159,2283.678406058808,1804.5094483820271,479.1689576767808,0.8609139258356491,0.8663072347890935,-13597
2188,2022-12-29,2022,306425,306425,716103632.3333331,4850189.083333334,265950,0,101,1.2495423023578358,94880363,17738620056,319985,319985,95743,415728,590888320.5333208,4841374.366670071,279160,0,47,1.1089750991032603,12970880359,-13560,-13560,125215311.80001235,8814.716663262807,-13210,0,54,0.1405672032545755,-12875999996,2336.9621680128357,1846.612561630454,490.3496063823818,0.867912213429061,0.8724158944950544,-13210
2189,2022-12-30,2022,302534,302534,716345520.4500003,4840695.18333333,262884,0,93,1.2572471193320416,93542868,17760478400,315603,315603,85365,400968,591449728.0499889,4832322.883332776,275559,0,53,1.1462286267233388,13012213732,-13069,-13069,124895792.40001142,8372.30000055395,-12675,0,40,0.11101849260870278,-12918670864,2367.8182301823936,1874.030753985193,493.7874761972005,0.8689403505060588,0.8731190768148592,-12675
2190,2022-12-31,2022,301322,301322,714474434.583333,4848905.949999995,261994,0,94,1.2598681808829089,93793658,17721095724,314737,314737,87862,402599,590110481.999988,4840240.283332679,275015,0,70,1.1360683955995643,12989930189,-13415,-13415,124363952.58334506,8665.666667315178,-13021,0,24,0.12379978528334457,-12896136531,2371.1326573676433,1874.9320289638267,496.2006284038166,0.8694818167939945,0.8737930399031573,-13021
