,date,year,num_segs_new,num_segs_distinct_new,sum_seg_length_h_new,sum_seg_day_length_h_new,num_segs_with_idents_new,min_num_idents_new,max_num_idents_new,avg_num_idents_new,total_msg_count_new,total_cumul_msg_count_new,num_segs_old,num_segs_distinct_old,num_segs_stale_old,num_segs_with_stale_old,sum_seg_length_h_old,sum_seg_day_length_h_old,num_segs_with_idents_old,min_num_idents_old,max_num_idents_old,avg_num_idents_old,total_msg_count_old,num_segs_diff,num_segs_distinct_diff,sum_seg_length_h_diff,sum_seg_day_length_h_diff,num_segs_with_idents_diff,min_num_idents_diff,max_num_idents_diff,avg_num_idents_diff,total_msg_count_diff,avg_seg_length_h_new,avg_seg_length_h_old,avg_seg_length_h_diff,prop_segs_with_idents_new,prop_segs_with_idents_old,prop_segs_with_idents_diff
0,2017-01-01,2017,166801,166801,209688399.08333355,2592368.4,129882,0,99,0.8380405393253045,24494883,1292482385,167253,167253,317620,484873,208426630.49999723,2587648.716666665,130512,0,99,0.29189499105951233,1352495062,-452,-452,1261768.5833363235,4719.683333334979,-630,0,0,0.5461455482657922,-1328000179,1257.1171580705964,1246.1757367580685,10.941421312527837,0.7786643964964238,0.7803268102814299,-630
1,2017-01-02,2017,170414,170414,210429931.00000012,2557511.9333333313,132682,0,103,0.8315807386717048,23725939,1306982472,170943,170943,317755,488698,209134618.43332946,2553482.2333333404,133208,0,103,0.292434182255702,1363575659,-529,-529,1295312.5666706562,4029.699999990873,-526,0,0,0.5391465564160027,-1339849720,1234.8159834285923,1223.4172702791543,11.398713149437981,0.7785862663865645,0.7792539033478996,-526
2,2017-01-03,2017,176294,176294,211325868.6166669,2696579.9666666663,137459,0,107,0.841208435908199,26067465,1322633323,176875,176875,321866,498741,210029060.78333008,2691730.549999917,138153,0,109,0.3019362755418147,1374915730,-581,-581,1296807.8333368301,4849.416666749399,-694,0,-2,0.5392721603663844,-1348848265,1198.7127674036944,1187.4434531919721,11.269314211722303,0.7797145677107559,0.7810770318021202,-694
3,2017-01-04,2017,179639,179639,211888505.8833333,2715950.016666664,139372,0,89,0.8338000100200961,26621557,1336642027,180504,180504,322644,503148,210649979.33332986,2710607.8166665803,140112,0,89,0.30204035393164524,1388942326,-865,-865,1238526.5500034392,5342.20000008354,-740,0,0,0.5317596560884508,-1362320769,1179.5239668631716,1167.0100348653207,12.513931997850932,0.7758448889161039,0.7762265656162745,-740
4,2017-01-05,2017,176772,176772,212158545.8833332,2685404.699999998,137501,0,90,0.8378872219582297,26830896,1349670668,177420,177420,329498,506918,210949608.96666276,2680530.449999945,138160,0,90,0.29681329130155,1403676414,-648,-648,1208936.9166704416,4874.250000053085,-659,0,0,0.5410739306566797,-1376845518,1200.1818494067682,1188.9843815052575,11.197467901510663,0.7778437761636459,0.7787171683012062,-659
5,2017-01-06,2017,173661,173661,212296678.49999973,2677392.300000002,134804,0,119,0.8353285999735117,26822129,1361307163,174557,174557,336392,510949,211098461.46666312,2672430.0499999058,135726,0,119,0.28909538916800454,1418982352,-896,-896,1198217.0333366096,4962.250000096392,-922,0,0,0.5462332108055072,-1392160223,1222.4775770034707,1209.3382761313676,13.13930087210315,0.7762479773812198,0.7775454436086779,-922
6,2017-01-07,2017,169599,169599,212409092.4,2635892.4,132300,0,67,0.8375815895140897,26627361,1372456437,170157,170157,343472,513629,211211601.4666624,2631171.5333332783,133045,0,67,0.2808895136372735,1433001527,-558,-558,1197490.933337599,4720.866666721646,-745,0,0,0.5566920758768161,-1406374166,1252.4194859639504,1241.2748312832407,11.144654680709664,0.7800753542178904,0.7818955435274482,-745
7,2017-01-08,2017,165816,165816,212740911.5500002,2591348.949999998,129518,0,88,0.8376513726057792,26032704,1383956207,166429,166429,350511,516940,211526651.36666256,2587019.7666665968,130266,0,90,0.2727647309165454,1446240639,-613,-613,1214260.1833376288,4329.183333401103,-748,0,-2,0.5648866416892337,-1420207935,1282.9938700125451,1270.9723147207671,12.021555291777986,0.7810947073865007,0.7827121475223668,-748
8,2017-01-09,2017,172137,172137,213274756.96666664,2625863.666666667,133601,0,88,0.8306697572282534,25894891,1396593580,172733,172733,355437,528170,212074490.79999572,2621190.316666622,134318,0,88,0.27483196698032064,1459791810,-596,-596,1200266.1666709185,4673.350000044797,-717,0,0,0.5558377902479328,-1433896919,1238.9826531580463,1227.7589736761113,11.22367948193505,0.7761318019949226,0.7776047425795881,-717
9,2017-01-10,2017,174783,174783,213558031.55000016,2644076.533333331,134145,0,105,0.8204001533329903,26035659,1406174338,175421,175421,356867,532288,212346326.24999368,2639198.733333312,134964,0,105,0.2734722556210203,1468205279,-638,-638,1211705.300006479,4877.800000018906,-819,0,0,0.54692789771197,-1442169620,1221.8466987636107,1210.4954723208377,11.35122644277294,0.767494550385335,0.7693719680083912,-819
10,2017-01-11,2017,173809,173809,214014591.01666692,2669386.200000001,133817,0,107,0.8243128951895476,26427621,1416783420,174121,174121,360372,534493,212795642.18332928,2664469.81666658,134498,0,108,0.27238149049660326,1478458631,-312,-312,1218948.8333376348,4916.383333421312,-681,0,-1,0.5519314046929444,-1452031010,1231.320535856411,1222.1136002166843,9.20693563972668,0.769908347668993,0.7724398550433319,-681
11,2017-01-12,2017,174991,174991,214743777.85000023,2685149.6500000022,134942,0,80,0.8286483304855684,27084988,1429790448,175417,175417,363807,539224,213511694.83333007,2679502.66666661,135669,0,82,0.2727141225168076,1490572496,-426,-426,1232083.0166701674,5646.983333392069,-727,0,-2,0.5559342079687608,-1463487508,1227.1704136212734,1217.1664937453613,10.003919875912061,0.7711368013212108,0.7734085065871609,-727
12,2017-01-13,2017,169424,169424,215098228.73333344,2628192.1499999976,130251,0,83,0.8194470677117761,26751325,1441169519,169643,169643,370802,540445,213912882.19999352,2623247.4333332833,130738,0,83,0.25976926421744395,1503214170,-219,-219,1185346.5333399177,4944.716666714288,-487,0,0,0.5596778034943322,-1476462845,1269.585352331036,1260.9590858449421,8.626266486093755,0.7687871848144301,0.770665456281721,-487
13,2017-01-14,2017,165063,165063,215060303.38333356,2575966.4333333303,125653,0,95,0.8118173061194822,26054675,1449579093,165319,165319,379269,544588,213878747.4833301,2571237.0333332717,126203,0,96,0.248900085936526,1514790395,-256,-256,1181555.900003463,4729.40000005858,-550,0,-1,0.5629172201829562,-1488735720,1302.8983078178244,1293.733614910144,9.164692907680319,0.7612426770384642,0.7633907778295296,-550
14,2017-01-15,2017,165828,165828,215303506.5666665,2560756.066666669,126070,0,120,0.8156644233784403,25511306,1458178561,165917,165917,385092,551009,214134374.0499956,2555816.8166666217,126540,0,120,0.24825728799348315,1526936778,-89,-89,1169132.5166709125,4939.250000047497,-470,0,0,0.5674071353849571,-1501425472,1298.3543585321327,1290.6114144421342,7.742944089998446,0.7602455556359602,0.7626704918724423,-470
15,2017-01-16,2017,170492,170492,215980837.21666664,2621464.9166666633,130559,0,61,0.8186777092180278,26278457,1470603925,170856,170856,389152,560008,214810998.48332825,2616571.0999999563,131211,0,61,0.25259103441379094,1539618813,-364,-364,1169838.7333383858,4893.816666706931,-652,0,0,0.5660866748042369,-1513340356,1266.8092181255815,1257.2634176343133,9.54580049126821,0.7657778664101541,0.7679624947324062,-652
16,2017-01-17,2017,174415,174415,216372561.59999982,2663056.6666666707,133449,0,68,0.8167187455207402,27189499,1480791639,174753,174753,389457,564210,215188895.94999638,2657957.4999999655,134157,0,68,0.2559614327998444,1548682309,-338,-338,1183665.6500034332,5099.166666705161,-708,0,0,0.5607573127208958,-1521492810,1240.5616581142667,1231.3888514073944,9.17280670687228,0.7651234125505261,0.7676949751935589,-708
17,2017-01-18,2017,173933,173933,216803999.13333318,2655053.816666667,133340,0,55,0.8217072090977561,27099564,1491680546,174241,174241,393072,567313,215623619.53332794,2649752.233333261,133898,0,56,0.254882225508665,1560246504,-308,-308,1180379.6000052392,5301.583333405666,-558,0,-1,0.5668249835890911,-1533146940,1246.4799614410904,1237.5021925570213,8.977768884069064,0.7666170306957276,0.7684643683174454,-558
18,2017-01-19,2017,172032,172032,217165811.98333386,2607701.200000001,130781,0,77,0.8136102585565468,26354044,1501959196,172244,172244,399099,571343,215990267.08332708,2602217.6666666204,131233,0,78,0.24743280306225945,1571450167,-212,-212,1175544.900006771,5483.533333380707,-452,0,-1,0.5661774554942873,-1545096123,1262.3570730058004,1253.978467077675,8.378605928125353,0.7602132161458334,0.7619017208146582,-452
19,2017-01-20,2017,160527,160527,217106230.68333313,2538145.716666665,120521,0,58,0.7902471235368502,25586441,1509118048,160906,160906,408935,569841,215924045.01666197,2533668.6166666173,120967,0,59,0.22468021781513825,1581626413,-379,-379,1182185.6666711569,4477.100000047591,-446,0,-1,0.565566905721712,-1556039972,1352.4592790205581,1341.926621857867,10.532657162691066,0.7507833573168377,0.751786757485737,-446
20,2017-01-21,2017,154714,154714,216771548.41666666,2487731.8833333333,117082,0,64,0.7985508745168506,24931948,1514426482,154941,154941,417193,572134,215606112.03332976,2484064.4333332684,117449,0,64,0.21771123547980428,1592655527,-227,-227,1165436.3833369017,3667.450000064913,-367,0,0,0.5808396390370463,-1567723579,1401.111395327292,1391.536856179641,9.574539147650967,0.7567640937471722,0.7580240220471018,-367
21,2017-01-22,2017,151333,151333,216835143.56666678,2447727.0666666683,115104,0,101,0.8027660853878537,24754059,1521522785,151657,151657,423020,574677,215684640.73333022,2444263.1999999373,115502,0,101,0.2130988363898285,1603748665,-324,-324,1150502.833336562,3463.866666730959,-398,0,0,0.5896672489980251,-1578994606,1432.834501177316,1422.1871772046804,10.647323972635604,0.7606007942748773,0.7616001899022136,-398
22,2017-01-23,2017,150219,150219,216896024.51666674,2461246.6833333345,114676,0,117,0.8031340908939619,24623037,1529183079,150689,150689,428242,578931,215766017.76666266,2458112.2166666333,115074,0,117,0.20999566442288037,1614288435,-470,-470,1130006.750004083,3134.46666670125,-398,0,0,0.5931384264710815,-1589665398,1443.8654532160829,1431.8630939661332,12.002359249949677,0.7633921141799639,0.7636522904790661,-398
23,2017-01-24,2017,148452,148452,216907621.5000002,2445759.4666666663,113766,0,74,0.8034718292781502,24230244,1534403364,148991,148991,430157,579148,215746535.4999975,2442189.3999999515,114180,0,76,0.20765158474172962,1621121650,-539,-539,1161086.000002712,3570.066666714847,-414,0,-2,0.5958202445364206,-1596891406,1461.1296681755732,1448.0507916585398,13.07887651703345,0.7663487187777868,0.7663550147324335,-414
24,2017-01-25,2017,144065,144065,217024347.04999995,2391731.916666668,111815,0,117,0.8150973518897725,24196212,1541190818,144487,144487,435042,579529,215849460.56666267,2388758.9833332757,112143,0,117,0.20411230499250463,1630594999,-422,-422,1174886.4833372831,2972.933333392255,-328,0,0,0.6109850468972678,-1606398787,1506.4335338215385,1493.9022927091203,12.531241112418229,0.7761427133585534,0.776145950846789,-328
25,2017-01-26,2017,141155,141155,216828913.8166667,2314583.4666666654,107384,0,80,0.7975913003435947,23529691,1546438249,141506,141506,441821,583327,215666492.04999632,2311327.866666613,107689,0,81,0.19449296878079975,1641236065,-351,-351,1162421.766670376,3255.600000052247,-305,0,-1,0.6030983315627949,-1617706374,1536.1050888503185,1524.0801948327019,12.024894017616589,0.7607523644220892,0.7610207341031475,-305
26,2017-01-27,2017,132475,132475,216179059.09999982,2255524.400000001,103358,0,64,0.8176108699754673,23576061,1549501008,132693,132693,450020,582713,215057955.91666448,2252933.6333332867,103502,0,64,0.18667680316038862,1652275369,-218,-218,1121103.183335334,2590.766666714102,-144,0,0,0.6309340668150787,-1628699308,1631.8479645216064,1620.7181683786218,11.12979614298456,0.7802075863370447,0.7800110028411446,-144
27,2017-01-28,2017,133535,133535,215911273.01666674,2255904.6499999994,102621,0,31,0.8104916314074965,24019771,1556033790,133736,133736,456237,589973,214824968.5666633,2252970.4499999667,102748,0,31,0.18403893059513107,1663769615,-201,-201,1086304.4500034451,2934.2000000327826,-127,0,0,0.6264527008123654,-1639749844,1616.889003007951,1606.336129139972,10.552873867979088,0.7684951510839855,0.7682897649099719,-127
28,2017-01-29,2017,139404,139404,216412478.9833334,2267117.1333333324,105674,0,66,0.8022797050299841,24239221,1566536427,139614,139614,458759,598373,215312848.68333092,2264426.1333332565,105844,0,67,0.18778755057464583,1674926904,-210,-210,1099630.3000024855,2691.000000075903,-170,0,-1,0.6144921544553383,-1650687683,1552.4122620823894,1542.2009876039,10.211274478489258,0.7580413761441566,0.7581188132995258,-170
29,2017-01-30,2017,138798,138798,217003484.5166667,2308767.2166666673,107689,0,70,0.8150765861179545,24270524,1577632494,139104,139104,464943,604047,215900019.2833311,2306005.066666648,107883,0,71,0.18814926653058855,1676033523,-306,-306,1103465.2333356142,2762.1500000194646,-194,0,-1,0.6269273195873659,-1651762999,1563.4482090279882,1552.07628309273,11.371925935258332,0.775868528364962,0.7755564182194618,-194
30,2017-01-31,2017,142450,142450,217328670.08333343,2346600.7666666694,110954,0,82,0.8229764829764831,24095038,1585438066,142815,142815,463022,605837,216167072.30000025,2343918.8999999547,111224,0,82,0.19469428245550716,1680666748,-365,-365,1161597.7833331823,2681.866666714661,-270,0,0,0.6282822005209759,-1656571710,1525.6487896337903,1513.6160228267356,12.032766807054713,0.7788978588978589,0.7787977453348738,-270
31,2017-02-01,2017,143840,143840,217945563.71666667,2362574.1333333356,112466,0,78,0.8307911568409342,23932339,1595056668,144226,144226,223776,368002,216761552.89999902,2358964.6666664705,112840,0,80,0.32743300308151246,1669637133,-386,-386,1184010.8166676462,3609.4666668651626,-374,0,-2,0.5033581537594217,-1645704794,1515.194408486281,1502.9297969852803,12.264611501000672,0.7818826473859845,0.7823832041379502,-374
32,2017-02-02,2017,150676,150676,218536311.63333327,2404289.616666666,116182,0,87,0.8223539249780994,24494106,1605267016,151067,151067,229667,380734,217358539.96666247,2401066.5166666135,116462,0,87,0.32739918158084547,1677931826,-391,-391,1177771.6666707993,3223.100000052713,-280,0,0,0.494954743397254,-1653437720,1450.3723992761506,1438.8221118223203,11.550287453830379,0.7710717035227906,0.7709294551424203,-280
33,2017-02-03,2017,150832,150832,218992090.46666682,2407529.4000000036,116789,0,62,0.8221531240055154,24359829,1614413611,151123,151123,234311,385434,217795805.39999682,2404078.8833332937,117040,0,62,0.32397245702247474,1685200885,-291,-291,1196285.0666700006,3450.516666709911,-251,0,0,0.4981806669830407,-1660841056,1451.8940971853906,1441.1823838859525,10.711713299438088,0.7742985573353135,0.7744684793181713,-251
34,2017-02-04,2017,152889,152889,219065606.26666686,2416824.9999999967,118206,0,59,0.8286534675483518,24452453,1621082717,153315,153315,241577,394892,217869359.44999695,2413079.7166666146,118632,0,60,0.3238910892092028,1692721730,-426,-426,1196246.8166699111,3745.2833333821036,-426,0,-1,0.504762378339149,-1668269277,1432.840860144725,1421.057035841222,11.783824303503025,0.7731491474206778,0.7737794736327169,-426
35,2017-02-05,2017,149666,149666,218987782.56666687,2392874.116666666,116268,0,58,0.8293333155158815,24224471,1626513832,149831,149831,248946,398777,217775578.46666285,2389319.0833332986,116588,0,58,0.3136991351055836,1699304451,-165,-165,1212204.1000040174,3555.033333367668,-320,0,0,0.515634180410298,-1675079980,1463.176556911168,1453.4747713534773,9.701785557690755,0.7768497855224299,0.7781300264965194,-320
36,2017-02-06,2017,153688,153688,219554053.14999995,2449578.0999999996,120167,0,48,0.8354718650772986,24607879,1636483450,154172,154172,254666,408838,218337015.0666666,2445463.4166664537,120606,0,49,0.31661440472754837,1705414758,-484,-484,1217038.0833333433,4114.683333545923,-439,0,-1,0.5188574603497502,-1680806879,1428.5699153479775,1416.1911051725774,12.378810175400076,0.7818892821820832,0.7822821264561658,-439
37,2017-02-07,2017,155418,155418,220058337.61666688,2427255.0666666646,122068,0,59,0.8394716184740507,24364974,1644790676,155669,155669,256003,411672,218829633.3833331,2423645.783333136,122385,0,59,0.31895538195456397,1709212349,-251,-251,1228704.2333337963,3609.283333528787,-317,0,0,0.5205162365194868,-1684847375,1415.9128132949008,1405.736745166559,10.17606812834174,0.7854173905210464,0.7861873590759881,-317
38,2017-02-08,2017,163747,163747,220735637.73333353,2511271.783333335,127870,0,70,0.8370718242166281,24579773,1653563613,164131,164131,260825,424956,219502883.8166634,2507263.7333332626,128224,0,70,0.32554899801391285,1716771037,-384,-384,1232753.9166701138,4008.050000072457,-354,0,0,0.5115228262027152,-1692191264,1348.0285912617242,1337.363958159418,10.664633102306198,0.7808998027444778,0.7812296275536005,-354
39,2017-02-09,2017,153794,153794,220968451.8666665,2498056.1833333327,121402,0,58,0.8440186223129638,25099648,1660118106,154242,154242,268158,422400,219740109.0166669,2494511.166666433,121793,0,59,0.3100781249999957,1723856111,-448,-448,1228342.8499996066,3545.016666899435,-391,0,-1,0.533940497312968,-1698756463,1436.7820062334454,1424.6450967743344,12.136909459110939,0.7893806000234079,0.7896228005342254,-391
40,2017-02-10,2017,155476,155476,221283294.1833332,2500084.3,121866,0,59,0.838084334559675,24954676,1667459564,155872,155872,275126,430998,220049717.09999782,2496482.6333331103,122222,0,61,0.30469978979020607,1731203157,-396,-396,1233577.0833353698,3601.666666889563,-356,0,-2,0.533384544769469,-1706248481,1423.2633601541922,1411.7334550143569,11.529905139835364,0.783825156294219,0.7841177376308767,-356
41,2017-02-11,2017,160668,160668,221474997.0166666,2513371.5166666675,126048,0,50,0.8395946921602312,24920467,1673958954,161078,161078,280772,441850,220248882.13333356,2510241.7333330754,126466,0,50,0.30771302478216145,1738341440,-410,-410,1226114.8833330274,3129.783333592117,-418,0,0,0.5318816673780697,-1713420973,1378.4636456336457,1367.3430396040028,11.120606029642886,0.7845246097542758,0.7851227355691032,-418
42,2017-02-12,2017,166033,166033,221433354.21666643,2567318.183333336,128720,0,54,0.8320936199430236,25248922,1678478926,166432,166432,287036,453468,220174271.8666622,2563333.4833333082,129239,0,55,0.30798424585637546,1744815011,-399,-399,1259082.350004226,3984.7000000276603,-519,0,-1,0.524109374086648,-1719566089,1333.6707414590257,1322.9082860667552,10.762455392270567,0.7752675672908398,0.7765273505095174,-519
43,2017-02-13,2017,167331,167331,222031709.91666642,2618719.6666666665,129695,0,64,0.8354518887713576,26035421,1689029102,167918,167918,290722,458640,220742586.9333294,2614557.933333287,130315,0,64,0.3088326356183571,1752829540,-587,-587,1289122.983337015,4161.733333379496,-620,0,0,0.5266192531530005,-1726794119,1326.9012311924653,1314.5856128189318,12.315618373533425,0.7750805290113607,0.7760633166188259,-620
44,2017-02-14,2017,171027,171027,222678807.7666667,2645436.450000001,132668,0,81,0.8364351827489224,25256805,1697620172,171409,171409,294073,465482,221394649.86666554,2641300.0999999125,133105,0,81,0.31019459399074556,1759605128,-382,-382,1284157.9000011683,4136.350000088569,-437,0,0,0.5262405887581768,-1734348323,1302.0096696233152,1291.6162504108042,10.393419212510935,0.7757137761873856,0.7765344876873443,-437
45,2017-02-15,2017,174478,174478,223268387.93333343,2684538.1333333347,135443,0,86,0.8406274716583177,25964794,1706922615,175118,175118,300186,475304,221967717.3333333,2680245.533333102,136086,0,88,0.31301440762122223,1767839357,-640,-640,1300670.6000001132,4292.600000232924,-643,0,-2,0.5276130640370955,-1741874563,1279.6363319921907,1267.5322772835077,12.104054708682952,0.7762755189766045,0.7771102913464064,-643
46,2017-02-16,2017,173877,173877,223804885.25000018,2609316.05,135122,0,57,0.8338825721630809,24239995,1714414025,174334,174334,307288,481622,222518851.316667,2603734.0666665505,135562,0,57,0.30369667498578545,1776436038,-457,-457,1286033.9333331883,5581.983333449345,-440,0,0,0.5301858971772955,-1752196043,1287.144850957862,1276.393883675399,10.75096728246308,0.7771125565773507,0.7775993208438974,-440
47,2017-02-17,2017,175801,175801,224471896.21666655,2681276.2499999963,137066,0,59,0.840211375361915,25350471,1722535056,176242,176242,316346,492588,223181857.36666602,2676039.549999941,137598,0,59,0.3031986162878502,1786284096,-441,-441,1290038.8500005305,5236.700000055134,-532,0,0,0.5370127590740648,-1760933625,1276.8522148148563,1266.3375209465735,10.514693868282848,0.7796656446777891,0.7807333098807322,-532
48,2017-02-18,2017,171962,171962,224633909.1666669,2654375.8499999987,133247,0,60,0.8379467556785809,25062900,1728574128,172301,172301,325366,497667,223315620.31666374,2649026.849999905,133751,0,61,0.29291875892916586,1793164691,-339,-339,1318288.850003153,5349.000000093598,-504,0,-1,0.545027996749415,-1768101791,1306.299700902914,1296.078492386369,10.221208516545175,0.7748630511392052,0.7762636316678371,-504
49,2017-02-19,2017,170315,170315,224812949.23333332,2625187.05,131969,0,137,0.8326806212018902,24737952,1734553655,170454,170454,334180,504634,223489498.98333192,2620350.716666501,132261,0,137,0.28359959891723363,1803355019,-139,-139,1323450.2500014007,4836.333333498798,-292,0,0,0.5490810222846566,-1778617067,1319.9832617992151,1311.1425896918342,8.840672107380897,0.7748524792296627,0.7759336829877855,-292
50,2017-02-20,2017,171242,171242,225283787.63333377,2624643.2333333315,132376,0,119,0.8286752081849086,24543670,1741868108,171422,171422,342419,513841,223969077.9499943,2619651.3999999417,132709,0,118,0.27894426486014146,1811688155,-180,-180,1314709.6833394766,4991.833333389834,-333,0,1,0.5497309433247671,-1787144485,1315.5872252913057,1306.5363719358909,9.050853355414802,0.7730346527137034,0.774165509677871,-333
51,2017-02-21,2017,172239,172239,225839250.91666684,2663990.050000005,133570,0,68,0.8349734961303776,25059877,1750092896,172695,172695,347156,519851,224545191.33333045,2659433.5166665,134075,0,68,0.28002254492152584,1816507965,-456,-456,1294059.583336383,4556.533333505038,-505,0,0,0.5549509512088517,-1791448088,1311.1969467813146,1300.241415983847,10.955530797467645,0.7754921939862632,0.7763687425808506,-505
52,2017-02-22,2017,172158,172158,226471573.55000016,2684267.8833333366,134575,0,97,0.8430976196284815,24945732,1757908620,172509,172509,352499,525008,225180860.86666423,2678952.6999999885,135036,0,97,0.2798547831652091,1823819072,-351,-351,1290712.68333593,5315.183333348017,-461,0,0,0.5632428364632724,-1798873340,1315.4867827809346,1305.328190799693,10.15859198124167,0.7816947222899894,0.7827765507886545,-461
53,2017-02-23,2017,173941,173941,227016322.3333333,2696761.8833333296,136660,0,98,0.8447749524263974,25037058,1765520757,174352,174352,360077,534429,225716453.1166647,2692080.1833331482,137090,0,98,0.27797144241798044,1831148022,-411,-411,1299869.2166686058,4681.7000001813285,-430,0,0,0.566803510008417,-1806110964,1305.134053117628,1294.602029897361,10.532023220266865,0.7856687037558713,0.7862829219051115,-430
54,2017-02-24,2017,177223,177223,227595638.08333328,2724978.1666666665,138891,0,85,0.8439931611585397,25322778,1773478613,177781,177781,365012,542793,226282281.2166649,2718328.3666665712,139463,0,86,0.279086134124795,1838812300,-558,-558,1313356.8666683733,6649.800000095274,-572,0,-1,0.5649070270337447,-1813489522,1284.2330740554742,1272.8147620761774,11.418311979296732,0.78370753231804,0.7844651565690371,-572
55,2017-02-25,2017,169938,169938,228034182.5999997,2708065.86666667,133626,0,88,0.8430839482634833,25106262,1780882916,170396,170396,373724,544120,226727642.1666646,2703565.699999982,134224,0,89,0.2667260898331235,1846601567,-458,-458,1306540.4333350956,4500.166666687932,-598,0,-1,0.5763578584303598,-1821495305,1341.8669314691222,1330.5925148868787,11.274416582243475,0.7863220704021466,0.7877180215498016,-598
56,2017-02-26,2017,171182,171182,228423245.71666697,2707239.800000001,133597,0,90,0.8394924700026865,25199475,1788045580,171579,171579,379883,551462,227107250.76666299,2702663.5166666247,134194,0,91,0.2636537059670445,1856432492,-397,-397,1315994.9500039816,4576.283333376516,-597,0,-1,0.5758387640356419,-1831233017,1334.388228415762,1323.630810103002,10.75741831275991,0.7804383638466661,0.7821120300269847,-597
57,2017-02-27,2017,179201,179201,229306039.43333307,2789602.966666666,140390,0,76,0.84519059603462,25578474,1798653485,179912,179912,383943,563855,227983696.59999904,2784111.299999849,141169,0,76,0.27230582330563663,1866947519,-711,-711,1322342.8333340287,5491.66666681692,-779,0,0,0.5728847727289834,-1841369045,1279.6024544133854,1267.195610076032,12.406844337353505,0.783421967511342,0.7846558317399618,-779
58,2017-02-28,2017,181572,181572,229928906.24999997,2788640.68333333,141450,0,91,0.8405095499306066,25115045,1806270094,182110,182110,387245,569355,228581298.88333184,2782497.6999998423,142024,0,92,0.2712753905735421,1872999010,-538,-538,1347607.366668135,6142.983333487529,-574,0,-1,0.5692341593570645,-1847883965,1266.323586511136,1255.1825758241273,11.141010687008702,0.7790298063578085,0.7798802921311295,-574
59,2017-03-01,2017,179873,179873,230456019.5166668,2763388.9,141036,0,102,0.8480483452213505,25461837,1813540140,179941,179941,218536,398477,229104337.43333292,2758010.8666664865,141427,0,103,0.38714907008435545,1867084366,-68,-68,1351682.0833338797,5378.03333351342,-391,0,-1,0.4608992751369951,-1841622529,1281.2151880308152,1273.219207592116,7.995980438699235,0.7840865499546903,0.7859631768190685,-391
60,2017-03-02,2017,180861,180861,230606408.63333353,2773520.8166666683,141711,0,65,0.8496635537788698,25641650,1819115157,181605,181605,230650,412255,229306620.44999868,2769606.6333331796,142343,0,65,0.3776085189991643,1876272177,-744,-744,1299788.1833348572,3914.183333488647,-632,0,0,0.4720550347797055,-1850630527,1275.0477362910385,1262.6668894028176,12.380846888220958,0.7835354222303316,0.7838055119627764,-632
61,2017-03-03,2017,186116,186116,231267683.7666667,2826406.5166666633,146105,0,41,0.8517644909626265,25737456,1827516173,186977,186977,236442,423419,229969570.73333198,2821879.3999998067,146942,0,34,0.3798837558069002,1884062657,-861,-861,1298113.033334732,4527.1166668566875,-837,0,7,0.4718807351557263,-1858325201,1242.5996892618944,1229.9350761501787,12.664613111715653,0.7850211695931569,0.7858827556330458,-837
62,2017-03-04,2017,178549,178549,231650176.21666715,2804417.800000002,139690,0,52,0.8472856190737549,25297646,1832775854,179334,179334,247027,426361,230350028.48333174,2800091.249999957,140513,0,52,0.3608350669972173,1892814977,-785,-785,1300147.7333354056,4326.550000044983,-823,0,0,0.4864505520765376,-1867517331,1297.403940748294,1284.4749377325645,12.92900301572945,0.7823622647004463,0.7835268270378177,-823
63,2017-03-05,2017,178632,178632,232028835.58333343,2745480.8333333335,140403,0,73,0.8512416588293251,25022227,1839666327,179467,179467,256440,435907,230720406.98333007,2740656.733333259,141288,0,73,0.3548050386894486,1902741696,-835,-835,1308428.6000033617,4824.100000074599,-885,0,0,0.4964366201398765,-1877719469,1298.9208853023727,1285.586804166393,13.334081135979659,0.7859901921268306,0.7872645110243108,-885
64,2017-03-06,2017,177092,177092,232295581.28333318,2701865.8166666697,138355,0,52,0.8422910125810306,24669294,1845355145,177925,177925,267848,445773,230987816.66666818,2697509.3333331565,139217,0,52,0.3404670089933668,1911920388,-833,-833,1307764.6166650057,4356.483333513141,-862,0,0,0.5018240035876638,-1887251094,1311.7226147049737,1298.2313708959853,13.491243808988429,0.7812605877171188,0.7824476605311227,-862
65,2017-03-07,2017,180003,180003,232453921.66666636,2731600.7166666663,138954,0,39,0.8312083687494098,23184022,1847986435,180642,180642,274991,455633,231100852.53332913,2727229.500000012,139572,0,34,0.3322849749688893,1912969459,-639,-639,1353069.1333372295,4371.216666654218,-618,0,5,0.49892339378052053,-1889785437,1291.389152773378,1279.3306790963848,12.058473676993344,0.7719538007699872,0.7726442355598366,-618
66,2017-03-08,2017,177666,177666,232181019.68333337,2738673.0166666675,138236,0,45,0.8257179201422895,14021701,1837263586,178110,178110,283743,461853,230897551.83332846,2734954.349999993,138584,0,32,0.31991780934627057,1908123210,-444,-444,1283467.8500049114,3718.6666666744277,-348,0,13,0.5058001107960189,-1894101509,1306.8399113129883,1296.37612617668,10.463785136308388,0.7780667094435626,0.7780809612037505,-348
67,2017-03-09,2017,181594,181594,232192639.85000035,2783482.8333333316,141884,0,35,0.8301155324515133,13901055,1831325814,182022,182022,289961,471983,230910572.7499912,2779267.900000052,142240,0,43,0.3215115798662259,1902743407,-428,-428,1282067.1000091434,4214.933333279565,-356,0,-8,0.5086039525852873,-1888842352,1278.6360774585082,1268.5860651459232,10.050012312585068,0.7813253741863718,0.7814440012745713,-356
68,2017-03-10,2017,182306,182306,232526460.38333368,2777152.966666664,143556,0,43,0.8356225247660525,14110106,1827883222,182730,182730,297008,479738,231245499.81666285,2773031.316666708,144005,0,39,0.3200830453289051,1897059149,-424,-424,1280960.566670835,4121.649999956135,-449,0,4,0.5155394794371474,-1882949043,1275.4734368771938,1265.5037476969455,9.969689180248224,0.7874452843022172,0.7880753023586713,-449
69,2017-03-11,2017,179634,179634,232558965.7833328,2746872.6500000022,140509,0,44,0.8285402540721695,14081656,1823770350,179913,179913,308173,488086,231281761.51666197,2743298.366666721,140845,0,44,0.30723069295165384,1893201673,-279,-279,1277204.266670823,3574.283333281055,-336,0,0,0.5213095611205156,-1879120017,1294.6266618977074,1285.5200097639524,9.106652133755006,0.7821960207978446,0.7828506000122282,-336
70,2017-03-12,2017,175935,175935,232609259.61666662,2667060.4666666705,138273,0,51,0.8302157046636528,13595348,1819322851,176279,176279,318574,494853,231320359.55000588,2663238.5499998974,138607,0,51,0.29723978636079856,1890920716,-344,-344,1288900.066660732,3821.916666773148,-334,0,0,0.5329759183028542,-1877325368,1322.1318078646466,1312.2400260383022,9.891781826344413,0.785932304544292,0.7862933191134508,-334
71,2017-03-13,2017,175563,175563,232497744.7500001,2685513.4833333334,138129,0,41,0.8330684711471098,13771733,1814912761,175932,175932,328916,504848,231185621.36666203,2682043.183333358,138428,0,41,0.29120646214305773,1888231447,-369,-369,1312123.383338064,3470.2999999755993,-299,0,0,0.541862009004052,-1874459714,1324.2980853027123,1314.0623727727873,10.235712529924967,0.7867773961483912,0.786826728508742,-299
72,2017-03-14,2017,178563,178563,232730217.79999998,2749789.5166666666,140090,0,45,0.8286151106332222,14152749,1812005348,179012,179012,333933,512945,231410238.71666062,2745988.6333333454,140425,0,45,0.2903332715983161,1880776336,-449,-449,1319979.0833393633,3800.883333321195,-335,0,0,0.5382818390349061,-1866623587,1303.3507378348256,1292.7079677153522,10.642770119473425,0.7845410303366319,0.7844446182378835,-335
73,2017-03-15,2017,185754,185754,233107729.13333327,2798216.8166666725,144842,0,43,0.8333441002616361,16975195,1811931633,186307,186307,338908,525215,231780773.73333108,2793945.583333288,145383,0,39,0.2974667517112012,1879346037,-553,-553,1326955.4000021815,4271.233333384618,-541,0,4,0.5358773485504349,-1862370842,1254.9271032297193,1244.0797915984429,10.847311631276398,0.7797517146333323,0.7803410499873864,-541
74,2017-03-16,2017,196505,196505,233877358.36666664,2908259.583333332,152661,0,51,0.8484720490572762,25609064,1822278549,197746,197746,342513,540259,232540193.71666545,2903252.8166665686,153910,0,51,0.3159577165766737,1883294026,-1241,-1241,1337164.650001198,5006.766666763462,-1249,0,0,0.5325143324806025,-1857684962,1190.1852795942425,1175.9539698232352,14.231309771007318,0.7768809953945193,0.7783216853943948,-1249
75,2017-03-17,2017,193660,193660,234414534.4833332,2907828.916666664,151927,0,48,0.8618041929154198,25715040,1830898900,194963,194963,354467,549430,233091984.13332993,2902741.316666565,153211,0,39,0.3105054329031886,1892783607,-1303,-1303,1322550.3500032723,5087.600000099279,-1284,0,9,0.5512987600122312,-1867068567,1210.443738941099,1195.570360187984,14.873378753114821,0.7845037694929258,0.7858465452419177,-1284
76,2017-03-18,2017,188929,188929,234639008.36666644,2904784.8000000003,147783,0,81,0.8553213111803893,25721327,1837155023,190216,190216,365585,555801,233267921.88332993,2899585.549999858,149086,0,81,0.2979069846941602,1903554496,-1287,-1287,1371086.4833365083,5199.250000142492,-1303,0,0,0.5574143264862291,-1877833169,1241.942784679252,1226.3317590703723,15.6110256088798,0.7822144826892642,0.7837721327333137,-1303
77,2017-03-19,2017,188204,188204,234938349.00000012,2854585.633333334,146619,0,110,0.8470702004208199,25382234,1843347816,189337,189337,375014,564351,233548632.21666437,2849784.933333207,147762,0,111,0.2882000740673776,1913429574,-1133,-1133,1389716.7833357453,4800.700000126846,-1143,0,-1,0.5588701263534424,-1888047340,1248.3175118488455,1233.507619834815,14.809892014030538,0.7790429533910013,0.7804179848629692,-1143
78,2017-03-20,2017,187867,187867,235613166.78333366,2836736.566666667,146232,0,128,0.8470194339612606,25332204,1853647067,188761,188761,387770,576531,234244316.89999762,2832384.866666532,147170,0,128,0.2813049081489111,1923599613,-894,-894,1368849.8833360374,4351.700000134762,-938,0,0,0.5657145258123495,-1898267409,1254.1487689872818,1240.9571728270014,13.191596160280369,0.7783804499992015,0.7796631719475952,-938
79,2017-03-21,2017,189034,189034,235889513.98333302,2857083.3166666673,146644,0,101,0.8459483479162486,25322639,1859345513,190202,190202,395254,585456,234486862.2166618,2851879.7999999025,147780,0,102,0.27948129321417786,1928100048,-1168,-1168,1402651.7666712105,5203.516666764859,-1136,0,-1,0.5664670547020707,-1902777409,1247.8681823552008,1232.8306864105625,15.037495944638295,0.7757546261519092,0.7769634388702538,-1136
80,2017-03-22,2017,188720,188720,236508413.78333336,2891391.599999993,147782,0,92,0.8555055108096655,25538400,1867945569,189928,189928,401904,591832,235099530.9833309,2886173.7666665195,148944,0,92,0.2788223685099784,1937298086,-1208,-1208,1408882.8000024557,5217.833333473653,-1162,0,0,0.5766831422996872,-1911759686,1253.2238966899818,1237.8350268698186,15.388869820163109,0.7830754557015684,0.7842129649130196,-1162
81,2017-03-23,2017,191471,191471,237249212.86666656,2921827.0499999975,150082,0,119,0.8525364154362804,25514203,1876650093,192638,192638,409185,601823,235824208.21666545,2917021.066666591,151144,0,119,0.27653479511417584,1945316560,-1167,-1167,1425004.6500011086,4805.983333406504,-1062,0,0,0.5760016203221046,-1919802357,1239.0869263056366,1224.1832256183382,14.903700687298397,0.7838367167873986,0.7846011690320706,-1062
82,2017-03-24,2017,190733,190733,237703429.4833332,2894057.7333333334,148044,0,82,0.8413384154813268,25329204,1882970504,191831,191831,417957,609788,236278561.28332886,2889067.449999829,149121,0,82,0.26810465276457046,1954026124,-1098,-1098,1424868.2000043392,4990.2833335045725,-1077,0,0,0.5732337627167563,-1928696920,1246.2627310603473,1231.701660749977,14.561070310370269,0.7761845092354234,0.7773561103262768,-1077
83,2017-03-25,2017,186075,186075,237689287.66666678,2849689.9166666637,144905,0,69,0.844433696090286,24982237,1886365612,186998,186998,430813,617811,236280418.34999844,2845100.2333331723,145914,0,69,0.2592799416002659,1961952125,-923,-923,1408869.3166683316,4589.683333491441,-1009,0,0,0.58515375449002,-1936969888,1277.3843217340684,1263.5451627824814,13.839158951587024,0.778745129652022,0.7802971154771708,-1009
84,2017-03-26,2017,185361,185361,237849735.51666638,2868465.8166666683,146026,0,47,0.8567336171039212,25140252,1890861504,186412,186412,439777,626189,236431657.4666603,2864055.666666637,147122,0,47,0.25855292890804926,1970890408,-1051,-1051,1418078.0500060916,4410.150000031106,-1096,0,0,0.5981806881958719,-1945750156,1283.1703298788116,1268.328527491043,14.841802387768666,0.7877924698291442,0.7892303070617771,-1096
85,2017-03-27,2017,196541,196541,238580868.59999973,2968542.45,153366,0,57,0.8500669071593203,25249449,1899451646,197790,197790,443958,641748,237122778.66666222,2963561.4166665385,154546,0,41,0.26534247087642143,1977327023,-1249,-1249,1458089.9333375096,4981.033333461732,-1180,0,16,0.5847244362828989,-1952077574,1213.898721386376,1198.8613108178483,15.037410568527775,0.780325733561954,0.7813640730067243,-1180
86,2017-03-28,2017,193640,193640,239052155.70000014,2962824.9500000007,152027,0,52,0.8509089031191905,24355756,1904614009,194723,194723,449277,644000,237563547.1333307,2957553.8833332444,153079,0,36,0.2606195652173895,1979428497,-1083,-1083,1488608.5666694343,5271.066666756291,-1052,0,16,0.590289337901801,-1955072741,1234.518465709565,1220.0076371734756,14.51082853608932,0.7851012187564553,0.7861372308355973,-1052
87,2017-03-29,2017,194044,194044,239528541.66666648,2981662.7000000016,152886,0,57,0.8547752056234665,25511090,1910185825,195085,195085,456963,652048,238004961.5333289,2976632.08333327,153798,0,35,0.258898117929968,1986923658,-1041,-1041,1523580.1333375871,5030.616666731425,-912,0,22,0.5958770876934986,-1961412568,1234.4032367229415,1220.0064665829198,14.396770140021772,0.7878934674609882,0.7883640464412949,-912
88,2017-03-30,2017,192161,192161,240017428.3833333,2889393.950000002,150697,0,51,0.8474924672540218,23787807,1915926618,193108,193108,465456,658564,238492758.86666232,2884652.483333194,151515,0,51,0.2508321135075719,1991578149,-947,-947,1524669.516670972,4741.466666807886,-818,0,0,0.5966603537464499,-1967790342,1249.0433978972492,1235.0226757392875,14.0207221579617,0.7842226050030964,0.7846127555564761,-818
89,2017-03-31,2017,189818,189818,239931626.41666695,2872263.2333333367,149690,0,85,0.8554562791726825,25918974,1919689263,191021,191021,479356,670377,238373350.19999525,2867598.2499999274,150882,0,85,0.24762036883723176,1997579135,-1203,-1203,1558276.2166717052,4664.983333409298,-1192,0,0,0.6078359103354507,-1971660161,1264.008821169051,1247.890808863922,16.118012305129014,0.7885974986566079,0.7898712706979861,-1192
90,2017-04-01,2017,189829,189829,239813747.55000046,2907576.216666666,149694,0,51,0.862945071617087,26095796,1923342489,190976,190976,248034,439010,238243280.04999653,2902455.249999854,150930,0,54,0.3811644381676947,1984377439,-1147,-1147,1570467.500003934,5120.966666812077,-1236,0,-3,0.4817806334493923,-1958281643,1263.3146018258562,1247.5037703690334,15.810831456822825,0.7885728734808696,0.7903087298927614,-1236
91,2017-04-02,2017,192195,192195,240232432.4666663,2978619.250000002,151749,0,52,0.8659226306615677,26476208,1929871993,193458,193458,253457,446915,238651219.58332878,2973827.5833332,152943,0,36,0.38055558663280625,1993581531,-1263,-1263,1581212.8833375275,4791.666666802019,-1194,0,16,0.48536704402876146,-1967105323,1249.9411143196562,1233.6073958343868,16.3337184852694,0.7895574806836806,0.7905746983841454,-1194
92,2017-04-03,2017,194715,194715,240853301.43333316,2983602.0500000045,152094,0,47,0.8517166114577718,26501491,1938873776,195845,195845,260485,456330,239305395.3666634,2979200.2333331956,153125,0,38,0.37079306642122967,2002986475,-1130,-1130,1547906.0666697621,4401.816666808911,-1031,0,9,0.4809235450365421,-1976484984,1236.9529899254458,1221.9122028474733,15.040787077972482,0.7811108543255527,0.7818683142280886,-1031
93,2017-04-04,2017,193803,193803,241171236.36666664,2941171.6000000034,151229,0,59,0.8449662801917425,26495340,1946285248,194986,194986,270949,465935,239593345.3333314,2936129.199999846,152329,0,36,0.35830105057572303,2007126929,-1183,-1183,1577891.0333352387,5042.4000001573,-1100,0,23,0.48666522961601943,-1980631589,1244.4143608028082,1228.7720417534151,15.642319049393109,0.7803233180084932,0.7812304473141661,-1100
94,2017-04-05,2017,192814,192814,241322408.49999958,2822382.2666666685,150070,0,42,0.8396900639995019,24568507,1949934183,193947,193947,281777,475724,239727438.74999982,2817779.449999906,151073,0,45,0.346253289722611,2014418684,-1133,-1133,1594969.7499997616,4602.8166667623445,-1003,0,-3,0.49343677427689087,-1989850177,1251.5813607933012,1236.0461298705306,15.535230922770552,0.7783148526559275,0.7789396072122796,-1003
95,2017-04-06,2017,191905,191905,241617670.63333356,2916632.3833333342,147903,0,49,0.8302753966806491,24026168,1952845317,192969,192969,293119,486088,240011296.59999758,2911927.999999877,148957,0,49,0.3339950790803321,2019140433,-1064,-1064,1606374.0333359838,4704.383333457168,-1054,0,0,0.496280317600317,-1995114265,1259.0483345057896,1243.7816260642776,15.266708441512037,0.7707094656210104,0.7719219149189767,-1054
96,2017-04-07,2017,193586,193586,242028582.11666682,2937414.7666666666,149229,0,47,0.8352101908195838,24693574,1957118189,194766,194766,298096,492862,240493643.43332645,2932908.5666665686,150318,0,47,0.33381555080327124,2021105849,-1180,-1180,1534938.6833403707,4506.200000097975,-1089,0,0,0.5013946400163125,-1996412275,1250.2380446760965,1234.7824745249502,15.455570151146276,0.7708666949056233,0.7717876836819568,-1089
97,2017-04-08,2017,191341,191341,241806361.35000032,2905099.1166666686,147273,0,57,0.8341285976345892,24342237,1958056196,192770,192770,309156,501926,240282392.21666265,2899858.166666558,148585,0,57,0.3250837772898793,2026362908,-1429,-1429,1523969.1333376765,5240.950000110548,-1312,0,0,0.50904482034471,-2002020671,1263.7456757830278,1246.4719210284932,17.273754754534593,0.7696886710114403,0.7707890231882555,-1312
98,2017-04-09,2017,188905,188905,241841417.41666627,2873801.116666665,145791,0,52,0.8345676398189578,23970533,1961074674,190329,190329,320768,511097,240313401.84999776,2868707.933333311,147212,0,53,0.315491971191381,2032510373,-1424,-1424,1528015.5666685104,5093.183333353605,-1421,0,-1,0.5190756686275768,-2008539840,1280.2277198415409,1262.6210501289754,17.606669712565463,0.7717688785368306,0.7734606917495495,-1421
99,2017-04-10,2017,187980,187980,242096180.73333308,2897855.833333335,146753,0,40,0.8442015107990197,24041105,1965065529,189230,189230,331184,520414,240577980.01666248,2892984.449999904,147945,0,41,0.31065459422690556,2039011414,-1250,-1250,1518200.7166706026,4871.383333431091,-1192,0,-1,0.5335469165721142,-2014970309,1287.882650991239,1271.3522169669845,16.53043402425442,0.7806841153314182,0.7818263488875971,-1192
100,2017-04-11,2017,189285,189285,242188504.89999992,2908462.4333333364,146754,0,46,0.8352325857833425,24150098,1967163460,190551,190551,337861,528412,240671620.73333013,2903327.366666632,147886,0,38,0.3048132896300663,2036437024,-1266,-1266,1516884.166669786,5135.0666667046025,-1132,0,8,0.5304192961532761,-2012286926,1279.4912692500723,1263.0299538356142,16.461315414458113,0.7753070766304778,0.7760966880257779,-1132
101,2017-04-12,2017,194102,194102,242863328.0833337,2959665.516666664,148802,0,42,0.8279409794850128,25086232,1974563215,195404,195404,344201,539605,241341361.8499993,2954299.249999895,150023,0,35,0.30387968977307644,2041716278,-1302,-1302,1521966.2333343923,5366.266666768584,-1221,0,7,0.5240612897119363,-2016630046,1251.214969878382,1235.0891581032083,16.125811775173588,0.7666175515965833,0.7677580806943564,-1221
102,2017-04-13,2017,200558,200558,243549932.33333305,3011064.216666664,152988,0,33,0.821188883016385,25424234,1981536553,201714,201714,350896,552610,241993093.6999964,3006064.449999884,154059,0,43,0.30296773493060264,2047407370,-1156,-1156,1556838.6333366334,4999.766666780226,-1071,0,-10,0.5182211480857823,-2021983136,1214.36159282269,1199.6841751192105,14.677417703479477,0.7628117552029837,0.763749665367798,-1071
103,2017-04-14,2017,201366,201366,243980561.11666697,3016725.266666666,153699,0,35,0.824607927852766,25277058,1986335901,202654,202654,358633,561287,242428856.99999702,3011123.166666504,154931,0,30,0.3015302331962045,2054648090,-1288,-1288,1551704.1166699529,5602.100000162143,-1232,0,5,0.5230776946565616,-2029371032,1211.6273905061776,1196.26978495365,15.357605552527502,0.7632817854056793,0.7645099529246894,-1232
104,2017-04-15,2017,197713,197713,244434547.43333316,3019402.833333333,151412,0,47,0.8303197058362368,25203312,1992174072,198941,198941,368140,567081,242847564.9833299,3014321.9166665794,152556,0,39,0.29508130231836094,2061892981,-1228,-1228,1586982.4500032663,5080.91666675359,-1144,0,8,0.5352384035178759,-2036689669,1236.3099413459568,1220.701439036347,15.608502309609776,0.7658171187529399,0.7668404200240272,-1144
105,2017-04-16,2017,192242,192242,244557850.2666666,2960935.4833333353,148401,0,61,0.8372416017311513,25357961,1996311904,193546,193546,378679,572225,242999809.48333094,2955644.416666546,149660,0,61,0.287722486784045,2071177950,-1304,-1304,1558040.783335656,5291.066666789353,-1259,0,0,0.5495191149471063,-2045819989,1272.1353828334422,1255.514500342714,16.620882490728263,0.7719488977434692,0.7732528701187315,-1259
106,2017-04-17,2017,193851,193851,245097946.54999974,2942752.6499999966,150031,0,42,0.8389175191255149,25088725,2003605992,195008,195008,389954,584962,243549308.26666498,2937881.1166665293,151144,0,41,0.2832372017327623,2080344779,-1157,-1157,1548638.2833347619,4871.53333346732,-1113,0,1,0.5556803173927527,-2055256054,1264.362559646325,1248.9195738978144,15.442985748510637,0.7739500956920522,0.7750656383327863,-1113
107,2017-04-18,2017,202340,202340,245678941.4833332,3046276.9333333373,155075,0,46,0.8310912325788276,24954262,2010042313,203724,203724,395478,599202,244104941.99999607,3040931.316666512,156367,0,43,0.28625738899403086,2084515485,-1384,-1384,1573999.4833371341,5345.616666825488,-1292,0,3,0.5448338435847967,-2059561223,1214.1886996309836,1198.2139659539184,15.97473367706516,0.766408026094692,0.7675433429541929,-1292
108,2017-04-19,2017,200756,200756,246293572.84999973,3038910.4333333317,153631,0,40,0.8288071091274989,24848577,2016420170,202078,202078,398721,600799,244702112.48332986,3033159.6166665466,154893,0,47,0.2823024006364866,2086827088,-1322,-1322,1591460.3666698635,5750.816666785162,-1262,0,-7,0.5465047084910123,-2061978511,1226.8304451672664,1210.929010002721,15.901435164545319,0.7652623084739684,0.7665010540484367,-1262
109,2017-04-20,2017,195071,195071,246431692.6333336,2982135.3666666667,151455,0,51,0.8416268948229103,24741289,2020053796,196453,196453,410938,607391,244852680.76666456,2976918.183333211,152734,0,34,0.2760528226463691,2094241627,-1382,-1382,1579011.866669029,5217.183333455585,-1279,0,17,0.5655740721765412,-2069500338,1263.292301948181,1246.3677356246255,16.924566323555382,0.7764096149607066,0.7774582215593552,-1279
110,2017-04-21,2017,191697,191697,246585508.98333323,2938101.5166666643,148751,0,35,0.8384273097648887,24598602,2023616221,193023,193023,420866,613889,244995605.44999793,2933200.8833332187,149961,0,32,0.26766565291119515,2100052154,-1326,-1326,1589903.5333352983,4900.633333445527,-1210,0,3,0.5707616568536935,-2075453552,1286.3295147202784,1269.2560236344784,17.073491085800015,0.7759693683260562,0.776907415178502,-1210
111,2017-04-22,2017,190641,190641,246737856.59999958,2943321.0666666646,147799,0,37,0.8382981625148845,24562571,2027155959,191936,191936,431005,622941,245156961.98333228,2938227.016666554,149058,0,43,0.2622832659914824,2104013267,-1295,-1295,1580894.6166673005,5094.050000110641,-1259,0,-6,0.5760148965234022,-2079450696,1294.2538939682418,1277.2849386427365,16.96895532550525,0.7752739442197638,0.7766026175391797,-1259
112,2017-04-23,2017,192226,192226,246970019.2999999,2951271.25,147843,0,37,0.8314015793909254,24358770,2030275744,193405,193405,436534,629939,245414709.4499968,2945612.4999998817,148915,0,36,0.25853138160996564,2111335443,-1179,-1179,1555309.8500030935,5658.750000118278,-1072,0,1,0.5728701977809598,-2086976673,1284.7898791006414,1268.9160541350886,15.873824965552785,0.7691103180631133,0.7699645820945684,-1072
113,2017-04-24,2017,199280,199280,247684202.43333328,3025081.4,152781,0,40,0.8317794058611004,24778556,2037483948,200655,200655,443052,643707,246156933.26666182,3020009.1666665543,154042,0,33,0.26304825021321854,2118239927,-1375,-1375,1527269.166671455,5072.23333344562,-1261,0,7,0.5687311556478819,-2093461371,1242.8954357353134,1226.767004393919,16.12843134139439,0.766664993978322,0.7676957962672248,-1261
114,2017-04-25,2017,199803,199803,248148765.3166668,3032102.1666666693,154422,0,40,0.8419993693788391,24847745,2043023625,201324,201324,447059,648383,246597286.6666655,3025714.7499998426,155819,0,35,0.2658120277675423,2120533001,-1521,-1521,1551478.6500013173,6387.416666826699,-1397,0,5,0.5761873416112968,-2095685256,1241.9671642401106,1224.877742676807,17.08942156330363,0.7728712782090359,0.7739713099282748,-1397
115,2017-04-26,2017,196777,196777,248398637.46666676,2999506.133333337,152903,0,57,0.8460389171498698,24836112,2046598686,198272,198272,457116,655388,246832459.71666783,2994374.3666665372,154246,0,35,0.2602473649197095,2126798250,-1495,-1495,1566177.749998927,5131.766666799784,-1343,0,22,0.5857915522301602,-2101962138,1262.3357275833393,1244.918393503207,17.417334080132377,0.7770369504566083,0.7779515009683667,-1343
116,2017-04-27,2017,196481,196481,248839389.30000013,3021392.4999999986,151183,0,39,0.8322687689903867,24928810,2051637540,197874,197874,466703,664577,247252214.14999932,3016243.6999997147,152466,0,35,0.2516683544570397,2132011427,-1393,-1393,1587175.1500008106,5148.800000283867,-1283,0,4,0.580600414533347,-2107082617,1266.4806739582968,1249.5437204988998,16.936953459397046,0.7694535349473995,0.7705206343430668,-1283
117,2017-04-28,2017,201266,201266,249315421.4166667,3030566.3,154646,0,37,0.8281428557232717,24153073,2056503712,202740,202740,473612,676352,247726677.28332794,3025265.249999934,156032,0,34,0.2520374006434497,2137508885,-1474,-1474,1588744.1333387494,5301.050000065938,-1386,0,3,0.576105455079822,-2113355812,1238.7359087807513,1221.8934462036498,16.842462577101514,0.7683662416901017,0.769616257275328,-1386
118,2017-04-29,2017,204650,204650,249803095.68333334,3109770.833333336,156611,0,48,0.826337649645737,25139798,2061560657,206221,206221,480077,686298,248203987.38333046,3104013.599999883,158141,0,34,0.2530110826492288,2143083141,-1571,-1571,1599108.300002873,5757.233333452605,-1530,0,14,0.5733265669965082,-2117943343,1220.6356984282108,1203.5825031559855,17.053195272225366,0.7652626435377474,0.7668520664723767,-1530
119,2017-04-30,2017,199853,199853,249867174.10000005,3045261.8999999943,153929,0,54,0.8303903368976194,24398384,2063869027,201347,201347,488669,690016,248261075.73333165,3039637.999999921,155411,0,54,0.24658848490470617,2151127447,-1494,-1494,1606098.3666684031,5623.900000073481,-1482,0,0,0.5838018519929132,-2126729063,1250.2548077837214,1233.0011161493921,17.253691634329243,0.7702111051622943,0.7718565461616016,-1482
120,2017-05-01,2017,187916,187916,249693427.88333344,2880120.8499999945,145022,0,38,0.8228623427488889,23965117,2067214211,189086,189086,235657,424743,248073604.28333032,2874883.983333319,146234,0,31,0.37207205298262364,2136888833,-1170,-1170,1619823.6000031233,5236.866666675545,-1212,0,7,0.4507902897662653,-2112923716,1328.7502282048013,1311.9617755060149,16.788452698786386,0.7717384363226122,0.7733729625672974,-1212
121,2017-05-02,2017,183663,183663,249840019.0333336,2892339.6000000006,142767,0,38,0.8321654334297051,25285643,2072789649,184636,184636,250481,435117,248228542.6833322,2887937.299999785,143715,0,32,0.35826226049546234,2142482315,-973,-973,1611476.3500013947,4402.300000215415,-948,0,6,0.4739031729342427,-2117196672,1360.317641731506,1344.4211458400973,15.896495891408676,0.7773313078845494,0.7783693320912498,-948
122,2017-05-03,2017,183701,183701,250119255.46666673,2886377.8166666697,142526,0,37,0.8299737072743202,26336316,2078361183,184746,184746,257979,442725,248495194.39999896,2881983.2333330875,143479,0,40,0.35135354904286537,2147659303,-1045,-1045,1624061.0666677654,4394.583333582152,-953,0,-3,0.4786201582314548,-2121322987,1361.5563087118019,1345.0640035508154,16.49230516098646,0.7758585963059537,0.7766284520368506,-953
123,2017-05-04,2017,184339,184339,250404644.0333332,2885951.7333333343,142356,0,30,0.8280342195628714,26570263,2083196339,185389,185389,269004,454393,248786974.39999825,2880796.5333331805,143300,0,25,0.34252288217468035,2155752966,-1050,-1050,1617669.6333349645,5155.2000001538545,-944,0,5,0.485511337388191,-2129182703,1358.3921147089504,1341.9726866210954,16.419428087855067,0.7722511242873185,0.7729692700214145,-944
124,2017-05-05,2017,186774,186774,250895870.46666664,2894803.3166666664,143635,0,42,0.8248310792722756,26522719,2091029773,187611,187611,278830,466441,249287592.64999765,2890311.4666666365,144410,0,37,0.33575307487978795,2162172261,-837,-837,1608277.8166689873,4491.850000029895,-775,0,5,0.48907800439248766,-2135649542,1343.3126156031708,1328.7472091188558,14.565406484314963,0.7690310214483814,0.7697309859230003,-775
125,2017-05-06,2017,185415,185415,251164815.15000013,2903689.850000002,141927,0,56,0.8211309764582159,26531637,2096862834,186270,186270,289305,475575,249543258.41666597,2899278.6833332554,142758,0,50,0.32545865531198664,2168220927,-855,-855,1621556.733334154,4411.166666746605,-831,0,6,0.4956723211462292,-2141689290,1354.6089321252332,1339.6857165226068,14.923215602626442,0.7654558692662405,0.7664036076662909,-831
126,2017-05-07,2017,183640,183640,251588158.18333325,2876196.1833333313,141277,0,38,0.8223208451317805,26114316,2104046517,184557,184557,298334,482891,249954863.96666554,2871888.3666665265,142247,0,31,0.31902230524072817,2178132894,-917,-917,1633294.2166677117,4307.81666680472,-970,0,7,0.5032985398910523,-2152018578,1370.0073959014007,1354.350493162901,15.656902738499639,0.7693149640601176,0.7707483324934844,-970
127,2017-05-08,2017,183910,183910,252170268.46666667,2895311.233333332,142185,0,37,0.8274155837094217,26338319,2112207640,184794,184794,309827,494621,250498578.6999997,2890929.599999801,143069,0,41,0.31270407038925,2188969489,-884,-884,1671689.7666669786,4381.633333531208,-884,0,-4,0.5147115133201716,-2162631170,1371.1612661990466,1355.5558010541451,15.605465144901473,0.7731227230710673,0.7742080370574802,-884
128,2017-05-09,2017,186260,186260,252226659.85000005,2907749.0999999987,143458,0,36,0.8238161709438427,26189347,2115267452,187186,187186,316316,503502,250530233.81666267,2903186.783333242,144310,0,35,0.30982995102303623,2192355621,-926,-926,1696426.0333373845,4562.316666756757,-852,0,1,0.5139862199208065,-2166166274,1354.1643930527223,1338.4026252853455,15.761767767376796,0.7702029421239128,0.7709444082356587,-852
129,2017-05-10,2017,187698,187698,252857483.59999987,2937893.0500000003,144247,0,36,0.8233705207301094,26538541,2122438382,188678,188678,323993,512671,251103140.63332832,2933315.599999901,145093,0,32,0.3065455233473299,2197051859,-980,-980,1754342.9666715562,4577.450000099372,-846,0,4,0.5168249973827795,-2170513318,1347.1506547752233,1330.8554290024715,16.29522577275179,0.7685057912178074,0.7689979753866375,-846
130,2017-05-11,2017,189330,189330,253335926.6499996,2938151.8333333298,144476,0,51,0.8198700681350034,26563911,2128858387,190397,190397,333441,523838,251577844.0166603,2933462.7999999537,145427,0,51,0.3020303987110528,2202069390,-1067,-1067,1758082.6333392859,4689.03333337605,-951,0,0,0.5178396694239507,-2175505479,1338.0654235990048,1321.3330252927321,16.73239830627267,0.7630908994876671,0.7638093037180208,-951
131,2017-05-12,2017,187813,187813,253695946.95000008,2922951.3166666673,144193,0,64,0.8250547086729884,26557361,2134521664,188647,188647,345512,534159,251946690.38333136,2918132.1833332125,145028,0,53,0.2950825503267723,2208746761,-834,-834,1749256.566668719,4819.13333345484,-835,0,11,0.529972158346216,-2182189400,1350.7901314073044,1335.5457037924343,15.24442761487012,0.7677477064952906,0.7687797844651652,-835
132,2017-05-13,2017,187252,187252,254065008.04999962,2926648.083333339,142981,0,37,0.8207121953303574,26498095,2140534080,188081,188081,356510,544591,252293043.6333321,2921785.333333292,143917,0,37,0.28802165294689314,2214876336,-829,-829,1771964.416667521,4862.750000047032,-936,0,0,0.5326905423834642,-2188378241,1356.8079809561427,1341.4063283018068,15.401652654335976,0.7635752889154722,0.7651862761257118,-936
133,2017-05-14,2017,185974,185974,254565200.01666638,2882728.799999993,141998,0,36,0.8175551421166388,25698056,2146854909,186780,186780,366172,552952,252768911.39999753,2878479.7666666275,142750,0,36,0.2792231513766159,2225226464,-806,-806,1796288.6166688502,4249.03333336534,-752,0,0,0.5383319907400229,-2199528408,1368.8214482490368,1353.2975232894182,15.523924959618626,0.7635368384827986,0.7642681229253667,-752
134,2017-05-15,2017,187383,187383,255382821.46666658,2925356.666666671,143344,0,54,0.820666762726608,26173979,2156389935,188349,188349,378689,567038,253580242.5999952,2921325.0999998758,144176,0,55,0.27588274507176036,2235199707,-966,-966,1802578.8666713834,4031.5666667954065,-832,0,-1,0.5447840176548476,-2209025728,1362.8921591962269,1346.3317702774912,16.560388918735725,0.7649786800296718,0.7654726067035131,-832
135,2017-05-16,2017,188848,188848,255896699.38333347,2948707.4333333387,143939,0,69,0.81740870965009,26603711,2163445875,189741,189741,385339,575080,254116527.1999973,2944159.5499998867,144808,0,69,0.27311504486332777,2240496060,-893,-893,1780172.1833361685,4547.883333452046,-869,0,0,0.5442936647867622,-2213892349,1355.0405584561843,1339.2810578630729,15.759500593111397,0.762194992798441,0.7631877137782557,-869
136,2017-05-17,2017,189751,189751,256652729.68333304,2967704.1333333366,145531,0,88,0.8224357183888354,26831826,2172405114,190608,190608,394796,585404,254870480.79999876,2963220.649999876,146363,0,88,0.2708317674631507,2248036309,-857,-857,1782248.883334279,4483.483333460521,-832,0,0,0.5516039509256847,-2221204483,1352.5764274408727,1337.1447200537164,15.431707387156393,0.7669577498932812,0.7678743809283975,-832
137,2017-05-18,2017,188849,188849,257172035.86666626,2963006.5833333326,145074,0,88,0.8233879978183632,26742003,2180515605,189669,189669,405110,594779,255373776.83333093,2958788.8499998543,145901,0,89,0.26538092299829075,2257106624,-820,-820,1798259.033335328,4217.733333478216,-827,0,-1,0.5580070748200725,-2230364621,1361.7865906976804,1346.4181117279625,15.368478969717899,0.7682010495157506,0.7692400972220026,-827
138,2017-05-19,2017,189035,189035,257667432.68333337,2942845.0333333365,145455,0,111,0.8239056259422867,26686273,2188668121,189977,189977,415015,604992,255843620.73332995,2938383.449999865,146349,0,112,0.26164808790860156,2265759396,-942,-942,1823811.9500034153,4461.583333471324,-894,0,-1,0.5622575380336852,-2239073123,1363.067329771383,1346.7083948758532,16.35893489552973,0.7694606818843072,0.7703511477705196,-894
139,2017-05-20,2017,187075,187075,257800160.89999995,2926224.6000000057,144043,0,96,0.823503942269143,26403204,2193639740,187990,187990,426560,614550,255961109.88333094,2921948.89999991,144934,0,96,0.25512163371572555,2273257025,-915,-915,1839051.0166690052,4275.700000095647,-891,0,0,0.5683823085534174,-2246853821,1378.0577891220096,1361.5676891501193,16.49009997189023,0.7699746091139917,0.7709665407734454,-891
140,2017-05-21,2017,187619,187619,258181088.0000002,2912330.7000000053,144182,0,94,0.821377365831818,26615693,2200482695,188508,188508,436040,624548,256357667.1333313,2907306.9333332544,145062,0,95,0.2509110588777836,2282317255,-889,-889,1823420.8666689098,5023.766666750889,-880,0,-1,0.5704663069540343,-2255701562,1376.0924426630577,1359.9299081913302,16.16253447172744,0.7684829361631818,0.769527022725826,-880
141,2017-05-22,2017,191608,191608,258688380.45000002,2959417.316666668,146635,0,93,0.8181965262410756,27309088,2208168086,192478,192477,446922,639400,256866567.24999702,2954822.6666665906,147487,0,94,0.24927431967469124,2292323847,-870,-869,1821813.200002998,4594.650000077207,-852,0,-1,0.5689222065663844,-2265014759,1350.0917521710994,1334.5312284064955,15.560523764603886,0.7652864181036283,0.7662538056297343,-852
142,2017-05-23,2017,191157,191157,258751752.7499999,2977634.083333336,146790,0,91,0.8263626233933379,27681683,2210640121,192315,192315,453611,645926,256884254.01666406,2973190.2333332067,147896,0,91,0.24990169152503527,2291780321,-1158,-1158,1867498.7333358526,4443.850000129081,-1106,0,0,0.5764609318683026,-2264098638,1353.6085665186204,1335.7473624868785,17.861204031741863,0.7679028233336995,0.7690299768608793,-1106
143,2017-05-24,2017,194096,194096,259283371.25000003,2982014.1500000004,149111,0,98,0.8249680570439364,26922372,2217544843,195180,195180,463820,659000,257418230.28333026,2977137.0499999123,150106,0,98,0.24759787556905258,2297822843,-1084,-1084,1865140.966669768,4877.100000088103,-995,0,0,0.5773701814748838,-2270900471,1335.851183177397,1318.876064572857,16.97511860453983,0.768233245404336,0.7690644533251357,-995
144,2017-05-25,2017,187854,187854,259103615.03333354,2839382.3166666655,147281,0,82,0.8289363015959199,18486374,2210661269,188373,188373,473973,662346,257249722.33332944,2835603.849999952,147769,0,82,0.23734271815637437,2292583583,-519,-519,1853892.7000041008,3778.466666713357,-488,0,0,0.5915935834395456,-2274097209,1379.2818626876913,1365.6400988110263,13.641763876664982,0.7840184398522256,0.7844489390730094,-488
145,2017-05-26,2017,191486,191486,256194515.1333335,2895557.316666659,149507,0,89,0.8356955599887196,22532284,2188148256,192186,192186,488891,681077,254325159.96666598,2891018.1166666658,150097,0,89,0.23839595229320587,2295608089,-700,-700,1869355.166667521,4539.199999993201,-590,0,0,0.5972996076955137,-2273075805,1337.9281782132036,1323.328233933096,14.599944280107593,0.7807724846725087,0.7809986159241568,-590
146,2017-05-27,2017,196762,196762,256691504.81666648,3028484.2833333365,151358,0,111,0.8274870147691119,27817145,2195709128,197698,197698,488264,685962,254811745.96666515,3023520.7999999155,152290,0,111,0.24220146305480886,2278595712,-936,-936,1879758.8500013351,4963.48333342094,-932,0,0,0.5852855517143031,-2250778567,1304.5786524667694,1288.893898606284,15.684753860485444,0.7692440613533101,0.7703163410858987,-932
147,2017-05-28,2017,193679,193679,257226729.59999996,2978617.8499999973,147795,0,120,0.8139550493342081,27090453,2202836219,194442,194442,499458,693900,255256709.31666446,2973116.483333307,148569,0,120,0.23119325551233538,2285977034,-763,-763,1970020.283335507,5501.366666690446,-774,0,0,0.5827617938218728,-2258886581,1328.1085177019706,1312.765294106543,15.343223595427617,0.7630925397177805,0.7640787484185515,-774
148,2017-05-29,2017,191179,191179,257713673.78333312,2991333.1000000024,146911,0,115,0.8180919452450323,26963903,2209906071,191894,191894,513446,705340,255782204.78332818,2986420.4666665774,147672,0,116,0.2254685683500142,2294758689,-715,-715,1931469.0000049472,4912.633333425038,-761,0,-1,0.5926233768950181,-2267794786,1348.0229197941883,1332.9348743750622,15.088045419126047,0.7684473713117026,0.7695498556494731,-761
149,2017-05-30,2017,191638,191638,258378544.4666667,2990653.099999999,145727,0,101,0.8091297133136444,26865573,2218371958,192447,192447,520128,712575,256448506.68332964,2985252.316666602,146515,0,101,0.22196681051117287,2298119985,-809,-809,1930037.7833370566,5400.783333397005,-788,0,0,0.5871629028024715,-2271254412,1348.26362447253,1332.5669232740943,15.696701198435676,0.7604285162650414,0.761326495086959,-788
150,2017-05-31,2017,194187,194187,259188425.94999993,3009897.5833333307,147946,0,83,0.8126548121140973,27323527,2228354968,195118,195118,530075,725193,257247866.8999964,3005236.216666483,148868,0,83,0.22198090715161364,2307511550,-931,-931,1940559.0500035286,4661.36666684784,-922,0,0,0.5906739049624836,-2280188023,1334.7362385226609,1318.4220159083036,16.314222614357277,0.761873863852884,0.762963950019988,-922
151,2017-06-01,2017,193551,193551,259660831.45000026,3009223.0666666687,147965,0,119,0.8220572355606532,27860490,2236354806,194715,194715,237880,432595,257735505.08333218,3004457.7666665846,149116,0,119,0.3757093817542977,2293691384,-1164,-1164,1925326.3666680753,4765.300000084098,-1151,0,0,0.44634785380635555,-2265830894,1341.5628513931742,1323.6551117445097,17.907739648664574,0.764475512913909,0.7658167064684283,-1151
152,2017-06-02,2017,195525,195525,260196552.38333344,3019115.533333336,149128,0,96,0.8183301368111492,28269484,2244539849,196611,196611,249859,446470,258287141.3499962,3014394.3499998646,150166,0,97,0.36572894035433784,2303257640,-1086,-1086,1909411.0333372355,4721.183333471417,-1038,0,-1,0.45260119645681135,-2274988156,1330.7584829731925,1313.6962903906506,17.06219258254191,0.7627055363764225,0.7637721185488096,-1038
153,2017-06-03,2017,194846,194846,260505477.90000004,3027920.099999998,149083,0,72,0.8232758178253603,28151568,2251703128,195841,195841,262841,458682,258593943.83332968,3023706.0499998955,150148,0,72,0.35778164392760226,2313328672,-995,-995,1911534.0666703582,4214.050000102725,-1065,0,0,0.46549417389775805,-2285177104,1336.9814001827085,1320.4280198392046,16.55338034350393,0.7651324635866273,0.766683176658616,-1065
154,2017-06-04,2017,192810,192810,261156195.30000028,3007262.116666668,148044,0,115,0.8244178206524564,27819681,2260724220,193981,193981,273976,467957,259256441.36666536,3002536.8166664653,149201,0,116,0.348230713505727,2325825186,-1171,-1171,1899753.9333349168,4725.300000202842,-1157,0,-1,0.4761871071467294,-2298005505,1354.4743286136625,1336.5043038579313,17.970024755731174,0.7678232456822779,0.7691526489707755,-1157
155,2017-06-05,2017,193988,193988,261791308.96666694,3008680.216666661,148813,0,77,0.8201125842835639,27644081,2269405037,195122,195122,286347,481469,259895346.5333319,3004187.4666664954,149904,0,77,0.33722212645051,2338040487,-1134,-1134,1895962.433335036,4492.750000165775,-1091,0,0,0.48289045783305395,-2310396406,1349.5232126042174,1331.9633179924965,17.559894611720892,0.7671247706043672,0.768257807935548,-1091
156,2017-06-06,2017,191557,191557,261873846.23333323,2979206.600000003,146357,0,87,0.8204398690729127,27408534,2273759081,192570,192570,298933,491503,259966335.2166661,2974582.1499998197,147308,0,87,0.3258291404121624,2344769793,-1013,-1013,1907511.0166671276,4624.450000183191,-951,0,0,0.4946107286607503,-2317361259,1367.0805359936376,1349.9835655432628,17.096970450374783,0.7640389022588576,0.7649581970192657,-951
157,2017-06-07,2017,193441,193441,262044490.5333331,2999482.3166666687,147105,0,82,0.8154527737139488,27141827,2277728228,194505,194505,309102,503607,260145889.03332865,2995043.9166665203,148063,0,82,0.31923106708207105,2350593900,-1064,-1064,1898601.5000044405,4438.400000148453,-958,0,0,0.4962217066318777,-2323452073,1354.6481383643234,1337.4766151683948,17.171523195928557,0.7604644310151416,0.7612297884373153,-958
158,2017-06-08,2017,195076,195076,262695701.40000004,3028396.38333333,148446,0,73,0.8121040004921158,27083240,2285002411,196097,196097,319771,515868,260764878.08332732,3023711.6999998908,149354,0,73,0.3122387897679179,2353560072,-1021,-1021,1930823.3166727126,4684.683333439287,-908,0,0,0.49986521072419793,-2326476832,1346.6326016526893,1329.7749485373429,16.857653115346466,0.7609649572474317,0.7616332733290158,-908
159,2017-06-09,2017,198165,198165,263395574.13333312,3035788.1166666634,150216,0,93,0.810435747987788,27477808,2292721532,199195,199195,329539,528734,261475311.3499959,3031209.783333241,151205,0,93,0.3091157368355385,2359986694,-1030,-1030,1920262.7833372056,4578.33333342243,-989,0,0,0.5013200111522494,-2332508886,1329.173033246704,1312.6600133035263,16.513019943177824,0.7580349708576186,0.759080298200256,-989
160,2017-06-10,2017,194787,194787,263700952.78333318,3002340.4999999995,147059,0,88,0.8060137483507632,27266400,2297863126,195835,195835,344047,539882,261798084.08333093,2997429.399999954,148085,0,88,0.2966796448112736,2368425236,-1048,-1048,1902868.700002253,4911.100000045728,-1026,0,0,0.5093341035394896,-2341158836,1353.7913350651388,1336.8299031497481,16.961431915390676,0.754973381180469,0.7561722878954221,-1026
161,2017-06-11,2017,193647,193647,264111496.7833331,2990452.5166666703,147273,0,73,0.8119000036148251,27025241,2302964017,194626,194626,355935,550561,262208298.81666404,2985663.98333323,148210,0,73,0.29062538029392604,2377662187,-979,-979,1903197.9666690528,4788.533333440311,-937,0,0,0.521274623320899,-2350636946,1363.8811692581505,1347.241883492771,16.639285765379555,0.7605230135246092,0.7615118226752849,-937
162,2017-06-12,2017,191608,191608,264622554.86666623,2991082.7500000014,144999,0,92,0.8060884722976077,26669256,2310702494,192614,192614,369356,561970,262758751.23333204,2986161.983333263,146026,0,92,0.2805398864708037,2385686078,-1006,-1006,1863803.6333341897,4920.766666738316,-1027,0,0,0.5255485858268041,-2359016822,1381.0621418034018,1364.172652212882,16.889489590519815,0.7567481524779759,0.7581276542722751,-1027
163,2017-06-13,2017,192257,192257,265094598.23333308,3013584.733333331,145023,0,123,0.8013440342874383,26472163,2316404541,193360,193360,377622,570982,263191351.8166641,3008808.3166665807,146084,0,123,0.2755673558886317,2389705887,-1103,-1103,1903246.4166689813,4776.4166667503305,-1061,0,0,0.5257766783988066,-2363233724,1378.855377090733,1361.146833971163,17.708543119570095,0.7543184383403465,0.7555026892842367,-1061
164,2017-06-14,2017,197912,197912,265776911.66666684,3055358.166666665,149344,0,94,0.8006285621892568,27946429,2324256722,198891,198891,387530,586421,263880697.59999642,3050565.4999999264,150274,0,95,0.2753482566279226,2399156247,-979,-979,1896214.0666704178,4792.666666738689,-930,0,-1,0.5252803055613342,-2371209818,1342.904481116187,1326.7603742753388,16.14410684084828,0.7545980031529165,0.7555595778592294,-930
165,2017-06-15,2017,199590,199590,266606731.50000018,3071729.68333333,151149,0,125,0.8030963475124002,28132851,2333697148,200703,200703,398158,598861,264729583.89999625,3066559.566666549,152164,0,126,0.2726809727132023,2405742328,-1113,-1113,1877147.600003928,5170.116666780785,-1015,0,-1,0.530415374799198,-2377609477,1335.7719900796642,1319.0115937479572,16.760396331706943,0.7572974597925748,0.7581550848766585,-1015
166,2017-06-16,2017,200564,200564,267253920.33333337,3057090.8666666686,150765,0,88,0.797984683193394,28468101,2342626782,201583,201583,411696,613279,265367327.26666448,3052485.6833332013,151684,0,88,0.2652283870799467,2415424979,-1019,-1019,1886593.0666688979,4605.1833334672265,-919,0,0,0.5327562961134473,-2386956878,1332.511918057744,1316.4171942409057,16.09472381683827,0.7517051913603637,0.7524642454968921,-919
167,2017-06-17,2017,200395,200395,267648775.2999999,3049302.9833333334,149412,0,99,0.7925846453254826,27806051,2349695690,201452,201452,426268,627720,265737105.19999737,3044201.5499999067,150421,0,100,0.25761326706175114,2423757393,-1057,-1057,1911670.1000025272,5101.433333426714,-1009,0,-1,0.5349713782637314,-2395951342,1335.6060545422786,1319.1087961400103,16.497258402268244,0.7455874647571047,0.7466840736254791,-1009
168,2017-06-18,2017,198965,198965,268021166.7333334,3021208.649999998,148635,0,92,0.7926670519940697,27482389,2354965717,199883,199883,440006,639889,266130170.7833376,3016518.7666665865,149554,0,92,0.2508872632597199,2434092566,-918,-918,1890995.9499958158,4689.883333411533,-919,0,0,0.5417797887343498,-2406610177,1347.0769569187214,1331.429740314772,15.647216603949346,0.7470409368481894,0.7482077015053806,-919
169,2017-06-19,2017,199453,199453,268689360.15,3050498.43333333,149119,0,98,0.7918958351090232,27605436,2363754223,200445,200445,455431,655876,266746566.5166634,3045819.299999918,150051,0,98,0.24488622849441183,2443546693,-992,-992,1942793.6333365738,4679.133333411999,-932,0,0,0.5470096066146113,-2415941257,1347.131204594566,1330.7718651832843,16.35933941128178,0.7476397948388843,0.748589388610342,-932
170,2017-06-20,2017,193984,193984,268626884.28333336,2975371.0333333304,142860,0,94,0.7746051220719234,22325306,2361361226,194603,194603,467711,662314,266718191.08333087,2970483.4166666204,143487,0,94,0.22920548259587364,2443742305,-619,-619,1908693.2000024915,4887.616666710004,-627,0,0,0.5453996394760499,-2421416999,1384.788870645689,1370.5759473560577,14.212923289631362,0.7364524909270868,0.7373319013581496,-627
171,2017-06-21,2017,202288,202288,269037963.48333323,3083073.799999999,151268,0,59,0.7934677291782005,27851317,2368167989,203297,203297,479139,682436,267068510.90000567,3078929.8999999324,152176,0,60,0.2391770070746554,2451142844,-1009,-1009,1969452.5833275616,4143.900000066496,-908,0,-1,0.5542907221035451,-2423291527,1329.9749045090823,1313.686433641449,16.28847086763335,0.7477853357589179,0.7485403129411649,-908
172,2017-06-22,2017,203207,203207,269842451.9500002,3083257.133333331,151399,0,34,0.7882848523918957,27680653,2377154331,204114,204114,490515,694629,267886849.8333298,3078383.2166665457,152202,0,34,0.23391911365635726,2454788753,-907,-907,1955602.1166704297,4873.916666785255,-803,0,0,0.5543657387355385,-2427108100,1327.9190773447776,1312.4374116098347,15.481665734942908,0.7450481528687496,0.745671536494312,-803
173,2017-06-23,2017,201890,201890,270239077.5333336,3055286.1999999974,151198,0,51,0.7933082371588488,27550194,2382673412,202853,202853,505354,708207,268291329.06666243,3050829.2999999356,152084,0,51,0.22972661947707237,2461014147,-963,-963,1947748.4666711688,4456.90000006184,-886,0,0,0.5635816176817764,-2433463953,1338.5461267687037,1322.5899004040484,15.956226364655322,0.7489127742830254,0.7497251704436217,-886
174,2017-06-24,2017,195865,195865,270082872.9666665,2998100.2833333346,146924,0,42,0.794608531386414,27101029,2383897855,196654,196654,522793,719447,268147434.10000485,2993545.533333243,147808,0,42,0.21972014616781751,2467743525,-789,-789,1935438.8666616678,4554.750000091735,-884,0,0,0.5748883852185964,-2440642496,1378.9236104800068,1363.5493511446746,15.374259335332226,0.7501289153243306,0.7516145107651001,-884
175,2017-06-25,2017,195483,195483,270300975.50000024,2988395.9166666674,146718,0,68,0.7976499235227614,27243822,2388781494,196340,196340,536881,733221,268345989.46666843,2983575.433333308,147657,0,68,0.21612174228506503,2477120897,-857,-857,1954986.0333318114,4820.483333359472,-939,0,0,0.5815281812376965,-2449877075,1382.7339231544443,1366.741313367976,15.992609786468165,0.750540967756787,0.7520474686767852,-939
176,2017-06-26,2017,199435,199435,270943415.4166667,3025853.5000000033,148545,0,33,0.7869080151427786,26929029,2396734879,200489,200489,550784,751273,268990505.30000716,3021422.0499995975,149596,0,33,0.21258450656420144,2482985385,-1054,-1054,1952910.116659522,4431.450000405777,-1051,0,0,0.5743235085785772,-2456056356,1358.5549949440503,1341.6721381223267,16.882856821723635,0.744829142327074,0.7461556494371262,-1051
177,2017-06-27,2017,200890,200890,271348975.14999974,3058959.366666661,150291,0,71,0.7922395340733723,27584359,2402143098,201989,201989,560663,762652,269408492.63333064,3054526.4666666086,151302,0,71,0.2125137021865782,2485385443,-1099,-1099,1940482.5166690946,4432.900000052527,-1011,0,0,0.5797258318867942,-2457801084,1350.734108965104,1333.7780405533501,16.956068411753904,0.7481258400119468,0.7490605924084975,-1011
178,2017-06-28,2017,200503,200503,271858491.3999999,3042653.9833333353,150049,0,60,0.7928160675900118,26837924,2408218447,201631,201631,573290,774921,269919412.2999954,3037967.283333321,151093,0,61,0.2089361367158711,2491404385,-1128,-1128,1939079.1000044942,4686.700000014156,-1044,0,-1,0.5838799308741407,-2464566461,1355.8824127319785,1338.6801250799501,17.202287652028417,0.7483628673885179,0.7493540179833458,-1044
179,2017-06-29,2017,200728,200728,272338059.66666657,3058556.5999999978,150038,0,70,0.7965356103782233,27718469,2414125699,201751,201751,587397,789148,270415017.63333154,3053567.283333333,151065,0,70,0.20579536411420934,2498502213,-1023,-1023,1923042.03333503,4989.316666664556,-1027,0,0,0.5907402462640139,-2470783744,1356.751722065016,1340.3404078955323,16.41131416948383,0.7474692120680723,0.748769522827644,-1027
180,2017-06-30,2017,196705,196705,272722617.4333333,2980004.050000002,148052,0,74,0.79333011362192,25300702,2418982231,197363,197363,601318,798681,270798171.5333301,2975720.9333333327,148717,0,66,0.19736665827783662,2504048990,-658,-658,1924445.9000031948,4283.116666669492,-665,0,8,0.5959634553440833,-2478748288,1386.454932174237,1372.0817556144266,14.373176559810418,0.7526600747311964,0.7535201633538201,-665
181,2017-07-01,2017,201306,201306,272494828.6166669,3050910.900000003,153210,0,97,0.8134531509244638,26779966,2419788523,202520,202520,265617,468137,270589601.850008,3047807.7333332226,153849,0,78,0.35343499872900186,2487846558,-1214,-1214,1905226.7666589022,3103.1666667805985,-639,0,19,0.46001815219546194,-2461066592,1353.6349071397121,1336.1129856310883,17.52192150862379,0.761080146642425,0.7596731187043255,-639
182,2017-07-02,2017,201751,201751,272824392.3000003,3032724.566666669,153141,0,105,0.8070245004981391,26715789,2424890410,202385,202385,281176,483561,270908522.1833426,3028986.266666583,153698,0,101,0.3403707081422988,2494412826,-634,-634,1915870.116657734,3738.3000000864267,-557,0,4,0.4666537923558403,-2467697037,1352.2827262318417,1338.5800438932854,13.702682338556315,0.7590594346496424,0.7594337525014205,-557
183,2017-07-03,2017,203968,203968,273472576.6000003,3036186.8666666695,153226,0,113,0.7972083856291178,24980080,2431096061,204717,204717,297853,502570,271556274.3833418,3032959.433333217,153630,0,93,0.32615158087430673,2500799914,-749,-749,1916302.2166585326,3227.4333334523253,-404,0,20,0.47105680475481104,-2475819834,1340.7621617116426,1326.4959645918111,14.266197119831531,0.7512256824599938,0.7504506220782837,-404
184,2017-07-04,2017,206415,206415,274015676.55000013,3098506.3333333367,156311,0,112,0.8103916866506788,26842663,2436996840,207419,207419,313493,520912,272083515.73334086,3094891.599999926,156957,0,112,0.32529102804312493,2501925879,-1004,-1004,1932160.8166592717,3614.733333410695,-646,0,0,0.4851006586075539,-2475083216,1327.4988569144691,1311.7579186735104,15.740938240958712,0.7572657025894436,0.7567146693408029,-646
185,2017-07-05,2017,210585,210585,274874205.53333336,3117981.43333333,157637,0,150,0.801329629365814,27069910,2445139740,211224,211224,328119,539343,272927305.35001206,3113936.16666657,158192,0,143,0.3160066970369571,2509112833,-639,-639,1946900.1833212972,4045.266666759737,-555,0,7,0.48532293232885687,-2482042923,1305.2886270785352,1292.1226060959552,13.166020982579994,0.7485670869245198,0.7489300458281256,-555
186,2017-07-06,2017,209410,209410,275601871.53333277,3113648.6833333317,156046,0,192,0.7949524855546544,26371040,2451674466,210702,210702,346123,556825,273710782.0000093,3111062.7499999152,156799,0,193,0.30233556323799965,2516574169,-1292,-1292,1891089.5333234668,2585.9333334164694,-753,0,-1,0.4926169223166547,-2490203129,1316.0874434522361,1299.0421638143412,17.045279637894964,0.7451697626665393,0.7441742365995576,-753
187,2017-07-07,2017,213326,213326,276106673.93333334,3095293.1666666623,157122,0,62,0.7819253161827439,27007833,2456970158,214165,214165,364438,578603,274202157.30000937,3092483.516666571,157773,0,62,0.29104757493479444,2524483127,-839,-839,1904516.6333239675,2809.6500000911765,-651,0,0,0.4908777412479494,-2497475294,1294.294525436812,1280.3313207107108,13.96320472610114,0.7365346933800849,0.7366890014708286,-651
188,2017-07-08,2017,207094,207094,276097556.3500001,3057498.416666673,154305,0,148,0.7984731571170588,26555020,2459321437,207902,207902,386959,594861,274152381.0500085,3053996.86666654,155065,0,148,0.2814085979749847,2530905339,-808,-808,1945175.2999916077,3501.550000132993,-760,0,0,0.5170645591420742,-2504350319,1333.1992059161544,1318.6615859876695,14.5376199284849,0.7450964296406463,0.7458562207193774,-760
189,2017-07-09,2017,207156,207156,276441143.2666665,3046471.399999996,155215,0,69,0.7985720905983894,26749126,2464227802,209528,209528,403881,613409,274308718.7166828,3045653.483333245,156261,0,69,0.2733543198746633,2536208065,-2372,-2372,2132424.5499836802,817.9166667512618,-1046,0,0,0.5252177707237261,-2509458939,1334.458781144,1309.1745194755965,25.284261668403587,0.7492662534515051,0.7457762208392196,-1046
190,2017-07-10,2017,208529,208529,277074286.23333323,3061958.683333336,155623,0,95,0.7955536160438118,26048493,2470617178,209086,209086,423199,632285,274218501.6500106,3058646.5833332483,156201,0,90,0.26532339055964127,2536381877,-557,-557,2855784.5833226442,3312.1000000876375,-578,0,5,0.5302302254841705,-2510333384,1328.70865075521,1311.5105824876396,17.198068267570534,0.7462894849157671,0.7470658006753202,-578
191,2017-07-11,2017,206921,206921,277548616.81666625,3084480.166666665,155655,0,76,0.8027169789436546,25972612,2474787366,207837,207837,437047,644884,274698670.3166784,3083106.0999998897,156336,0,76,0.2609973266509934,2534649773,-916,-916,2849946.4999878407,1374.066666775383,-681,0,0,0.5417196522926612,-2508677161,1341.3264812013583,1321.702441416487,19.62403978487123,0.7522436098800992,0.7522048528414094,-681
192,2017-07-12,2017,207763,207763,278249106.6333334,3108425.966666668,156214,0,89,0.8013746432232881,26129971,2480964870,218796,218796,452394,671190,275378563.40001404,3115056.8166665593,161050,0,89,0.2571045456577112,2539737309,-11033,-11033,2870543.233319342,-6630.849999891128,-4836,0,0,0.544270097565577,-2513607338,1339.2620756984322,1258.608765242573,80.65331045585913,0.7518855619142966,0.7360737856267939,-4836
193,2017-07-13,2017,208712,208712,278959646.3666666,3105404.700000002,157274,0,219,0.8045248955498477,25989807,2486684692,224153,224153,468232,692385,270194575.7833396,3123941.1499997703,162520,0,219,0.2513731522202222,2486043060,-15441,-15441,8765070.583326995,-18536.449999768287,-5246,0,0,0.5531517433296256,-2460053253,1336.5769403132863,1205.4024518223696,131.1744884909167,0.7535455555981448,0.7250404857396511,-5246
194,2017-07-14,2017,205993,205993,279475975.53333354,3084077.5666666636,157005,0,59,0.8141198972780624,25550993,2491990706,224294,224294,486571,710865,264328056.56666067,3113058.2499998696,164056,0,59,0.2472551046963948,2431954738,-18301,-18301,15147918.966672868,-28980.68333320599,-7051,0,0,0.5668647925816677,-2406403745,1356.7255952063106,1178.4891997407897,178.2363954655209,0.7621860937022131,0.7314328515252303,-7051
195,2017-07-15,2017,207194,207194,279510224.16666687,3080135.3333333354,156165,0,73,0.8048109501240382,26302894,2493867016,216548,216548,502516,719064,258001199.96667233,3086970.8166663577,160095,0,73,0.23888694191337106,2376799970,-9354,-9354,21509024.199994534,-6835.483333022334,-3930,0,0,0.5659240082106671,-2350497076,1349.0266328497296,1191.4273046468788,157.59932820285076,0.7537139106344778,0.7393049116131296,-3930
196,2017-07-16,2017,203503,203503,279633488.99999994,3035279.0166666675,153868,0,152,0.8078799821132865,25938328,2496486700,210233,210233,518918,729151,256282077.23332745,3038789.016666596,156205,0,153,0.23045157998823348,2366548098,-6730,-6730,23351411.766672492,-3509.999999928288,-2337,0,-1,0.577428402125053,-2340609770,1374.100082062672,1219.0382919585766,155.0617901040955,0.7560969617155521,0.7430089472157083,-2337
197,2017-07-17,2017,208970,208970,280165821.7166667,3080954.1999999997,156507,0,207,0.8030817820739821,26411521,2504118227,214682,214682,537205,751887,256080078.45000833,3080739.966666247,158780,0,207,0.22823376385014896,2365864839,-5712,-5712,24085743.266658366,214.23333375249058,-2273,0,0,0.5748480182238331,-2339453318,1340.6987688025397,1192.8344176503308,147.86435115220888,0.7489448246159736,0.7396055561248731,-2273
198,2017-07-18,2017,210257,210257,280639472.3333334,3122261.166666668,159503,0,124,0.8134283281888346,26784945,2509166461,211900,211900,551191,763091,256039368.04999745,3120773.9666666617,160233,0,124,0.2269716193743611,2361656697,-1643,-1643,24600104.283335924,1487.2000000062399,-730,0,0,0.5864567088144734,-2334871752,1334.7449660811928,1208.302822321838,126.44214375935485,0.7586097014605935,0.7561727229825389,-730
199,2017-07-19,2017,212377,212377,281513492.6666665,3166060.5000000023,160601,0,111,0.8105632907518221,26647242,2517659951,239695,239694,562867,802562,257029455.61666968,3209436.7166663436,170873,0,111,0.2293280768339345,2366785693,-27318,-27317,24484037.049996823,-43376.21666634129,-10272,0,0,0.5812352139178876,-2340138451,1325.5366290448897,1072.3232772479482,253.21335179694142,0.7562071222401673,0.7128767809090719,-10272
200,2017-07-20,2017,213473,213473,281949252.15000015,3145615.749999998,159561,0,201,0.8017547886617986,26586971,2522134900,244308,244308,584101,828409,250367902.383339,3184963.316666327,170416,0,202,0.2214570339047422,2317725472,-30835,-30835,31581349.766661167,-39347.566666328814,-10855,0,-1,0.5802977547570565,-2291138501,1320.7724262553118,1024.804355090046,295.96807116526566,0.7474528394691601,0.6975457209751625,-10855
201,2017-07-21,2017,213585,213585,281628161.4333334,3145242.35,160071,0,321,0.8049628953344108,26846321,2521106673,232765,232765,605191,837956,243864105.050003,3160102.81666632,165943,0,321,0.21402078390751184,2267525150,-19180,-19180,37764056.383330405,-14860.466666319873,-5872,0,0,0.5909421114268989,-2240678829,1318.5764985056694,1047.6837370309238,270.8927614747456,0.7494486972399748,0.7129207569866604,-5872
202,2017-07-22,2017,213108,213108,281943519.80000013,3141831.7500000005,159251,0,77,0.8004532912889243,26799890,2524165304,232531,232530,622545,855076,241116706.86667368,3161072.7666663122,166045,0,77,0.20940828651488766,2248725978,-19423,-19422,40826812.93332645,-19241.01666631177,-6794,0,0,0.5910450047740367,-2221926088,1323.0076759201913,1036.9273077309322,286.08036818925916,0.7472783752838936,0.7140768327663838,-6794
203,2017-07-23,2017,206554,206554,281935974.03333396,3090459.2666666624,157002,0,82,0.8134337751871173,25712773,2525445435,227820,227820,640265,868085,238626019.50000173,3117697.8166662813,162708,0,82,0.2016645835373219,2228342016,-21266,-21266,43309954.53333223,-27238.549999618903,-5706,0,0,0.6117691916497955,-2202629243,1364.9504441130841,1047.4322688965049,317.51817521657927,0.7601014746749034,0.714195417434817,-5706
204,2017-07-24,2017,209656,209656,282524700.816667,3138025.166666667,159047,0,79,0.8125071545770218,26559815,2532753299,236186,236186,659022,895208,237980683.2999978,3170628.2666666317,167581,0,80,0.20169167389031264,2227361288,-26530,-26530,44544017.516669214,-32603.099999964703,-8534,0,-1,0.6108154806867092,-2200801473,1347.5631549617804,1007.5986015259067,339.96455343587365,0.7586093410157592,0.7095297773788455,-8534
205,2017-07-25,2017,211153,211153,282977818.4333333,3141341.9666666677,159131,0,83,0.8075281904590506,26290276,2538227093,236155,236155,676731,912886,236413831.8999962,3196954.2166666584,166710,0,83,0.19688657729442652,2213565213,-25002,-25002,46563986.53333709,-55612.24999999069,-7579,0,0,0.6106416131646241,-2187274937,1340.1553301792221,1001.096025491716,339.05930468750614,0.7536288852159335,0.7059346615570282,-7579
206,2017-07-26,2017,220346,220346,283874604.6000005,3177436.2833333286,162201,0,147,0.7901164532144895,26578140,2545693432,234812,234812,696006,930818,235571579.2166618,3204981.6666666446,166564,0,149,0.19336003386269376,2205319164,-14466,-14466,48303025.38333869,-27545.383333316073,-4363,0,-2,0.5967564193517958,-2178741024,1288.3129469107698,1003.2348398576811,285.07810705308873,0.7361195574233251,0.7093504590906768,-4363
207,2017-07-27,2017,226494,226494,284721517.633333,3194933.7666666615,163729,0,78,0.7791288069441121,27369883,2553491317,231010,231010,719440,950450,235467721.29999733,3194329.0666666348,165341,0,78,0.1889210374033399,2204107297,-4516,-4516,49253796.3333357,604.700000026729,-1612,0,0,0.5902077695407723,-2176737414,1257.0819431566974,1019.2966594519602,237.78528370473725,0.7228844914214063,0.715730920739362,-1612
208,2017-07-28,2017,225561,225561,285315161.4333338,3163493.333333339,162795,0,111,0.7762822473743244,27317295,2560003326,234328,234328,740957,975285,236054971.74999565,3164305.0833332897,165729,0,111,0.18404261318486323,2212250227,-8767,-8767,49260189.683338165,-811.7499999506399,-2934,0,0,0.5922396341894611,-2184932932,1264.9135330723566,1007.3698907087315,257.54364236362505,0.7217338103661537,0.7072522276467175,-2934
209,2017-07-29,2017,223835,223835,285369154.0833332,3153084.7000000016,159574,0,147,0.7669533361627986,27706916,2564086999,224500,224500,770498,994998,235640998.96666414,3148621.8666666234,160150,0,147,0.17472195924011832,2216495557,-665,-665,49728155.11666906,4462.833333378192,-576,0,0,0.5922313769226802,-2188788641,1274.9085446124743,1049.6258305864772,225.28271402599717,0.7129090624790583,0.7133630289532294,-576
210,2017-07-30,2017,221820,221820,285670081.64999974,3118482.316666665,157994,0,235,0.7634568569110098,27461741,2569025841,225729,225729,790924,1016653,236253290.2999996,3117271.016666632,158941,0,235,0.1687980067928775,2228179452,-3909,-3909,49416791.35000014,1211.3000000328757,-947,0,0,0.5946588501181324,-2200717711,1287.8463693535286,1046.623563210751,241.2228061427777,0.7122621945721757,0.7041230856469484,-947
211,2017-07-31,2017,223718,223718,286107538.6333335,3149215.5833333335,160716,0,158,0.7692943795313741,27496271,2575280927,230628,230628,817427,1048055,236708840.51666635,3147762.8666666485,163139,0,158,0.16752842169542456,2236693090,-6910,-6910,49398698.11666715,1452.7166666849516,-2423,0,0,0.6017659578359495,-2209196819,1278.8758107677231,1026.3664451699983,252.5093655977248,0.7183865401979278,0.7073685762353227,-2423
212,2017-08-01,2017,234944,234944,286397392.9500002,3233584.399999998,168626,0,150,0.7737631095069463,28018367,2579505395,235585,235585,333796,569381,236400133.4166626,3229084.916666434,169188,0,150,0.3222095573965378,2210584209,-641,-641,49997259.53333762,4499.483333563898,-562,0,0,0.4515535521104085,-2182565842,1219.002796198244,1003.4600395469262,215.54275665131775,0.7177284799782075,0.7181611732495702,-562
213,2017-08-02,2017,233281,233281,286729452.9999999,3249621.633333327,167556,0,142,0.7725489859868568,27824618,2583289538,233967,233967,357119,591086,237100911.6499949,3245175.0833331617,168074,0,142,0.3075170110609931,2218789034,-686,-686,49628541.35000497,4446.5500001651235,-518,0,0,0.46503197492586373,-2190964416,1229.1161860588727,1013.3946738215001,215.72151223737262,0.7182582379190762,0.7183662653280164,-518
214,2017-08-03,2017,232844,232844,287148542.58333313,3258153.316666662,167182,0,136,0.7789764821081923,28013149,2587929646,233280,233280,383345,616625,237892492.2833308,3254215.599999713,167652,0,137,0.2974692884654347,2227017143,-436,-436,49256050.30000234,3937.7166669494472,-470,0,-1,0.48150719364275757,-2199003994,1233.2228555742606,1019.7723434642095,213.45051211005114,0.7180000343577674,0.7186728395061729,-470
215,2017-08-04,2017,234858,234858,287848289.1,3281689.7833333313,169718,0,138,0.7841759701606943,28316406,2594384918,235775,235775,407466,643241,238868464.33332688,3277230.2499997346,170319,0,138,0.29004525519983665,2235618795,-917,-917,48979824.76667315,4459.533333596773,-601,0,0,0.49413071496085764,-2207302389,1225.6269281863936,1013.1204085816006,212.50651960479297,0.7226409149358336,0.722379387127558,-601
216,2017-08-05,2017,236915,236915,288177093.2166666,3282085.3833333286,168498,0,163,0.7684570415549874,28434689,2599323713,237441,237441,431763,669204,239525363.63333,3277409.5166664636,169080,0,163,0.27540630360846297,2246023103,-526,-526,48651729.58333659,4675.866666865069,-582,0,0,0.49305073794652443,-2217588414,1216.3733542269024,1008.7784486812724,207.59490554563,0.7112171031804656,0.7120926882888802,-582
217,2017-08-06,2017,237348,237348,288458875.5000005,3261798.466666666,168454,0,199,0.7686645769081681,28593280,2603979403,237981,237981,458486,696467,240081677.6499956,3257252.283333226,169111,0,199,0.26521141705206147,2257721735,-633,-633,48377197.85000488,4546.1833334397525,-657,0,0,0.5034531598561067,-2229128455,1215.341504878914,1008.8270813636198,206.5144235152943,0.7097342299071405,0.710607149310239,-657
218,2017-08-07,2017,237054,237054,289210898.38333374,3286086.3833333324,169681,0,133,0.7720772482219248,28274219,2612879457,237651,237651,486082,723733,241072302.1666612,3281594.249999944,170248,0,133,0.25637493384991833,2265375244,-597,-597,48138596.21667254,4492.13333338825,-567,0,0,0.5157023143720065,-2237101025,1220.0211697897262,1014.3963297720658,205.6248400176604,0.7157904949927021,0.71637821848004,-567
219,2017-08-08,2017,235279,235279,289676463.81666666,3253996.1333333296,167849,0,198,0.7716923312322815,28388651,2618922622,236016,236016,509708,745724,241843579.71666116,3249425.633333267,168571,0,198,0.2472912230262121,2273158435,-737,-737,47832884.10000551,4570.500000062399,-722,0,0,0.5244011082060694,-2244769784,1231.2040760827217,1024.691460395317,206.5126156874046,0.7134040862125391,0.7142354755609789,-722
220,2017-08-09,2017,233448,233448,289956831.5500001,3232193.2333333315,166132,0,179,0.7701543812754879,28170065,2623279315,234057,234057,537308,771365,242442016.96666327,3227767.93333326,166747,0,179,0.23670117259662668,2283693239,-609,-609,47514814.5833368,4425.300000071526,-615,0,0,0.5334532086788611,-2255523174,1242.0617505825712,1035.8246793159926,206.2370712665786,0.7116445632432062,0.7124204787722649,-615
221,2017-08-10,2017,233941,233941,290529325.43333346,3265960.4500000067,169256,0,176,0.784813264883026,28715893,2630114442,234673,234673,562763,797436,243260775.91666365,3261621.1833333196,169887,0,172,0.23371781559899213,2292476226,-732,-732,47268549.51666981,4339.266666687094,-631,0,4,0.5510954492840339,-2263760333,1241.891440291926,1036.5946483688522,205.2967919230739,0.7234986599185265,0.7239307461872478,-631
222,2017-08-11,2017,236871,236871,291100496.8833334,3270504.3833333347,170621,0,221,0.7804585618332345,29530754,2638359334,237588,237588,583837,821425,244087846.84999645,3265496.999999986,171272,0,221,0.22813160057217466,2303773777,-717,-717,47012650.03333694,5007.383333348669,-651,0,0,0.5523269612610598,-2274243023,1228.941056031905,1027.3576394851443,201.58341654676065,0.7203118997260112,0.7208781588295705,-651
223,2017-08-12,2017,233354,233354,291178441.4666666,3216329.8833333305,165560,0,233,0.7682276712634019,29515873,2642730516,234017,234017,610252,844269,244501609.03332874,3211779.766666649,166228,0,230,0.21501440891469342,2315225525,-663,-663,46676832.43333784,4550.116666681599,-668,0,3,0.5532132623487085,-2285709652,1247.7970871151408,1044.8027666081043,202.9943205070365,0.7094800174841657,0.7103244636073448,-668
224,2017-08-13,2017,231519,231519,291552295.85,3185590.3666666658,165399,0,224,0.771301707419262,29735114,2649902500,231996,231996,636669,868665,245097559.6166619,3181224.7499999898,165956,0,224,0.20852112149102245,2328157270,-477,-477,46454736.23333812,4365.616666676011,-557,0,0,0.5627805859282395,-2298422156,1259.301810434565,1056.4732134030842,202.82859703148074,0.7144078887693882,0.7153399196537872,-557
225,2017-08-14,2017,229172,229172,292088311.30000025,3190216.1166666625,163266,0,162,0.7675981358979281,28575738,2658165674,229598,229598,661745,891343,245840689.28332806,3186027.1666666074,163826,0,163,0.20008459145357027,2339416073,-426,-426,46247622.016672194,4188.950000055134,-560,0,-1,0.5675135444443579,-2310840335,1274.5375146178428,1070.7440364608055,203.79347815703727,0.712416874661826,0.7135340900182058,-560
226,2017-08-15,2017,232886,232886,292382099.34999996,3234604.533333332,166696,0,134,0.7812964282953883,29268348,2662980402,233794,233794,678403,912197,246467171.08332872,3230703.649999961,167436,0,134,0.20296931474232263,2345914077,-908,-908,45914928.26667124,3900.883333371021,-740,0,0,0.5783271135530657,-2316645729,1255.4730612832027,1054.2065710981835,201.26649018501917,0.715783688156437,0.7161689350453818,-740
227,2017-08-16,2017,242621,242621,292955929.40000004,3361690.983333333,175444,0,124,0.7941563178785014,30125083,2670110726,243329,243329,697454,940783,247305752.2833278,3356794.483333278,176171,0,125,0.20791298312150347,2353674536,-708,-708,45650177.11667225,4896.500000054948,-727,0,-1,0.586243334756998,-2323549453,1207.46320145412,1016.3431086443777,191.12009280974235,0.7231195980562276,0.7240033041684304,-727
228,2017-08-17,2017,241002,241002,293598421.9166664,3351647.300000002,173233,0,311,0.7853793744450257,29972637,2678087591,241843,241843,718730,960573,248218672.949997,3347161.59999997,174023,0,313,0.20040434199170268,2362709912,-841,-841,45379748.96666938,4485.700000032317,-790,0,-2,0.584975032453323,-2332737275,1218.2406034666367,1026.3628591689526,191.8777442976841,0.7188031634592245,0.719570134343355,-790
229,2017-08-18,2017,241237,241237,294205437.8500002,3363666.2666666643,173918,0,368,0.787474558214536,29992225,2684533835,242342,242342,742051,984393,249118563.11666185,3359584.9499999746,174711,0,368,0.19609444601901999,2373100029,-1105,-1105,45086874.733338356,4081.3166666897014,-793,0,0,0.591380112195516,-2343107804,1219.5701233641614,1027.9628092392645,191.6073141248969,0.7209424756567193,0.7209274496372895,-793
230,2017-08-19,2017,233095,233095,294349639.86666673,3216283.916666668,170497,0,299,0.7962161350522333,28341072,2687849290,235016,235016,764989,1000005,249415247.73333204,3214394.283333352,171221,0,301,0.18834905825470794,2381049516,-1921,-1921,44934392.1333347,1889.6333333160728,-724,0,-2,0.6078670767975254,-2352708444,1262.7883046254392,1061.2692230883515,201.5190815370877,0.7314485510199704,0.7285503965687442,-724
231,2017-08-20,2017,234903,234903,294661531.96666676,3307142.5000000033,172229,0,311,0.8024674014380393,29592146,2691363530,235769,235769,788821,1024590,250001204.3166638,3302036.916666615,173004,0,311,0.187346157975382,2393849392,-866,-866,44660327.65000296,5105.583333388437,-775,0,0,0.6151212434626573,-2364257246,1254.3966316593094,1060.3650366106817,194.03159504862765,0.7331919983993394,0.7337860363321725,-775
232,2017-08-21,2017,238981,238981,295369178.6,3319494.7166666635,174138,0,293,0.7964315154761246,29378341,2701056170,239776,239776,807462,1047238,250860817.01666293,3313870.183333258,175024,0,294,0.1849331288589576,2403094413,-795,-795,44508361.5833371,5624.533333405387,-886,0,-1,0.6114983866171669,-2373716072,1235.9525594084887,1046.2298854625271,189.72267394596156,0.7286688063067776,0.7299479514213266,-886
233,2017-08-22,2017,235050,235050,295402161.3666668,3263236.250000008,172735,0,289,0.8069134226760258,29077024,2705544516,235756,235756,829033,1064789,251150003.64999828,3258627.033333269,173446,0,289,0.18087151538943508,2408175986,-706,-706,44252157.71666852,4609.216666738968,-711,0,0,0.6260419072865908,-2379098962,1256.7630775012415,1065.2963387994293,191.46673870181212,0.7348861944267178,0.7357013183121532,-711
234,2017-08-23,2017,222722,222722,295314176.3500003,3253951.3833333347,171236,0,295,0.8400472337712485,29230091,2709617864,223399,223399,855742,1079141,251290742.63333118,3248687.08333333,171916,0,298,0.17590194423156896,2417139969,-677,-677,44023433.71666914,5264.30000000447,-680,0,-3,0.6641452895396796,-2387909878,1325.931773017485,1124.8516897270408,201.08008329044424,0.7688328948195509,0.7695468645786239,-680
235,2017-08-24,2017,234114,234114,295754110.13333297,3374405.6166666686,177966,0,243,0.8320348206429348,30068077,2715314880,235066,235066,865635,1100701,251919036.0999979,3369671.566666681,178753,0,243,0.1799108022978126,2423499905,-952,-952,43835074.03333506,4734.0499999877065,-787,0,0,0.6521240183451222,-2393431828,1263.2910040977172,1071.694911641828,191.59609245588922,0.76016812322202,0.760437494150579,-787
236,2017-08-25,2017,231500,231500,296236957.46666646,3351911.25,175521,0,157,0.8284276457883369,26441713,2718651972,232127,232127,878590,1110717,252632360.11666626,3347904.8,176147,0,157,0.17530027900896325,2425986832,-627,-627,43604597.3500002,4006.4500000001863,-626,0,0,0.6531273667793737,-2399545119,1279.6412849532028,1088.3368161250792,191.30446882812362,0.7581900647948164,0.7588389114579519,-626
237,2017-08-26,2017,231209,231209,296196593.9833331,3341431.6666666665,175821,0,158,0.8388903546142247,30099802,2721780420,246552,246552,893746,1140298,252841338.70000276,3344213.5999991694,182223,0,158,0.1787471345209734,2435984491,-15343,-15343,43355255.28333035,-2781.933332502842,-6402,0,0,0.6601432200932513,-2405884689,1281.0772676813322,1025.5091773743582,255.568090306974,0.7604418513120164,0.7390854667575197,-6402
238,2017-08-27,2017,227817,227817,296496840.26666665,3270818.349999998,172779,0,159,0.8320976924461304,29537121,2726886648,230328,230328,918119,1148447,248974454.08333367,3266877.3499991666,174429,0,159,0.16861378888184936,2401234210,-2511,-2511,47522386.18333298,3941.000000831671,-1650,0,0,0.663483903564281,-2371697089,1301.4693384017287,1080.9560890700811,220.51324933164756,0.7584113564834933,0.7573069709284151,-1650
239,2017-08-28,2017,231120,231120,297025904.8166666,3328402.0499999914,174204,0,160,0.8246884735202494,28651764,2732876975,231948,231948,932371,1164319,248938908.8499987,3323440.8333333544,175044,0,163,0.1667120436924923,2400885391,-828,-828,48086995.96666789,4961.2166666369885,-840,0,-3,0.6579764298277572,-2372233627,1285.1588128100839,1073.2530948747078,211.90571793537606,0.7537383177570094,0.7546691499818925,-840
240,2017-08-29,2017,224878,224878,297013652.1666669,3272502.933333337,168564,0,75,0.8118846663524212,26557748,2732737058,225692,225692,946522,1172214,249129480.53333658,3268156.2499992703,169284,0,66,0.15819807646044684,2403689942,-814,-814,47884171.633330345,4346.683334066533,-720,0,9,0.6536865898919744,-2377132194,1320.7768308445777,1103.847192338836,216.92963850574165,0.7495797721431176,0.7500664622582989,-720
241,2017-08-30,2017,223503,223503,297156608.14999986,3276832.633333335,169931,0,74,0.8235146731811205,26800364,2733867683,224371,224371,964114,1188485,249555940.06666592,3272295.1833333387,170770,0,66,0.15758381468844918,2409595358,-868,-868,47600668.08333394,4537.449999996461,-839,0,8,0.6659308584926713,-2382794994,1329.5419218086552,1112.2468592940527,217.29506251460248,0.7603074679087082,0.7611054904599971,-839
242,2017-08-31,2017,225826,225826,297403489.3999998,3280678.483333338,172292,0,75,0.8287973926828609,26961820,2736440085,227129,227129,977640,1204769,250057861.20000947,3276643.916666125,173150,0,58,0.1580452352276703,2411587791,-1303,-1303,47345628.19999033,4034.5666672131047,-858,0,17,0.6707521574551906,-2384625971,1316.9585849282182,1100.9508305853037,216.0077543429145,0.7629413796462763,0.7623421051472952,-858
243,2017-09-01,2017,228146,228146,297368547.91666704,3320961.6166666714,175002,0,141,0.8397079063406758,26925273,2736305809,229445,229445,341585,571030,250330619.48332906,3317582.7833332475,176022,0,141,0.3416352906152082,2393459866,-1299,-1299,47037928.43333799,3378.833333423827,-1020,0,0,0.4980726157254676,-2366534593,1303.4133752801586,1091.0266925987887,212.38668268136985,0.7670614431109903,0.7671642441543725,-1020
244,2017-09-02,2017,226053,226053,297590441.04999995,3337760.46666667,172143,0,155,0.8339106315775497,27125317,2738264527,227225,227225,359262,586487,250829259.69999582,3334035.3999998625,173033,0,155,0.32816072649521527,2397206119,-1172,-1172,46761181.35000414,3725.0666668075137,-890,0,0,0.5057499050823344,-2370080802,1316.4631349727717,1103.880557597077,212.58257737569465,0.76151610463033,0.7615051160743757,-890
245,2017-09-03,2017,224681,224681,298033282.16666687,3288734.6666666665,171034,0,166,0.8346989732109079,26903169,2742266503,225610,225610,377534,603144,251542802.04999608,3284089.0499998583,171960,0,105,0.31796552730358657,2406463111,-929,-929,46490480.11667079,4645.616666808259,-926,0,61,0.5167334459073214,-2379559942,1326.4730091403674,1114.9452686050977,211.5277405352697,0.7612303666086585,0.7622002570808032,-926
246,2017-09-04,2017,231913,231913,298659963.8833332,3366213.049999996,175885,0,163,0.8305700844713325,27557142,2748893881,232718,232718,395630,628348,252403843.43332735,3361221.5499999356,176682,0,163,0.31211526097003356,2415193262,-805,-805,46256120.45000586,4991.500000060536,-797,0,0,0.5184548235012989,-2387636120,1287.8103594163897,1084.590978924395,203.2193804919948,0.7584094035263224,0.7592107185520673,-797
247,2017-09-05,2017,234606,234606,299375587.83333325,3398526.9166666623,176803,0,154,0.8253113731106613,27666319,2754169399,235526,235526,407620,643146,253354963.53333047,3393546.1499998756,177720,0,156,0.3077559372210996,2418701513,-920,-920,46020624.30000278,4980.766666786745,-917,0,-2,0.5175554358895617,-2391035194,1276.078138808612,1075.698494150669,200.37964465794312,0.753616702045131,0.7545663748375976,-917
248,2017-09-06,2017,233671,233671,299647993.5166662,3416252.6333333324,177261,0,158,0.8412939560321986,27684273,2756170123,234782,234782,422708,657490,253976215.2166634,3411182.9166665636,178351,0,159,0.3075073385146541,2426359794,-1111,-1111,45671778.30000278,5069.716666768771,-1090,0,-1,0.5337866175175445,-2398675521,1282.3499429397152,1081.7533508389204,200.59659210079485,0.7585922087036903,0.759645117598453,-1090
249,2017-09-07,2017,236402,236402,300020215.63333374,3411392.1500000013,179750,0,138,0.8411054051996179,29540582,2760558541,237427,237426,439160,676587,254646737.8833295,3405796.649999861,180708,0,138,0.2997944092925225,2436054859,-1025,-1024,45373477.75000423,5595.500000140164,-958,0,0,0.5413109959070954,-2406514277,1269.1103105444697,1072.5309691580935,196.5793413863762,0.7603573573827632,0.7611097305698172,-958
250,2017-09-08,2017,239149,239149,300444306.8499999,3416881.816666669,178878,0,143,0.8194431086895615,30759559,2767486227,240837,240837,457154,697991,255382314.16667318,3413690.7499996885,179844,0,143,0.28515124120510305,2446362968,-1688,-1688,45061992.68332672,3191.0666669807397,-966,0,0,0.5342918674844584,-2415603409,1256.3059299850718,1060.3948486597706,195.9110813253012,0.7479772024971879,0.7467457242865506,-966
251,2017-09-09,2017,234741,234741,300628037.2833332,3399106.3833333347,176807,0,170,0.8265577807029882,30317059,2772593502,235649,235649,477409,713058,255720892.08333606,3394052.0666663027,177652,0,172,0.2764136998673331,2455894206,-908,-908,44907145.19999713,5054.316667031962,-845,0,-2,0.5501440808356551,-2425577147,1280.6797162972518,1085.177073033775,195.50264326347678,0.7532003356891211,0.7538839545255868,-845
252,2017-09-10,2017,229461,229461,300954995.56666696,3307494.7833333323,172971,0,177,0.8306378861767354,29773453,2778330855,230087,230087,495001,725088,256304939.6166679,3302754.1499995934,173700,0,178,0.26645041705282546,2467736713,-626,-626,44650055.949999064,4740.633333738893,-729,0,-1,0.5641874691239099,-2437963260,1311.573625002362,1113.947939764819,197.62568523754294,0.753814373684417,0.7549318301338189,-729
253,2017-09-11,2017,232078,232078,300652347.91666627,3335641.849999993,175485,0,230,0.8331897034617682,29692753,2780125126,232952,232952,515960,748912,256259116.74999368,3330968.816666659,176258,0,230,0.26242869656247597,2479853833,-874,-874,44393231.16667259,4673.0333333341405,-773,0,0,0.5707610068992923,-2450161080,1295.4797435201367,1100.0511553882075,195.42858813192925,0.7561466403536742,0.7566279748617741,-773
254,2017-09-12,2017,238027,238027,301081245.26666695,3407644.8000000035,181922,0,265,0.8420011175202814,30187110,2787086422,238907,238907,525788,764695,256863631.26666138,3402374.933333317,182749,0,265,0.2662839432715014,2481349413,-880,-880,44217614.00000557,5269.866666686721,-827,0,0,0.57571717424878,-2451162303,1264.903751535191,1075.1615953767005,189.74215615849062,0.764291445928403,0.7649378209931061,-827
255,2017-09-13,2017,235474,235474,301337827.6499999,3421570.416666669,179413,0,183,0.839353814009191,30798420,2793598354,236113,236113,539812,775925,257316654.13332778,3416327.983333311,180066,0,183,0.2585958694461473,2488231112,-639,-639,44021173.516672134,5242.433333357796,-653,0,0,0.5807579445630436,-2457432692,1279.7074311813615,1089.8029931995602,189.90443798180127,0.7619227600499419,0.7626263695772787,-653
256,2017-09-14,2017,232920,232920,301601258.70000064,3405494.266666666,176439,0,180,0.8315988322170698,29678202,2798614988,233687,233687,559406,793093,257800202.26666045,3400925.4999999916,177080,0,180,0.24778809042570915,2498713964,-767,-767,43801056.43334019,4568.766666674521,-641,0,0,0.5838107417913606,-2469035762,1294.8705937661027,1103.1858950932676,191.6846986728351,0.757509015971149,0.7577657293730503,-641
257,2017-09-15,2017,237624,237624,301993583.45,3441857.6666666684,178500,0,429,0.8265831734168267,30609626,2803868894,238538,238538,573395,811933,258489217.73333764,3436500.733332811,179353,0,429,0.24681100534157702,2506636630,-914,-914,43504365.71666235,5356.933333857451,-853,0,0,0.5797721680752497,-2476027004,1270.888392797024,1083.639578320174,187.24881447684993,0.7511867488132512,0.7518843957776119,-853
258,2017-09-16,2017,248798,248798,302368261.8500007,3509700.7333333297,189406,0,140,0.8386281240202895,30793470,2809765976,249487,249487,588874,838361,259019658.9166625,3504483.166666657,190090,0,143,0.2524270570792227,2517387160,-689,-689,43348602.933338165,5217.566666672472,-684,0,-3,0.5862010669410669,-2486593690,1215.3162881132512,1038.2090406179982,177.10724749525298,0.7612842546965811,0.76192346695419,-684
259,2017-09-17,2017,243766,243766,302791306.25,3435653.816666668,183886,0,148,0.8315023424103443,29793898,2815277449,244628,244628,603672,848300,259625062.16667274,3430704.4499996407,184747,0,148,0.2433360839325735,2526790242,-862,-862,43166244.08332726,4949.36666702712,-861,0,0,0.5881662584777707,-2496996344,1242.139208298122,1061.3055830349458,180.83362526317615,0.7543545859553834,0.7552160831957094,-861
260,2017-09-18,2017,243308,243308,303627938.4,3458472.6333333394,180242,0,142,0.8099815871241394,29687875,2824078065,244276,244276,620875,865151,260638581.89999485,3452819.983333306,181139,0,142,0.23173873693724956,2535561394,-968,-968,42989356.500005126,5652.6500000334345,-897,0,0,0.5782428501868898,-2505873519,1247.915968237789,1066.9839931061376,180.93197513165137,0.740797672086409,0.7415341662709394,-897
261,2017-09-19,2017,244627,244627,304185287.2666668,3475946.1999999993,181547,0,118,0.8139207855224472,29548736,2829877210,245542,245542,634280,879822,261449659.68332547,3470211.633333301,182394,0,118,0.22995105828224074,2541966446,-915,-915,42735627.58334136,5734.566666698083,-847,0,0,0.5839697272402065,-2512417710,1243.4657141961713,1064.7859009184801,178.6798132776912,0.7421380305526373,0.7428220019385685,-847
262,2017-09-20,2017,205880,205880,294588380.5000003,2885416.6833333313,112186,0,77,0.5837138138721584,25181267,2789978437,206046,206046,671746,877792,252059831.3833349,2882430.5333329663,113444,0,56,0.13956837155043278,2543348427,-166,-166,42528549.11666539,2986.1500003649853,-1258,0,21,0.4441454423217256,-2518167160,1430.87420099087,1223.3182463301152,207.55595466075465,0.5449096561103556,0.5505760849519039,-1258
263,2017-09-21,2017,233045,233045,294751454.55,3366841.5166666675,177251,0,112,0.8296809629041602,28651760,2791327653,234080,234080,685703,919783,252118825.73332906,3362197.3833332937,178146,0,110,0.21337641595897888,2546570674,-1035,-1035,42632628.816670954,4644.133333373815,-895,0,2,0.6163045469451813,-2517918914,1264.783430453346,1077.062652654345,187.7207777990011,0.7605870110922783,0.7610475051264525,-895
264,2017-09-22,2017,236998,236998,294778758.08333313,3377657.399999998,179529,0,81,0.8253951510139331,28730453,2791212414,237952,237952,688468,926420,252482050.3166609,3372629.5333333453,180399,0,75,0.21429912998424586,2510980747,-954,-954,42296707.766672224,5027.866666652728,-870,0,6,0.6110960210296873,-2482250294,1243.8027244252405,1061.0629467987699,182.73977762647064,0.7575127216263429,0.7581318921463153,-870
265,2017-09-23,2017,238385,238385,295005917.5833334,3416219.7333333315,179931,0,78,0.823474631373618,28937718,2793455128,239220,239220,698289,937509,253073743.71666348,3410818.1833333,180781,0,71,0.2120075647273846,2514721135,-835,-835,41932173.86666989,5401.550000031479,-850,0,7,0.6114670666462334,-2485783417,1237.518793478337,1057.9121466293097,179.60664684902736,0.7547916186001636,0.7557102248975838,-850
266,2017-09-24,2017,239842,239842,295373397.06666654,3405957.6333333347,181610,0,123,0.8260855062916413,29651447,2797712401,240835,240835,713613,954448,253717355.2166635,3401243.7333333096,182553,0,122,0.210727038036645,2524270850,-993,-993,41656041.850003034,4713.900000025053,-943,0,1,0.6153584682549964,-2494619403,1231.5332471654945,1053.490378128858,178.04286903663638,0.7572068278283203,0.758000290655428,-943
267,2017-09-25,2017,237887,237887,295977040.4833333,3443856.549999996,179847,0,79,0.8258711068700678,29650537,2804806556,238732,238732,730493,969225,254531223.299996,3438731.766666621,180670,0,54,0.20561995408702738,2534037052,-845,-845,41445817.1833373,5124.783333375119,-823,0,25,0.6202511527830404,-2504386515,1244.1917401259138,1066.1797467452875,178.01199338062634,0.7560186138796992,0.7567900407151115,-823
268,2017-09-26,2017,237261,237261,296234725.5833337,3413252.166666673,178520,0,84,0.8201263587357391,29035889,2808272021,238175,238175,743464,981639,255068512.8999948,3407959.3333333153,179307,0,42,0.2016382804676662,2538477721,-914,-914,41166212.68333888,5292.833333357703,-787,0,42,0.618488078268073,-2509441832,1248.5605539188223,1070.9289929673341,177.63156095148815,0.7524203303534925,0.7528371995381548,-787
269,2017-09-27,2017,237146,237146,296260066.73333275,3381981.850000002,177152,0,99,0.8132500653605788,29812998,2811168127,238115,238115,761523,999638,255318654.09999478,3376944.333333333,177978,0,49,0.19575386289836932,2547816131,-969,-969,40941412.633337975,5037.516666668933,-826,0,50,0.6174962024622095,-2518003133,1249.2728814035775,1072.2493505238847,177.02353087969277,0.7470166058040195,0.7474455620183524,-826
270,2017-09-28,2017,231459,231459,296246403.91666675,3316308.199999997,174013,0,69,0.8167623639607882,29538475,2814626836,232456,232456,779319,1011775,255607158.0333316,3311365.36666656,174856,0,37,0.18916063354006218,2552994246,-997,-997,40639245.88333514,4942.833333436865,-843,0,32,0.627601730420726,-2523455771,1279.9087696597096,1099.5937211056355,180.3150485540741,0.7518091757071447,0.7522111711463675,-843
271,2017-09-29,2017,231275,231275,296152812.59999996,3311339.1333333305,173939,0,67,0.8194703275321589,29493748,2817474410,232030,232030,796014,1028044,255760046.21666622,3306582.166666587,174648,0,50,0.1867410344304272,2559501591,-755,-755,40392766.38333374,4756.966666743625,-709,0,17,0.6327292931017316,-2530007843,1280.5223763917413,1102.271457210991,178.25091918075032,0.7520873419089829,0.7526957720984355,-709
272,2017-09-30,2017,234043,234043,296606728.89999986,3335100.3833333314,175049,0,74,0.8165935319578018,29191267,2823678502,234813,234813,810129,1044942,256363119.76666695,3329318.44999986,175804,0,60,0.18571939878002627,2564502333,-770,-770,40243609.13333291,5781.933333471417,-755,0,14,0.6308741331777755,-2535311066,1267.3172404216314,1091.7756673040544,175.54157311757695,0.7479352084873293,0.7486979000310886,-755
273,2017-10-01,2017,223123,223123,296186600.90000033,3245974.0,169018,0,96,0.827435988221743,28391233,2822643833,231649,231648,328965,560614,256166983.71666062,3248135.5166665902,171723,0,54,0.3381845619267447,2546450514,-8526,-8525,40019617.183339715,-2161.516666590236,-2705,0,42,0.48925142629499835,-2518059281,1327.4588496031351,1105.8458683721017,221.61298123103347,0.7575104314660523,0.7413068910291001,-2705
274,2017-10-02,2017,222572,222572,296103928.9333334,3232456.21666667,167016,0,73,0.8160819869525366,29229505,2825878143,223421,223421,354479,577900,255020393.1666646,3227410.3833331987,167757,0,39,0.31889081155909155,2540380100,-849,-849,41083535.7666688,5045.833333471324,-741,0,34,0.4971911753934451,-2511150595,1330.373672040209,1141.434301908346,188.93937013186292,0.7503908847474076,0.7508560072687885,-741
275,2017-10-03,2017,216926,216926,295553273.03333306,3156708.599999999,163425,0,104,0.8151166757327393,28460938,2824499206,217828,217828,367174,585002,254640615.58332705,3152850.649999885,164101,0,69,0.30678185715604056,2541938234,-902,-902,40912657.45000601,3857.9500001142733,-676,0,35,0.5083348185766987,-2513477296,1362.4612680514695,1168.9985474012847,193.4627206501848,0.7533675078137245,0.7533512679728961,-676
276,2017-10-04,2017,211250,211250,295058562.7999997,3149794.2666666666,160745,0,74,0.8243550295857995,28108545,2824269050,212029,212029,385862,597891,254446313.34999543,3144709.3333331426,161437,0,62,0.2960456002849985,2547143027,-779,-779,40612249.45000428,5084.933333524037,-692,0,12,0.528309429300801,-2519034482,1396.72692449704,1200.054300826752,196.67262367028798,0.7609230769230769,0.7613911304585693,-692
277,2017-10-05,2017,218686,218686,294903251.9166668,3208666.649999995,166016,0,73,0.8274375131467022,29018299,2823613970,219574,219574,398557,618131,254513841.39999473,3203815.783333189,166758,0,86,0.2967299811852174,2552225337,-888,-888,40389410.516672075,4850.86666680593,-742,0,-13,0.5307075319614849,-2523207038,1348.5236911218221,1159.1255859072328,189.39810521458935,0.7591523920141207,0.7594615027280097,-742
278,2017-10-06,2017,221584,221584,294869720.30000013,3225611.5166666643,168622,0,128,0.8272573832045639,28373509,2824013956,222900,222900,410963,633863,254734256.93333066,3222464.516666536,169403,0,92,0.2930112658413519,2553387895,-1316,-1316,40135463.366669476,3147.000000128057,-781,0,36,0.534246117363212,-2525014386,1330.7356140335048,1142.8185595932287,187.91705444027616,0.7609845476207668,0.759995513683266,-781
279,2017-10-07,2017,216699,216699,295038857.98333305,3217491.7500000023,164499,0,93,0.8262613117734736,28168611,2827324451,217320,217320,427179,644499,255048879.26666236,3214142.24999986,165177,0,70,0.2817987304867909,2554909709,-621,-621,39989978.71667069,3349.5000001424924,-678,0,23,0.5444625812866828,-2526741098,1361.5146262019348,1173.60978863732,187.9048375646148,0.7591128708485041,0.7600635008282717,-678
280,2017-10-08,2017,218101,218101,295349644.0666669,3222399.133333335,165999,0,71,0.8249343194208185,28499629,2830563589,218998,218998,441478,660476,255570606.9999969,3219640.83333321,166656,0,50,0.2757420405889055,2564202859,-897,-897,39779037.06667,2758.3000001250766,-657,0,21,0.549192278831913,-2535703230,1354.1874822521074,1166.999730591133,187.18775166097453,0.7611106780803389,0.7609932510799186,-657
281,2017-10-09,2017,220363,220363,296005141.26666665,3215992.1666666656,167488,0,60,0.8259598934485376,28512204,2838574368,221297,221297,456331,677628,256362210.5999965,3212143.149999893,168225,0,50,0.27278388732460335,2571199475,-934,-934,39642930.66667014,3849.0166667727754,-737,0,10,0.5531760061239342,-2542687271,1343.2615333185092,1158.4531674627153,184.8083658557939,0.7600550001588289,0.7601774990171579,-737
282,2017-10-10,2017,217960,217960,295782544.6833333,3190855.783333328,165421,0,61,0.8204349421912279,28083794,2838692824,218716,218716,470511,689227,256368173.31666285,3186399.1833332116,166038,0,50,0.26259418159764913,2575718494,-756,-756,39414371.36667043,4456.600000116508,-617,0,11,0.5578407605935788,-2547634700,1357.0496636232945,1172.1509780567624,184.8986855665321,0.7589511837034318,0.759148850564202,-617
283,2017-10-11,2017,223378,223378,295838953.0833333,3217159.549999999,171276,0,99,0.8320112096983582,28775688,2841070137,223906,223906,484157,708063,256719332.89999792,3212722.4666662733,171815,0,69,0.2647024346703505,2583619225,-528,-528,39119620.18333539,4437.083333725575,-539,0,30,0.5673087750280077,-2554843537,1324.387151301083,1146.5495917929752,177.8375595081077,0.7667541118641943,0.7673532643162756,-539
284,2017-10-12,2017,218834,218834,295621600.3666664,3192049.733333335,166940,0,201,0.8221117376641657,28780759,2842474742,219438,219438,498703,718141,256657198.28332996,3187213.316666592,167363,0,201,0.2521914220187955,2588784747,-604,-604,38964402.08333641,4836.41666674288,-423,0,0,0.5699203156453702,-2560003988,1350.8942868414706,1169.611454184462,181.2828326570086,0.7628613469570542,0.7626892334053355,-423
285,2017-10-13,2017,215852,215852,295623084.5166666,3180678.3499999945,165628,0,216,0.8215304931156521,28607716,2844535867,216686,216686,514589,731275,256862583.06666273,3176832.5500000007,166160,0,216,0.24433626200813474,2594045834,-834,-834,38760501.45000386,3845.79999999376,-532,0,0,0.5771942311075173,-2565438118,1369.5637961041205,1185.4138387651383,184.14995733898218,0.7673220539999629,0.7668238834073268,-532
286,2017-10-14,2017,212439,212439,295393451.3000008,3150875.6166666667,163020,0,103,0.8243589924637189,28486939,2844007203,218714,218714,530204,748918,256891243.16666022,3151177.049999999,164951,0,103,0.23754937122622188,2599354525,-6275,-6275,38502208.13334057,-301.4333333321847,-1931,0,0,0.586809621237497,-2570867586,1390.4859809168786,1174.5532666709046,215.932714245974,0.7673732224309096,0.7541858317254497,-1931
287,2017-10-15,2017,207845,207845,295126705.0500004,3116013.2333333343,159573,0,65,0.8258702398421908,28422347,2843896779,208429,208429,551364,759793,256408218.99999756,3111462.7999999896,160159,0,66,0.22827270059081686,2601289011,-584,-584,38718486.05000287,4550.433333344758,-586,0,-1,0.5975975392513739,-2572866664,1419.9365154321752,1230.1945458645273,189.74196956764786,0.767750006014097,0.7684103459691309,-586
288,2017-10-16,2017,211573,211573,295367617.9999999,3144965.433333331,162429,0,57,0.822420630231645,28206603,2847312060,212182,212182,561336,773518,256848506.59999645,3140421.749999999,162932,0,57,0.22672516993786426,2606956621,-609,-609,38519111.40000343,4543.683333331719,-503,0,0,0.5956954602937807,-2578750018,1396.0553473269267,1210.5103477203365,185.54499960659018,0.7677208339438397,0.7678879452545456,-503
289,2017-10-17,2017,219884,219884,295707635.78333306,3223280.8333333367,170258,0,59,0.8346628222153502,27997532,2850359652,220394,220394,570504,790898,257367096.7166626,3219411.2999999914,170638,0,55,0.23337901979775116,2607757313,-510,-510,38340539.06667048,3869.5333333453164,-380,0,4,0.601283802417599,-2579759781,1344.8347118632237,1167.75908925226,177.0756226109636,0.7743082716341344,0.7742406780583864,-380
290,2017-10-18,2017,219925,219925,296007671.96666664,3261340.4499999993,168452,0,65,0.8244265090371722,28601600,2853991989,220865,220865,579101,799966,257793356.583328,3258608.866666627,168996,0,65,0.2282984526842404,2610619279,-940,-940,38214315.38333863,2731.5833333721384,-544,0,0,0.5961280563529318,-2582017679,1345.9482640294038,1167.1987711195889,178.749492909815,0.7659520291008298,0.7651551852941842,-544
291,2017-10-19,2017,221414,221414,296290020.13333315,3276205.416666665,169012,0,62,0.8215876141526733,29447619,2857619933,222062,222062,592394,814456,258274659.94999576,3271368.4166666474,169548,0,62,0.22498575736442528,2617035367,-648,-648,38015360.18333739,4837.000000017695,-536,0,0,0.5966018567882481,-2587587748,1338.172022244904,1163.074546523024,175.09747572187985,0.7633302320539803,0.7635164953931785,-536
292,2017-10-20,2017,220499,220499,296688570.1500001,3234224.466666663,168599,0,53,0.8229561131796519,28269120,2861464863,221031,221031,607768,828799,258902428.6833303,3229407.5333333,169085,0,50,0.22049133746541277,2622781434,-532,-532,37786141.4666698,4816.933333362918,-486,0,3,0.6024647757142392,-2594512314,1345.5324974262926,1171.3398965906606,174.192600835632,0.764624782878834,0.7649831924028756,-486
293,2017-10-21,2017,210447,210447,296139182.53333366,3141180.2333333367,161742,0,76,0.8287312244888262,26917357,2858427505,210853,210853,625315,836168,258565839.38334548,3136662.666666116,162159,0,87,0.20967795945312007,2628339735,-406,-406,37573343.149988174,4517.566667220555,-417,0,-11,0.6190532650357061,-2601422378,1407.1912763466985,1226.2848495555932,180.90642679110533,0.7685640565082895,0.7690618582614428,-417
294,2017-10-22,2017,207798,207798,295537704.0499997,3121155.783333333,158226,0,71,0.8198105852799348,27442017,2855877999,208573,208573,642829,851402,258264143.43333054,3118339.0499999933,158636,0,67,0.20128681868259699,2638547481,-775,-775,37273560.61666918,2816.7333333399147,-410,0,4,0.6185237665973378,-2611105464,1422.2355559245023,1238.2434132573753,183.99214266712693,0.76144139982098,0.7605778312629151,-410
295,2017-10-23,2017,228943,228943,295998686.8333333,3211528.066666667,176128,0,58,0.8307002179581817,28952753,2862027274,229352,229352,653965,883317,258868465.48332763,3207126.4833333488,176538,0,58,0.21653607934637054,2644623739,-409,-409,37130221.35000569,4401.583333318122,-410,0,0,0.6141641386118112,-2615670986,1292.8924965311598,1128.6950429179935,164.19745361316632,0.769309391420572,0.7697251386515052,-410
296,2017-10-24,2017,219990,219990,296159937.78333366,3246839.9833333287,167254,0,86,0.8203372880585491,29058779,2865442617,220485,220485,663224,883709,259197188.63332745,3242555.116666639,167749,0,81,0.20549298468161353,2642203028,-495,-495,36962749.150006205,4284.866666689515,-495,0,5,0.6148443033769355,-2613144249,1346.2427282300725,1175.5774253728257,170.66530285724684,0.7602800127278513,0.7608181962491779,-495
297,2017-10-25,2017,224360,224360,296611401.5666665,3300280.3833333394,170696,0,54,0.8239258334819033,29357326,2869895540,225179,225179,674937,900116,259834367.36666262,3296551.89999998,171252,0,48,0.2067611285656509,2646244465,-819,-819,36777034.20000386,3728.4833333594725,-556,0,6,0.6171647049162524,-2616887139,1322.0333462589876,1153.9014178349785,168.13192842400917,0.7608129791406668,0.7605149680920512,-556
298,2017-10-26,2017,226781,226781,297274133.8500005,3336512.3499999973,173040,0,61,0.8264448961773702,29685781,2875844865,227748,227748,686516,914264,260767053.68332928,3333063.7999999807,173596,0,59,0.20663834516069907,2652600382,-967,-967,36507080.16667122,3448.5500000165775,-556,0,2,0.619806551016671,-2622914601,1310.8423273995638,1144.9806526657942,165.86167473376963,0.7630268849683175,0.7622284279115513,-556
299,2017-10-27,2017,230346,230346,297698797.16666603,3325978.566666666,177043,0,80,0.8322089378586993,29135965,2880684273,230769,230769,700557,931326,261378170.44999367,3321702.0166666396,177464,0,93,0.2073044240147916,2661464641,-423,-423,36320626.71667236,4276.550000026356,-421,0,-13,0.6249045138439078,-2632328676,1292.3983796838932,1132.6398712565106,159.7585084273826,0.7685959382841464,0.7690114356781024,-421
300,2017-10-28,2017,219231,219231,297288541.1833333,3220304.45,168714,0,167,0.8340152624400742,28967543,2881044727,219701,219701,717345,937046,261146409.6166612,3215557.433333298,169179,0,167,0.19671819739906488,2668825504,-470,-470,36142131.56667209,4747.016666701995,-465,0,0,0.6372970650410092,-2639857961,1356.0515674486421,1188.6446107057373,167.40695674290487,0.7695718215033458,0.7700420116430967,-465
301,2017-10-29,2017,208798,208798,296428959.0500001,3081489.3833333296,159103,0,261,0.8256831961991974,28242161,2879486795,209307,209307,739898,949205,260543485.51666096,3077560.716666668,159562,0,261,0.1828698753167132,2678782092,-509,-509,35885473.53333911,3928.666666661389,-459,0,0,0.6428133208824842,-2650539931,1419.6925212406252,1244.7910749122627,174.90144632836245,0.7619948466939338,0.762334752301643,-459
302,2017-10-30,2017,226038,226038,296678785.0500001,3185655.883333329,173091,0,73,0.8282810854812033,28178547,2883258566,227049,227049,751127,978176,260986977.46666127,3181965.0666666846,173655,0,70,0.19282726216959067,2685736122,-1011,-1011,35691807.5833388,3690.8166666445322,-564,0,3,0.6354538233116126,-2657557575,1312.5172981976484,1149.4742432984126,163.0430548992358,0.7657606243198046,0.7648349034789848,-564
303,2017-10-31,2017,218184,218184,296615451.21666646,3196866.8166666646,166548,0,66,0.8263392366076334,27531450,2883468031,218676,218676,760292,978968,261111473.71666232,3191891.766666677,167047,0,52,0.18542587704603566,2682123850,-492,-492,35503977.50000414,4975.0499999877065,-499,0,14,0.6409133595615978,-2654592400,1359.4738900041546,1194.056383492758,165.4175065113966,0.7633373666263338,0.7639018456529294,-499
304,2017-11-01,2017,221561,221561,297076849.83333343,3272567.7833333355,167679,0,63,0.8201894737792305,29071374,2888386516,222120,222120,303669,525789,261672942.99999613,3268029.5833332,168309,0,43,0.3490088229308702,2651415040,-559,-559,35403906.83333731,4538.200000135694,-630,0,20,0.47118065084836025,-2622343666,1340.8354802213992,1178.0701557716375,162.7653244497617,0.756807380360262,0.7577390599675851,-630
305,2017-11-02,2017,225720,225720,297592198.20000005,3248506.8833333417,172093,0,61,0.8253234095339358,28970868,2893541562,226434,226434,317779,544213,262346990.06666154,3244089.916666551,172672,0,61,0.34523798586215276,2657051491,-714,-714,35245208.13333851,4416.966666790657,-579,0,0,0.48008542367178303,-2628080623,1318.4130701754389,1158.6024628221094,159.8106073533295,0.762418040049619,0.7625709919888356,-579
306,2017-11-03,2017,216415,216415,297455440.65000004,3119694.0333333346,164651,0,54,0.8198461289651827,27767777,2895481680,217449,217447,338803,556252,262414231.0666626,3117461.6666665548,165212,0,50,0.3213040132889399,2662534258,-1034,-1032,35041209.583337426,2232.3666667798534,-561,0,4,0.4985421156762428,-2634766481,1374.46776170783,1206.7962816992767,167.67148000855332,0.7608114040154333,0.7597735560982115,-561
307,2017-11-04,2017,209252,209252,296947181.3000008,3098007.8666666676,158360,0,61,0.8126756255615244,27288078,2894184994,209795,209795,358763,568558,262094130.6999944,3093945.016666591,158867,0,58,0.30169129622660057,2669415730,-543,-543,34853050.6000064,4062.8500000764616,-507,0,3,0.5109843293349239,-2642127652,1419.0888560204958,1249.2868309539997,169.80202506649607,0.756790855045591,0.7572487428203722,-507
308,2017-11-05,2017,209736,209736,297022608.6666667,3094565.266666665,158684,0,79,0.8148243506121986,27900219,2896528273,210156,210156,374359,584515,262297544.6333298,3090464.583333203,159183,0,54,0.2948837925459532,2678421726,-420,-420,34725064.03333688,4100.683333462104,-499,0,25,0.5199405580662454,-2650521507,1416.1737072637347,1248.1087603177155,168.0649469460193,0.7565892359919136,0.7574516073773768,-499
309,2017-11-06,2017,220404,220404,297534976.71666634,3214747.2999999956,167243,0,55,0.817253770348996,27947201,2900193144,221188,221188,386606,607794,263043586.26666033,3211760.2833332503,167775,0,48,0.2982243983981345,2683989414,-784,-784,34491390.45000601,2987.0166667453013,-532,0,7,0.5190293719508615,-2656042213,1349.9527082841796,1189.2308184289398,160.72188985523985,0.7588020181121939,0.7585176411016873,-532
310,2017-11-07,2017,219272,219272,297825871.0166667,3208801.8999999985,167533,0,50,0.8263435367944832,27505835,2900499280,220310,220310,394184,614494,263559857.23332965,3206357.133333238,168072,0,46,0.2969158364442956,2682325910,-1038,-1038,34266013.78333706,2444.766666760668,-539,0,4,0.5294277003501877,-2654820075,1358.248527019714,1196.3136363911292,161.93489062858475,0.7640419205370499,0.7628886568925605,-539
311,2017-11-08,2017,216556,216556,297882710.46666646,3159806.1833333354,164641,0,78,0.8171419863684221,27208508,2901305415,217863,217863,411867,629730,263771031.13332844,3157506.0333332205,165173,0,78,0.28270369841043624,2687201119,-1307,-1307,34111679.33333802,2300.150000114925,-532,0,0,0.5344382879579859,-2659992611,1375.5458655805726,1210.7197235571366,164.82614202343598,0.7602698609135743,0.7581507644712503,-532
312,2017-11-09,2017,217980,217980,298212008.0833335,3178854.433333338,166722,0,79,0.8265345444536204,27564426,2904868400,218845,218845,425653,644498,264240838.5333253,3177046.683333261,167135,0,79,0.28120956155023397,2693818651,-865,-865,33971169.55000818,1807.750000076834,-413,0,0,0.5453249829033864,-2666254225,1368.0705022632053,1207.433747781879,160.6367544813263,0.7648499862372695,0.7637140441865247,-413
313,2017-11-10,2017,217948,217948,298327297.63333344,3154945.4666666654,166059,0,129,0.825646484482537,27865907,2907856814,218504,218504,440734,659238,264451268.23332638,3150890.6999999136,166354,0,129,0.2741923250783486,2700231537,-556,-556,33876029.40000707,4054.7666667518206,-295,0,0,0.5514541594041884,-2672365630,1368.8003451893728,1210.2811309327353,158.5192142566375,0.7619202745609044,0.7613316003368359,-295
314,2017-11-11,2017,215506,215506,297907585.10000014,3140599.5000000014,164398,0,137,0.8297216782827386,27874519,2906514909,215876,215876,457822,673698,264167959.13333774,3136232.5666662115,164801,0,140,0.2671419538131426,2704952910,-370,-370,33739625.96666241,4366.93333378993,-403,0,-3,0.562579724469596,-2677078391,1382.3632989336731,1223.7023065710766,158.66099236259652,0.7628465100739654,0.7634058440956846,-403
315,2017-11-12,2017,211392,211392,297886987.3666669,3108052.2999999993,160202,0,82,0.8174386920980923,27907103,2908090097,212173,212173,472977,685150,264312154.64999473,3104291.76666656,160672,0,82,0.25414288841859906,2711159132,-781,-781,33574832.71667218,3760.53333343938,-470,0,0,0.5632958036794933,-2683252029,1409.1686883451923,1245.7388765299766,163.42981181521577,0.7578432485619134,0.7572688325093202,-470
316,2017-11-13,2017,219034,219034,298343076.0333335,3157860.4000000004,165662,0,50,0.81630249185058,28366888,2913910087,219459,219459,486484,705943,264895056.1166618,3153301.8333332557,166036,0,51,0.25462678998163013,2717656921,-425,-425,33448019.916671693,4558.566666744649,-374,0,-1,0.5616757018689499,-2689290033,1362.0856854795761,1207.0366497462478,155.0490357333283,0.7563300674781084,0.7565695642466247,-374
317,2017-11-14,2017,214225,214225,298562810.2999998,3154136.1833333345,163527,0,46,0.8211506593534834,27558782,2915228744,214699,214699,499831,714530,265319340.5833271,3151003.799999885,163856,0,46,0.24723804458875157,2717493192,-474,-474,33243469.71667266,3132.3833334497176,-329,0,0,0.5739126147647319,-2689934410,1393.687992998015,1235.7735275121315,157.9144654858835,0.7633422803127553,0.7631893953860986,-329
318,2017-11-15,2017,214121,214121,298729100.9,3168592.0999999978,163773,0,48,0.8225069003040342,28367102,2916811772,214536,214536,511577,726113,265643173.8833296,3164814.1833333382,164131,0,48,0.24369072031487946,2722460424,-415,-415,33085927.016670376,3777.9166666595265,-358,0,0,0.5788161799891547,-2694093322,1395.1415363275903,1238.2219016077936,156.9196347197967,0.7648619238654779,0.7650510869970542,-358
319,2017-11-16,2017,221291,221291,298856342.0333333,3201053.549999999,169536,0,54,0.8309330248405953,28473900,2917613909,222684,222684,523287,745971,265967892.0333284,3198841.3666666825,169973,0,50,0.24821474293236323,2727544000,-1393,-1393,32888450.000004888,2212.183333316352,-437,0,4,0.582718281908232,-2699070100,1350.5128633036738,1194.3736057971314,156.13925750654244,0.7661224360683444,0.7632923784376067,-437
320,2017-11-17,2017,210581,210581,298077904.83333343,3161261.033333331,164780,0,66,0.8458645366865956,28896677,2913289435,210842,210842,537424,748266,265302657.53333658,3157590.6333328946,165077,0,66,0.23908743682059538,2732189836,-261,-261,32775247.299996853,3670.4000004362315,-297,0,0,0.6067770998660001,-2703293159,1415.50237121741,1258.3008012319015,157.2015699855085,0.7825017451716917,0.7829417288775481,-297
321,2017-11-18,2017,199637,199637,297287053.6999997,3031435.1666666633,156271,0,128,0.8448734453032253,28073729,2911651482,199866,199866,555441,755307,264628855.53332675,3027961.1500000237,156537,0,125,0.2242545084316689,2737775640,-229,-229,32658198.166672945,3474.016666639596,-266,0,3,0.6206189368715564,-2709701911,1489.138054068132,1324.0313786903562,165.1066753777759,0.7827757379644054,0.783209750532857,-266
322,2017-11-19,2017,204190,204190,297368788.2,3068421.7666666685,160570,0,89,0.846775062441843,28033951,2914511374,204585,204585,563427,768012,264844201.2666631,3064280.98333338,160977,0,88,0.2262868288516319,2744734611,-395,-395,32524586.933336884,4140.783333288506,-407,0,1,0.6204882335902111,-2716700660,1456.3337489593025,1294.5435944309852,161.79015452831732,0.7863754346442039,0.7868465430016863,-407
323,2017-11-20,2017,205049,205049,297679754.5000002,3095808.1000000034,158063,0,50,0.832313251954411,27315009,2918691329,206169,206169,572247,778416,265286838.14999574,3092462.466666694,158437,0,50,0.220407853898168,2748497156,-1120,-1120,32392916.350004435,3345.6333333095536,-374,0,0,0.611905398056243,-2721182147,1451.7493599090958,1286.7445549524698,165.004804956626,0.7708547712985676,0.7684811974642163,-374
324,2017-11-21,2017,212589,212589,297927027.5833331,3110700.866666669,160604,0,79,0.8138520807755811,27306518,2921338877,214127,214127,580593,794720,265698602.01666233,3107902.2166667227,161129,0,79,0.21931372055566703,2748387585,-1538,-1538,32228425.566670746,2798.649999946356,-525,0,0,0.5945383602199141,-2721081067,1401.4225928121073,1240.8458625799751,160.57673023213215,0.7554671220053719,0.7524926795780075,-525
325,2017-11-22,2017,211386,211386,297892889.13333315,3094025.600000001,158159,0,96,0.8074754241056642,27814931,2921593087,212158,212158,595443,807601,265559779.03332773,3090510.9500000253,158484,0,96,0.21238829570542916,2748531574,-772,-772,32333110.100005418,3514.6499999756925,-325,0,0,0.595087128400235,-2720716643,1409.2366057039403,1251.7075907263818,157.52901497755852,0.7481999754004522,0.7470093043863536,-325
326,2017-11-23,2017,208671,208671,297977761.43333346,3072815.000000002,156321,0,302,0.8126524529043316,27467229,2923801001,209172,209172,612023,821195,265796361.48333874,3068586.2833329495,156674,0,302,0.20757189218151478,2751666176,-501,-501,32181399.949994713,4228.716667052358,-353,0,0,0.6050805607228169,-2724198947,1427.9787868622543,1270.7071763110682,157.2716105511861,0.7491266155814655,0.7490199453081674,-353
327,2017-11-24,2017,209249,209249,298213189.68333375,3072612.866666661,156473,0,217,0.8051460222032127,26574336,2926128785,209588,209588,626813,836401,266168748.50001416,3070821.916666249,156807,0,217,0.2026575769278168,2756831730,-339,-339,32044441.1833196,1790.9500004122965,-334,0,0,0.6024884452753959,-2730257394,1425.1594496668263,1269.9617750062703,155.197674660556,0.7477837409019876,0.7481678340362998,-334
328,2017-11-25,2017,209584,209584,298194674.03333324,3058553.1833333354,157189,0,246,0.8117842965111838,26821687,2927263437,210438,210438,640848,851286,266305868.98333132,3056139.1499999957,157685,0,246,0.20139647545008754,2759686929,-854,-854,31888805.05000192,2414.0333333397284,-496,0,0,0.6103878210610962,-2732865242,1422.7931236799243,1265.483748103153,157.30937557677134,0.7500047713565922,0.7493180889383096,-496
329,2017-11-26,2017,208668,208668,298205336.26666653,3045780.699999994,156289,0,262,0.8131769126075868,26230949,2928112919,209881,209881,656326,866207,266485418.9999951,3043556.816666671,156792,0,262,0.19733620254742587,2765636239,-1213,-1213,31719917.26667142,2223.8833333230577,-503,0,0,0.615840710060161,-2739405290,1429.089924026044,1269.697681066867,159.39224295917688,0.7489840320509135,0.7470519008390469,-503
330,2017-11-27,2017,215372,215372,298629365.11666685,3106931.1499999966,161190,0,247,0.8073797893876632,27265029,2932148609,215899,215899,669085,884984,266986085.91666144,3102325.4166666805,161585,0,247,0.19766911040199858,2771666748,-527,-527,31643279.200005412,4605.733333316166,-395,0,0,0.6097106789856646,-2744401719,1386.5746945594917,1236.624930716036,149.94976384345568,0.7484259792359267,0.7484286634027948,-395
331,2017-11-28,2017,215520,215520,298662831.8166665,3119381.35,162104,0,196,0.815089086859688,27563160,2932521379,216079,216079,679701,895780,267214259.91666156,3115242.733333389,162502,0,196,0.19775168010002545,2770161342,-559,-559,31448571.900004923,4138.616666611284,-398,0,0,0.6173374067596625,-2742598182,1385.777801673471,1236.6507616041426,149.12704006932836,0.7521529324424647,0.7520490191087519,-398
332,2017-11-29,2017,214832,214832,298785653.8499996,3090191.0500000026,162179,0,140,0.8111454531913312,26865568,2934588733,215430,215430,695191,910621,267482408.14999437,3086622.5000000033,162587,0,140,0.19265863624932952,2773452406,-598,-598,31303245.700005233,3568.549999999348,-408,0,0,0.6184868169420017,-2746586838,1390.787470442018,1241.6209819894832,149.16648845253485,0.7549108140314292,0.7547091862786056,-408
333,2017-11-30,2017,211011,211011,298797392.6833327,3066045.4,159478,0,115,0.8110240698352217,26577368,2936644414,211505,211505,710581,922086,267624376.53332698,3062689.2666666843,159732,0,115,0.1862624527430199,2776822716,-494,-494,31173016.1500057,3356.133333315607,-254,0,0,0.6247616170922018,-2750245348,1416.0275657825075,1265.3335691039313,150.69399667857624,0.7557805043338973,0.7552161887425829,-254
334,2017-12-01,2017,207967,207967,298708883.10000044,3046942.066666661,157215,0,124,0.8106093755259238,26633130,2937972744,208247,208247,298587,506834,267692803.59999618,3043006.033333217,157557,0,124,0.3343126151757767,2741771605,-280,-280,31016079.50000426,3936.0333334440365,-342,0,0,0.4762967603501471,-2715138475,1436.3282785249603,1285.4581511378133,150.87012738714702,0.7559612823188294,0.7565871297065504,-342
335,2017-12-02,2017,204332,204332,298469699.8166666,3028844.83333333,155258,0,109,0.8207867588042983,26314033,2936298834,204774,204774,316877,521651,267646721.61666793,3025537.6833332377,155556,0,109,0.323258270376167,2746054958,-442,-442,30822978.199998677,3307.1500000925735,-298,0,0,0.4975284884281313,-2719740925,1460.7095306494655,1307.0346900322693,153.6748406171962,0.7598320380557132,0.759647220838583,-298
336,2017-12-03,2017,201739,201739,298592947.50000006,3000580.999999996,152985,0,98,0.8170408299832953,26680210,2939798317,202034,202034,331548,533582,267892692.4333349,2997418.083333287,153259,0,98,0.3101622618454182,2752215274,-295,-295,30700255.066665173,3162.9166667088866,-274,0,0,0.5068785681378771,-2725535064,1480.0953087900707,1325.9782632296292,154.1170455604415,0.7583313092659327,0.7585802389696784,-274
337,2017-12-04,2017,202727,202727,298912203.06666625,3024846.133333337,153682,0,106,0.8131526634340757,27022926,2944586535,202949,202949,346241,549190,268303323.8666702,3021384.9666665792,153844,0,104,0.30095777417651265,2757815356,-222,-222,30608879.199996054,3461.166666757781,-162,0,2,0.512194889257563,-2730792430,1474.4567969074974,1322.0233845284786,152.43341237901882,0.7580736655699537,0.7580426609640846,-162
338,2017-12-05,2017,209250,209250,298964723.133333,3027467.0999999936,158025,0,84,0.8097443249701312,26606450,2945294234,209700,209700,358567,568267,268479025.2166677,3024014.6999998926,158302,0,84,0.299537013410948,2758999284,-450,-450,30485697.916665316,3452.4000001009554,-277,0,0,0.5102073115591832,-2732392834,1428.7441965750681,1280.3005494357067,148.44364713936147,0.7551971326164875,0.754897472579876,-277
339,2017-12-06,2017,208300,208300,299071922.2166672,3055120.0666666664,157771,0,100,0.8148679788766195,26371341,2946190259,208786,208786,371849,580635,268637594.8166709,3051586.1499999156,158159,0,100,0.29425887175248444,2761303275,-486,-486,30434327.39999628,3533.916666750796,-388,0,0,0.5206091071241351,-2734931934,1435.7749506321036,1286.6647898646024,149.11016076750116,0.7574219875180028,0.7575172664833849,-388
340,2017-12-07,2017,208373,208373,299118736.3166663,3028320.733333333,159529,0,114,0.8262346849159927,26153130,2947242423,209226,209226,385775,595001,268887208.51667064,3026007.0666666436,159872,0,114,0.29076925921133295,2765262316,-853,-853,30231527.79999566,2313.666666689329,-343,0,0,0.5354654257046598,-2739109186,1435.4966157643566,1285.151981668964,150.34463409539262,0.7655934310107355,0.7641115348952807,-343
341,2017-12-08,2017,203883,203883,299033793.3166665,2993459.166666666,153537,0,113,0.8129123075489372,26153849,2949531121,204398,204398,402323,606721,268913468.4333414,2990072.6999998707,153884,0,113,0.27491219193005295,2769852208,-515,-515,30120324.8833251,3386.4666667953134,-347,0,0,0.5380001156188843,-2743698359,1466.6931196650357,1315.6364956278505,151.0566240371852,0.7530642574417681,0.7528645094374701,-347
342,2017-12-09,2017,209095,209095,298998091.28333354,3029930.000000001,157864,0,149,0.8172170544489347,26579688,2951500555,209266,209266,417586,626852,269014052.2000114,3026212.966666544,158128,0,149,0.27382221002724655,2774460915,-171,-171,29984039.083322167,3717.033333457075,-264,0,0,0.5433948444216881,-2747881227,1429.9628938201943,1285.512468341782,144.45042547841217,0.7549869676462851,0.7556315885045827,-264
343,2017-12-10,2017,200926,200926,299075196.4000001,2988255.883333334,152223,0,128,0.818818868638204,26230899,2954006826,201171,201171,431505,632676,269152048.7000023,2984613.0666665863,152510,0,127,0.2613391372519307,2780408595,-245,-245,29923147.699997783,3642.8166667474434,-287,0,1,0.5574797313862733,-2754177696,1488.4842996924247,1337.9266827723793,150.55761692004535,0.7576072783014642,0.7581112585810083,-287
344,2017-12-11,2017,200697,200697,299177555.0500001,2977017.683333337,154099,0,154,0.828133953173191,26076684,2956390199,201088,201088,447235,648323,269394919.5333382,2974264.4333332703,154371,0,151,0.25738405085120364,2787482247,-391,-391,29782635.516661882,2753.2500000665896,-272,0,3,0.5707499023219874,-2761405563,1490.692711151637,1339.6867020077686,151.00600914386837,0.7678191502613392,0.76767882718014,-272
345,2017-12-12,2017,205013,205013,299217333.88333315,3016092.283333333,155697,0,103,0.8166213849853426,25774524,2958484917,205571,205571,457102,662673,269496119.5166698,3013588.183333025,155971,0,103,0.2537812767382934,2786558383,-558,-558,29721214.366663337,2504.100000308361,-274,0,0,0.5628401082470492,-2760783859,1459.5041967257353,1310.9637036190406,148.5404931066946,0.7594494007697072,0.7587208312456524,-274
346,2017-12-13,2017,202494,202494,299520316.98333293,2994164.4333333364,152847,0,127,0.8091103933943721,26041469,2961721366,203266,203266,469963,673229,269972669.95001006,2990625.949999933,153146,0,127,0.2447889202633874,2789582260,-772,-772,29547647.03332287,3538.4833334032446,-299,0,0,0.5643214731309847,-2763540791,1479.156503320261,1328.1742640186262,150.98223930163476,0.7548223651071143,0.7534265445278601,-299
347,2017-12-14,2017,203293,203293,299558465.1833337,3000025.916666666,154120,0,137,0.8132055702852533,26336465,2962180836,204068,204068,486111,690179,270121887.683346,2997568.0666666236,154480,0,137,0.24088243774441143,2795958737,-775,-775,29436577.49998772,2457.8500000424683,-360,0,0,0.5723231325408419,-2769622272,1473.5306438654243,1323.685671851275,149.84497201414933,0.7581175938177901,0.7570025677715272,-360
348,2017-12-15,2017,207118,207118,299678528.0333325,3003423.0666666655,158698,0,87,0.8262294923666709,26720990,2964438944,208298,208298,499170,707468,270347105.2166785,3000625.4166666074,159166,0,87,0.24353044943375723,2801719422,-1180,-1180,29331422.816654027,2797.6500000581145,-468,0,0,0.5826990429329136,-2774998432,1446.897556143515,1297.8862265440787,149.0113295994363,0.7662202222887436,0.7641263958367339,-468
349,2017-12-16,2017,193909,193909,299313431.3833326,2916707.15,146405,0,80,0.8098283215322638,26429075,2964701038,194330,194330,516984,711314,270122620.9000019,2913145.0166666247,146661,0,80,0.22156178565303036,2803561711,-421,-421,29190810.483330727,3562.133333375212,-256,0,0,0.5882665358792334,-2777132636,1543.5767879950524,1390.0201765038948,153.55661149115758,0.7550191069006595,0.7547007667369938,-256
350,2017-12-17,2017,192904,192904,299280190.8666665,2902500.2333333297,145874,0,92,0.8089256832414036,26267062,2966556916,193160,193160,533017,726177,270203902.9833403,2899516.6833332554,146148,0,92,0.2159225643334933,2810226830,-256,-256,29076287.883326173,2983.5500000743195,-274,0,0,0.5930031189079102,-2783959768,1551.4462679191022,1398.8605455753795,152.58572234372264,0.7561999751171568,0.7566162766618347,-274
351,2017-12-18,2017,196647,196647,299697086.6333333,2969556.4499999997,149697,0,103,0.8161121196865447,26311104,2972048519,196923,196923,543741,740664,270712790.03333014,2965861.6500000227,149915,0,103,0.2174521780456479,2815279381,-276,-276,28984296.600003183,3694.7999999769963,-218,0,0,0.5986599416408969,-2788968277,1524.0358949454267,1374.7139238856312,149.3219710597955,0.7612473111717951,0.7612874067528933,-218
352,2017-12-19,2017,197637,197637,299930263.69999987,2975822.5333333323,150129,0,122,0.8119380480375638,25704276,2974570544,197886,197886,552758,750644,271071729.6833351,2972258.966666264,150353,0,122,0.21446517923276912,2815415846,-249,-249,28858534.016664743,3563.566667068284,-224,0,0,0.5974728688047947,-2789711570,1517.5815444476484,1369.837834325496,147.74371012215238,0.7596199092275232,0.7597960441870572,-224
353,2017-12-20,2017,202952,202952,300158798.8166662,3016008.799999997,154848,0,114,0.8171735188616032,25563572,2975586678,203577,203577,564291,767868,271436963.5333268,3013493.2333333627,155131,0,114,0.21695265332061817,2817415901,-625,-625,28721835.28333938,2515.5666666342877,-283,0,0,0.600220865540985,-2791852329,1478.9644783824067,1333.338066349965,145.62641203244175,0.7629784382514092,0.7620261620910024,-283
354,2017-12-21,2017,206915,206915,300665074.2666665,3078000.250000002,158407,0,105,0.8227146412778176,26033366,2979344231,207544,207544,575415,782959,272015700.48332715,3075557.4000000264,158711,0,105,0.218344766456481,2820623598,-629,-629,28649373.78333932,2442.849999975413,-304,0,0,0.6043698748213366,-2794590232,1453.0849588800545,1310.641119393127,142.44383948692757,0.7655655704033058,0.76471013375477,-304
355,2017-12-22,2017,206626,206626,301154775.40000004,3086921.4499999997,157873,0,102,0.8229070881689625,25637126,2982464923,206951,206951,587910,794861,272598796.2999954,3082766.016666682,158192,0,102,0.21511308266476803,2824818059,-325,-325,28555979.100004613,4155.433333317749,-319,0,0,0.6077940055041945,-2799180933,1457.4873220214301,1317.2142019125079,140.27312010892228,0.7640519586112106,0.7643935037762563,-319
356,2017-12-23,2017,208068,208068,301228539.6999998,3068562.166666661,157696,0,129,0.8196695311148281,25488737,2982334687,208432,208432,600341,808773,272799585.8166624,3066386.5999999996,158069,0,129,0.21196553297402326,2832413509,-364,-364,28428953.883337438,2175.566666661296,-373,0,0,0.6077039981408048,-2806924772,1447.7408332852713,1308.8181556414677,138.92267764380358,0.7579060691696945,0.758372035004222,-373
357,2017-12-24,2017,197011,197011,300904876.93333375,2974997.983333331,149135,0,65,0.8178274309556315,25164083,2979737793,197160,197160,617282,814442,272606823.29999536,2971287.6166666565,149380,0,65,0.19875694033460892,2839195557,-149,-149,28298053.63333839,3710.366666674614,-245,0,0,0.6190704906210226,-2814031474,1527.3506399811877,1382.6680021302261,144.68263785096156,0.7569881884767855,0.7576587543112193,-245
358,2017-12-25,2017,193273,193273,300656500.5166664,2941361.7166666654,146791,0,113,0.8185313002850898,25482237,2978191927,193517,193517,635741,829258,272437929.69999814,2938062.0166666927,147090,0,113,0.19183052801420317,2846164172,-244,-244,28218570.816668272,3299.6999999727122,-299,0,0,0.6267007722708866,-2820681935,1555.6052863910966,1407.8242722861462,147.78101410495037,0.759500809735452,0.7600882609796555,-299
359,2017-12-26,2017,197750,197750,300975893.8500003,2967346.849999999,150909,0,309,0.823307206068268,26379612,2981661476,198156,198156,646038,844194,272832648.4499952,2963819.3666667314,151268,0,309,0.19397792450550674,2851238332,-406,-406,28143245.400005102,3527.483333267737,-359,0,0,0.6293292815627612,-2824858720,1522.0019916561332,1376.8578718282324,145.1441198279008,0.7631302149178255,0.7633783483719897,-359
360,2017-12-27,2017,200142,200142,301423864.9166664,3002434.283333332,152792,0,328,0.823190534720349,26975447,2986660795,201117,201117,654976,856093,273386289.0833286,2998779.36666663,153237,0,328,0.19392869699904475,2850741762,-975,-975,28037575.833337784,3654.9166667019017,-445,0,0,0.6292618377213042,-2823766315,1506.0500290626974,1359.3395341185908,146.71049494410659,0.7634179732390003,0.7619296230552365,-445
361,2017-12-28,2017,202940,202940,302039007.68333316,3047146.0833333298,154156,0,93,0.816275746526067,27071043,2993308046,203422,203422,664429,867851,274100680.54999995,3042650.266666326,154526,0,87,0.19200185285262225,2853751388,-482,-482,27938327.133333206,4495.816667003557,-370,0,6,0.6242738936734448,-2826680345,1488.3167817253038,1347.4485579239215,140.86822380138233,0.7596136789198777,0.7596326847636932,-370
362,2017-12-29,2017,205599,205599,302677757.9499998,3029951.4166666623,156010,0,113,0.8127763267331072,27189957,2999414209,205895,205895,676168,882063,274786909.51666915,3026377.883332888,156326,0,113,0.1905158701816085,2858949964,-296,-296,27890848.433330655,3573.5333337741904,-316,0,0,0.6222604565514986,-2831760007,1472.175243799823,1334.5972923901463,137.57795140967664,0.7588071926419876,0.7592510745768474,-316
363,2017-12-30,2017,198551,198551,303128376.6833333,2973024.483333334,150856,0,89,0.8125116468816562,26904707,3005282451,198811,198811,691649,890460,275292414.2166674,2969630.149999553,151115,0,89,0.18205871122791026,2866956000,-260,-260,27835962.466665864,3394.333333780989,-259,0,0,0.6304529356537459,-2840051293,1526.7028455325496,1384.6940773733215,142.0087681592281,0.7597846397147332,0.7600937573876697,-259
364,2017-12-31,2017,193155,193155,303220611.8666665,2933067.766666666,146647,0,104,0.8124200771401213,27639579,3008951319,193936,193935,708165,902101,275503645.9166643,2930144.850000024,147008,0,103,0.17500811993335422,2878053353,-781,-780,27716965.950002193,2922.916666642297,-361,0,1,0.6374119572067671,-2850413774,1569.8305084862752,1420.5978596780587,149.23264880821648,0.7592192798529678,0.7580232654071446,-361
365,2018-01-01,2018,194471,194471,303474488.7333332,2939072.783333334,146530,0,129,0.8019190521980146,27761805,3014635440,194517,194517,287849,482366,275832610.6833452,2935570.2166666053,146786,0,125,0.32459999253678073,2857334440,-46,-46,27641878.04998797,3502.566666728817,-256,0,4,0.4773190596612339,-2829572635,1560.5128205919298,1418.0385811180781,142.47423947385164,0.7534799533092338,0.7546178483114586,-256
366,2018-01-02,2018,202124,202124,303942653.9999996,2990570.6833333266,153192,0,150,0.8112891096554589,28648183,3022277227,202347,202347,301717,504064,276356295.6166748,2986621.7666665916,153521,0,150,0.3266053517013701,2865392274,-223,-223,27586358.383324802,3948.9166667349637,-329,0,0,0.48468375795408875,-2836744091,1503.7435138825651,1365.7543507770058,137.98916310555933,0.7579109853357345,0.7587016362980424,-329
367,2018-01-03,2018,199100,199100,304297732.95000005,2979455.116666671,150009,0,109,0.8100803616273226,27772287,3027857744,199270,199270,312689,511959,276761456.2999978,2975609.116666466,150253,0,109,0.3165155803492015,2865459169,-170,-170,27536276.65000224,3846.000000204891,-244,0,0,0.49356478127812103,-2837686882,1528.3663131592168,1388.8766813870518,139.489631772165,0.7534354595680562,0.7540171626436494,-244
368,2018-01-04,2018,196538,196538,304531621.04999936,2958989.1166666644,136316,0,120,0.7384373505378091,27778058,3032756854,196482,196482,329358,525840,277067244.86666495,2955165.449999841,136500,0,121,0.27696827932450746,2871891393,56,56,27464376.18333441,3823.6666668234393,-184,0,-1,0.46146907121330166,-2844113335,1549.4795970753714,1410.1405974423353,139.3389996330361,0.6935859731960231,0.6947201270345376,-184
369,2018-01-05,2018,199260,199260,305048122.5500001,2958627.766666666,149959,0,118,0.8035531466425777,27913476,3040136686,199667,199667,344700,544367,277648865.2000098,2955654.233333172,150250,0,118,0.2953173135035782,2877793962,-407,-407,27399257.34999025,2973.533333494328,-291,0,0,0.5082358331389996,-2849880486,1530.904961106093,1390.5596077469477,140.3453533591453,0.7525795443139617,0.7525029173574,-291
370,2018-01-06,2018,194946,194946,305355360.85,2945711.366666665,147378,0,116,0.8071055574364184,28569039,3047118261,195528,195528,361957,557485,278023647.6500063,2942723.7166666016,147771,0,116,0.2843574266572195,2886347566,-582,-582,27331713.19999373,2987.650000063237,-393,0,0,0.5227481307791989,-2857778527,1566.3586883034277,1421.9121949286357,144.446493374792,0.7559939675602475,0.7557536516509145,-393
371,2018-01-07,2018,198763,198763,305659019.8666668,2969948.0500000007,150348,0,65,0.8133606355307571,27918778,3051799657,199131,199131,376375,575506,278476897.38334227,2966420.2333332626,150732,0,64,0.2827546541652117,2895398293,-368,-368,27182122.483324528,3527.81666673813,-384,0,1,0.5306059813655454,-2867479515,1537.8064321159713,1398.4607990887519,139.3456330272195,0.7564184481015078,0.7569489431580216,-384
372,2018-01-08,2018,195876,195876,306112143.8833337,2946329.9499999997,146585,0,152,0.8002818109416149,27822588,3058450858,196192,196192,390804,586996,278995025.8500079,2942447.733333232,146874,0,152,0.268483941968938,2903439641,-316,-316,27117118.03332579,3882.2166667678393,-289,0,0,0.5317978689726769,-2875617053,1562.7853534038559,1422.0509799074778,140.7343734963781,0.7483561028405726,0.7486237970967216,-289
373,2018-01-09,2018,190534,190534,306059807.6500002,2912508.3499999954,142493,0,92,0.7988600459760465,25932442,3060353341,190859,190859,407635,598494,279064359.4833397,2909597.2999999225,142686,0,90,0.2554110818153536,2906797474,-325,-325,26995448.166660488,2911.0500000729226,-193,0,2,0.543448964160693,-2880865032,1606.3264700788322,1462.1493326662076,144.1771374126247,0.7478612741033096,0.7475990128838567,-193
374,2018-01-10,2018,194922,194922,306403243.38333285,2944602.066666666,145852,0,91,0.7977190876350548,26494173,3064515576,195106,195106,421100,616206,279465281.9000105,2941458.9333332605,146032,0,91,0.25313612655507933,2910979673,-184,-184,26937961.483322322,3143.13333340548,-180,0,0,0.5445829610799755,-2884485500,1571.9274549990912,1432.3766665300427,139.55078846904848,0.7482582776700424,0.7484751878466065,-180
375,2018-01-11,2018,200604,200604,306770002.26666623,2956767.0499999984,151340,0,112,0.8069878965524112,27315488,3069793168,200951,200951,434605,635556,279915899.31667644,2953131.383333262,151643,0,112,0.2559664293941048,2917053458,-347,-347,26854102.949989796,3635.6666667363606,-303,0,0,0.5510214671583065,-2889737970,1529.2317315041885,1392.9559908469053,136.27574065728322,0.7544216466271859,0.7546267498046787,-303
376,2018-01-12,2018,201395,201395,306914621.79999954,2936437.8833333333,151238,0,87,0.8020705578589341,27299248,3073097434,201859,201859,447977,649836,280254461.1833444,2932737.2166665304,151590,0,87,0.24984611501979131,2922746988,-464,-464,26660160.61665511,3700.66666680295,-352,0,0,0.5522244428391427,-2895447740,1523.943602373443,1388.367430648841,135.57617172460186,0.7509521090394499,0.7509697363010814,-352
377,2018-01-13,2018,195502,195502,306840379.83333343,2922769.783333333,146010,0,96,0.7944829208908343,25311592,3072436207,195665,195665,466423,662088,280292594.0666764,2919395.1166665563,146229,0,93,0.2354369811867916,2927038128,-163,-163,26547785.766657054,3374.666666776873,-219,0,3,0.5590459397040427,-2901726536,1569.4999531121596,1432.5126827315892,136.9872703805704,0.7468465795746335,0.7473436741369177,-219
378,2018-01-14,2018,192016,192016,306676741.3499999,2733454.6333333314,144288,0,117,0.7958972168985922,23011270,3069905244,192848,192848,481507,674355,280212068.966676,2731387.666666628,144597,0,114,0.2274855232036521,2929163709,-832,-832,26464672.383323908,2066.966666703578,-309,0,3,0.56841169369494,-2906152439,1597.1415993979663,1453.0203526439268,144.12124675403948,0.7514373802183152,0.749797768190492,-309
379,2018-01-15,2018,202802,202802,307478480.3000002,3021094.100000001,153047,0,107,0.8063184781215176,26956043,3076376568,203080,203080,496003,699083,281045185.0833421,3017693.7666666303,153286,0,107,0.23485766353923218,2935979022,-278,-278,26433295.216658115,3400.3333333707415,-239,0,0,0.5714608145822854,-2909022979,1516.1511242492686,1383.9136551277431,132.23746912152546,0.7546621828187099,0.7548059877880638,-239
380,2018-01-16,2018,205053,205053,307867249.31666595,3039122.0666666618,153531,0,98,0.8018365983428682,27048223,3078738703,205385,205385,501287,706672,281480794.0833438,3035294.466666515,153830,0,98,0.2337166323273014,2933396868,-332,-332,26386455.233322144,3827.6000001467764,-299,0,0,0.5681199660155669,-2906348645,1501.403292400823,1370.5031724972312,130.90011990359176,0.7487381311173209,0.7489836161355503,-299
381,2018-01-17,2018,201667,201667,308185729.6166668,2978274.2833333355,151641,0,114,0.8044895793560667,28066622,3083524724,202083,202083,517008,719091,281876070.2500084,2974386.4166665655,151975,0,114,0.22665837842499134,2939552402,-416,-416,26309659.36665839,3887.8666667700745,-334,0,0,0.5778312009310753,-2911485780,1528.1911746426872,1394.8529576956419,133.33821694704534,0.7519376001031404,0.7520424775958393,-334
382,2018-01-18,2018,199011,199011,308608178.0333333,2965974.050000001,149400,0,144,0.8012923908728659,26706874,3088580680,199283,199283,533733,733016,282397575.566677,2962312.266666538,149681,0,144,0.21850000545691226,2944319233,-272,-272,26210602.466656327,3661.7833334631287,-281,0,0,0.5827923854159536,-2917612359,1550.7091468980775,1417.068066853053,133.6410800450244,0.7507122721859596,0.7510976852014472,-281
383,2018-01-19,2018,200488,200488,308709170.0500002,2972965.716666665,151726,0,171,0.8103876541239386,27455938,3091470645,200845,200845,548177,749022,282624280.5000079,2969547.2333329413,152066,0,171,0.21823257527815806,2952599342,-357,-357,26084889.549992263,3418.4833337236196,-340,0,0,0.5921550788457806,-2925143404,1539.788765661786,1407.1760835470534,132.6126821147327,0.7567834483859384,0.757131121013717,-340
384,2018-01-20,2018,198007,198007,308779114.1500004,2964995.300000002,150114,0,208,0.8135974990783156,26788997,3093064097,198310,198310,562743,761053,282863117.58333063,2961291.316666688,150448,0,208,0.212818292549931,2958029476,-303,-303,25915996.566669762,3703.9833333143033,-334,0,0,0.6007792065283846,-2931240479,1559.4353439524884,1426.3684009042945,133.06694304819393,0.7581247127626801,0.7586505975492915,-334
385,2018-01-21,2018,198690,198690,308852474.14999986,2979423.333333337,150184,0,171,0.8124817554985143,28073974,3097141556,198900,198900,576135,775035,282991002.3999986,2975831.1333332965,150411,0,171,0.20916861819143676,2966705032,-210,-210,25861471.75000125,3592.200000040699,-227,0,0,0.6033131373070776,-2938631058,1554.4439788112127,1422.780303670179,131.66367514103376,0.7558709547536363,0.7562141779788839,-227
386,2018-01-22,2018,200114,200114,309309557.10000014,3003089.8499999954,153259,0,187,0.8178338347142126,28249378,3104956286,200460,200460,588613,789073,283545099.4166627,2999124.8000000287,153526,0,187,0.20836855398676613,2974165250,-346,-346,25764457.68333745,3965.049999966752,-267,0,0,0.6094652807274464,-2945915872,1545.6667554493945,1414.472210998018,131.1945444513765,0.7658584606774139,0.765868502444378,-267
387,2018-01-23,2018,186878,186878,309122049.95000005,2831827.0333333304,145910,0,167,0.8295251447468406,24200537,3103759507,187298,187298,603627,790925,283416133.5999969,2828114.633333371,146082,0,167,0.19659891898726264,2970553071,-420,-420,25705916.350003123,3712.3999999593943,-172,0,0,0.6329262257595779,-2946352534,1654.1382610580167,1513.1829149269984,140.95534613101836,0.7807767634499513,0.7799442599493854,-172
388,2018-01-24,2018,192644,192644,309771968.83333355,2969015.383333333,147735,0,207,0.8173418326031442,28916408,3113147326,192862,192862,610552,803414,284100679.89999616,2965340.883333323,147956,0,207,0.19665701618343917,2978799627,-218,-218,25671288.93333739,3674.500000009779,-221,0,0,0.620684816419705,-2949883219,1608.0021637493696,1473.0775367879426,134.92462696142707,0.7668808787192957,0.7671599381941492,-221
389,2018-01-25,2018,188302,188302,310048037.16666704,2935978.9333333345,144664,0,203,0.817405019596182,27575964,3117933875,188618,188618,624896,813514,284500583.09999996,2932065.2999996967,144879,0,203,0.1898307834899006,2986624313,-316,-316,25547454.06666708,3913.6333336378448,-215,0,0,0.6275742361062814,-2959048349,1646.5467024602344,1508.342698469923,138.20400399031132,0.7682552495459422,0.7681080278658452,-215
390,2018-01-26,2018,190252,190252,310187094.2333331,2924842.916666668,145691,0,179,0.8146984000168206,28107686,3121888185,190873,190873,638161,829034,284690021.2999969,2921057.266666694,146038,0,179,0.18783065592002224,2996103143,-621,-621,25497072.9333362,3785.64999997383,-347,0,0,0.6268677440967984,-2967995457,1630.4012269691416,1491.515412342222,138.88581462691968,0.765779071967706,0.7651055937717749,-347
391,2018-01-27,2018,186121,186121,310241540.2833333,2913894.849999998,142982,0,179,0.8156790475013556,28799135,3125646046,186686,186686,651467,838153,284852740.36666757,2910995.5166663732,143270,0,179,0.18180690160388294,3003259221,-565,-565,25388799.916665733,2899.3333336249925,-288,0,0,0.6338721458974726,-2974460086,1666.8809015819456,1525.8387900896028,141.04211149234288,0.7682206736477882,0.7674383724542815,-288
392,2018-01-28,2018,182216,182216,310388258.6166669,2861467.5000000005,139012,0,133,0.8112295297888209,28258099,3131075871,182557,182557,664263,846820,285081029.31666285,2858335.5666666934,139281,0,133,0.17523912992135496,3010641585,-341,-341,25307229.300004065,3131.933333307039,-269,0,0,0.635990399867466,-2982383486,1703.4083648892902,1561.6000992383904,141.80826565089978,0.7628967818413311,0.7629452718876844,-269
393,2018-01-29,2018,184836,184836,311017520.31666654,2898478.2166666673,142278,0,161,0.8192559890930344,27597407,3139927030,185100,185100,677276,862376,285754868.91666555,2894976.4166666605,142487,0,161,0.17618185107192277,3020243917,-264,-264,25262651.40000099,3501.8000000067987,-209,0,0,0.6430741380211117,-2992646510,1682.667447448909,1543.7864339095925,138.88101353931643,0.7697526455885217,0.7697839005942734,-209
394,2018-01-30,2018,188285,188285,311535790.6833335,2928242.0999999978,143616,0,160,0.8125766789707095,28720726,3147236848,188628,188628,683101,871729,286367810.3666742,2924439.149999596,143878,0,160,0.17632199915340097,3022805036,-343,-343,25167980.31665933,3802.9500004015863,-262,0,0,0.6362546798173085,-2994084310,1654.5969709925566,1518.161727668608,136.43524332394873,0.7627585840613963,0.762760565769663,-262
395,2018-01-31,2018,188447,188447,312102330.6166669,2919269.533333337,143014,0,68,0.808795045821903,28258286,3155179036,188915,188915,694785,883700,286939215.9333369,2915991.149999613,143302,0,68,0.17313341631775891,3028996304,-468,-468,25163114.68333,3278.383333723992,-288,0,0,0.6356616295041441,-3000738018,1656.1809453940202,1518.8800038818354,137.30094151218486,0.7589083402760458,0.7585527882910303,-288
396,2018-02-01,2018,187941,187941,312537117.24999976,2909633.2166666673,144284,0,156,0.8165807354435696,27694657,3161098483,189195,189195,249092,438287,287440813.4500001,2907654.566666468,144681,0,156,0.3517740658518227,3007406598,-1254,-1254,25096303.799999654,1978.65000019921,-397,0,0,0.4648066695917469,-2979711941,1662.9533590328867,1519.2833502471,143.67000878578665,0.767709015063238,0.7647189407753905,-397
397,2018-02-02,2018,188095,188095,312723607.5166666,2881031.1833333382,142817,0,181,0.8084797575693136,27839877,3166136977,188324,188324,263110,451434,287690904.7166716,2877055.31666663,143048,0,181,0.3379541638423367,3015544427,-229,-229,25032702.799995005,3975.8666667081416,-231,0,0,0.4705255937269769,-2987704550,1662.5833090548213,1527.638031884792,134.94527717002916,0.759281214280018,0.7595845457827999,-231
398,2018-02-03,2018,173167,173167,311832183.5666662,2689807.3333333354,134276,0,146,0.8195037160659939,23666921,3160794434,173310,173310,283795,457105,286887670.5000073,2686665.149999993,134389,0,146,0.3109810656194919,3019442853,-143,-143,24944513.066658914,3142.1833333424293,-113,0,0,0.508522650446502,-2995775932,1800.759865139814,1655.3440107322558,145.4158544075583,0.7754133293294911,0.7754255380531995,-113
399,2018-02-04,2018,172624,172624,311744775.1500003,2678918.933333335,134030,0,160,0.8224117156362961,23481388,3160299850,172999,172999,295046,468045,286856349.9500018,2675161.0999999754,134217,0,160,0.304075462829427,3023618065,-375,-375,24888425.199998498,3757.8333333595656,-187,0,0,0.5183362528068691,-3000136677,1805.917920741034,1658.138775079635,147.77914566139907,0.7764273797386226,0.7758252937878254,-187
400,2018-02-05,2018,186188,186188,312551860.81666654,2886538.5333333327,143877,0,191,0.8246879498141659,27997790,3169520572,186807,186807,301599,488406,287727365.94999945,2883896.6999997604,144143,0,191,0.3154834297694954,3031209311,-619,-619,24824494.86666709,2641.833333572373,-266,0,0,0.5092045200446705,-3003211521,1678.6896084423622,1540.2386738719613,138.45093457040093,0.7727511977141384,0.7716145540584668,-266
401,2018-02-06,2018,188802,188802,312326936.1666664,2903059.5166666685,144465,0,178,0.8145146767513056,28369038,3169649996,189578,189578,310563,500141,287626653.9333336,2900475.983333136,144664,0,178,0.3082870630482186,3035066493,-776,-776,24700282.233332813,2583.533333532512,-199,0,0,0.506227613703087,-3006697455,1654.2565024028686,1517.194262695743,137.06223970712563,0.7651666825563288,0.763084324130437,-199
402,2018-02-07,2018,188204,188204,312626702.4166666,2915972.2499999963,145005,0,123,0.8238454017980485,28508446,3174351304,188563,188563,323217,511780,287960523.1833352,2912430.4166664397,145250,0,123,0.3040701082496447,3040341290,-359,-359,24666179.233331442,3541.8333335565403,-245,0,0,0.5197752935484039,-3011832844,1661.1055153804734,1527.1316386742637,133.9738767062097,0.7704671526641305,0.7702995815722067,-245
403,2018-02-08,2018,186143,186143,312777484.58333313,2881874.499999996,142879,0,148,0.8238773416137062,27789508,3177593595,186476,186476,337046,523522,288159976.2500073,2879019.3666664464,143116,0,148,0.29387685713302986,3046285490,-333,-333,24617508.333325863,2855.133333549369,-237,0,0,0.5300004844806763,-3018495982,1680.3075301425954,1545.292564458736,135.01496568385937,0.7675765406166227,0.7674767798537078,-237
404,2018-02-09,2018,185114,185114,312794282.0500003,2836980.133333333,141749,0,63,0.8173395853366034,28588976,3181613913,185569,185569,351302,536871,288310751.1166743,2834751.816666537,142029,0,63,0.2829785926228116,3057851640,-455,-455,24483530.933326006,2228.316666795872,-280,0,0,0.5343609927137918,-3029262664,1689.7386586103714,1553.657944574117,136.08071403625445,0.7657389500524001,0.7653702935296305,-280
405,2018-02-10,2018,171676,171676,311511492.2833339,2713823.13333333,132411,0,54,0.8197593140567113,27508205,3171686908,172009,172009,370344,542353,287349160.2333381,2711880.5499998988,132698,0,54,0.26046320385431887,3056028389,-333,-333,24162332.04999578,1942.5833334312774,-287,0,0,0.5592961102023924,-3028520184,1814.5313980016654,1670.5472401638176,143.98415783784776,0.771284279689648,0.7714596329261841,-287
406,2018-02-11,2018,165775,165775,311137575.7666662,2643789.066666665,125596,0,62,0.8036977831397992,27714188,3173888109,166331,166331,386061,552392,287013799.0666749,2642360.266666596,125856,0,62,0.24195317817781958,3065513238,-556,-556,24123776.699991286,1428.8000000691973,-260,0,0,0.5617446049619796,-3037799050,1876.8666913989816,1725.5580683497055,151.3086230492761,0.7576293168451214,0.7566599130649128,-260
407,2018-02-12,2018,169808,169808,311116988.0500003,2710526.1500000036,129906,0,69,0.8136895788184302,28045849,3177343381,170255,170255,397936,568191,286797819.86667454,2707244.083333286,130134,0,69,0.24383173967908767,3070345590,-447,-447,24319168.183325768,3282.066666717641,-228,0,0,0.5698578391393425,-3042299741,1832.1692031588636,1684.5192203851548,147.64998277370887,0.7650169603316687,0.7643475962526798,-228
408,2018-02-13,2018,169455,169455,310937383.05000037,2692274.283333334,128081,0,66,0.8038712342509813,28635701,3179810915,170245,170245,406607,576852,286728653.2666722,2689570.1999999313,128438,0,66,0.2372653644262316,3076307617,-790,-790,24208729.783328176,2704.083333402872,-357,0,0,0.5666058698247497,-3047671916,1834.9259865451027,1684.2118903149708,150.71409623013187,0.755840783688885,0.7544303797468355,-357
409,2018-02-14,2018,163656,163656,310411759.59999996,2623014.199999997,121657,0,67,0.7807779733098699,26810946,3177577233,164281,164281,421700,585981,286280950.91667193,2621921.899999934,122147,0,67,0.2194849321053069,3083676731,-625,-625,24130808.683328032,1092.3000000631437,-490,0,0,0.5612930412045629,-3056865785,1896.733145133695,1742.6297071278598,154.1034380058352,0.7433702400156426,0.7435248141903202,-490
410,2018-02-15,2018,158353,158353,309860522.6666664,2550243.8166666683,117186,0,57,0.7761583298074557,26401609,3176279184,166163,166163,437588,603751,285881893.1000005,2557660.83333316,118401,0,58,0.20593589078941504,3091273129,-7810,-7810,23978629.566665888,-7417.016666491516,-1215,0,-1,0.5702224390180406,-3064871520,1956.7707758404729,1720.4906814393125,236.28009440116034,0.7400301857242995,0.7125593543689028,-1215
411,2018-02-16,2018,155742,155742,309726313.86666626,2546412.8000000007,117587,0,84,0.7914884873701383,26232432,3179008824,157030,157030,459270,616300,285620330.5666734,2545141.999999985,117985,0,84,0.2010968684082411,3095199504,-1288,-1288,24105983.29999286,1270.8000000156462,-398,0,0,0.5903916189618972,-3068967072,1988.7141160808662,1818.8902156700847,169.82390041078156,0.7550114933672356,0.7513532446029421,-398
412,2018-02-17,2018,156015,156015,309870208.8166665,2552152.066666664,117022,0,51,0.7857577797006698,25916952,3183264383,156639,156639,464832,621471,285785232.7500014,2549796.399999868,117321,0,51,0.19817497517985505,3101053822,-624,-624,24084976.066665113,2355.6666667959653,-299,0,0,0.5875828045208148,-3075136870,1986.1565158264684,1824.483256085658,161.6732597408104,0.7500689036310612,0.7489897152050256,-299
413,2018-02-18,2018,162004,162004,310137617.0499994,2603401.0833333367,123081,0,91,0.8090787881780699,29092352,3190745226,162603,162603,472335,634938,286128131.1000073,2605240.7666665902,123441,0,91,0.20750214981620044,3112152717,-599,-599,24009485.94999212,-1839.683333253488,-360,0,0,0.6015766383618695,-3083060365,1914.3824661736712,1759.673137027037,154.70932914663422,0.7597405002345621,0.7591557351340381,-360
414,2018-02-19,2018,168325,168325,310744866.55000037,2673334.283333333,128821,0,86,0.818701915936434,28689739,3200337779,173937,173937,480621,654558,286803911.9333395,2675595.633333271,130616,0,86,0.21371215385038883,3122561121,-5612,-5612,23940954.616660893,-2261.3499999376945,-1795,0,0,0.6049897620860452,-3093871382,1846.1004993316524,1648.8953582810989,197.2051410505535,0.7653111540175256,0.7509385582136061,-1795
415,2018-02-20,2018,167236,167236,311033303.0,2666213.85,128610,0,59,0.8188787103255277,28352024,3206293787,167855,167855,490499,658354,283824872.0666735,2664780.1999999434,128889,0,59,0.20889065760973533,3074754672,-619,-619,27208430.933326483,1433.6500000567175,-279,0,0,0.6099880527157924,-3046402648,1859.8465820756296,1690.8931641397248,168.95341793590478,0.7690329833289483,0.7678591641595425,-279
416,2018-02-21,2018,170908,170908,311342281.1499998,2701552.7833333286,131903,0,88,0.8187679921361208,29425589,3213412054,171462,171462,499138,670600,284258735.86667484,2699532.799999899,132167,0,88,0.2095586042350185,3080107010,-554,-554,27083545.283324957,2019.9833334293216,-264,0,0,0.6092093879011024,-3050681421,1821.6951877618355,1657.8526779500696,163.84250981176592,0.771777798581693,0.7708238560147438,-264
417,2018-02-22,2018,174924,174924,311879587.20000046,2756436.2333333315,135078,0,69,0.8228144794310676,29447265,3221618952,175614,175614,508516,684130,284891935.6833431,2754206.0333332242,135348,0,69,0.2112727113267937,3085241500,-690,-690,26987651.516657352,2230.2000001072884,-270,0,0,0.6115417681042739,-3055794235,1782.9433765521053,1622.262095751723,160.68128080038218,0.7722096453316869,0.7707130411015067,-270
418,2018-02-23,2018,185289,185289,312503013.39999974,2827504.3833333314,141860,0,103,0.8197680380378752,29981331,3230171846,185923,185923,516851,702774,285576742.10000646,2825424.9166665934,142176,0,103,0.21702567254907157,3087564394,-634,-634,26926271.299993277,2079.466666738037,-316,0,0,0.6027423654888037,-3057583063,1686.5707807802933,1535.994697267183,150.57608351311023,0.7656147963451689,0.7647036676473594,-316
419,2018-02-24,2018,180234,180234,312759928.2833331,2822614.666666665,139367,0,91,0.8281456328994531,29285001,3236682351,180875,180875,528271,709146,285858095.46667403,2821889.5999999773,139791,0,91,0.21176598330950247,3087324348,-641,-641,26901832.816659093,725.0666666878387,-424,0,0,0.6163796495899506,-3058039347,1735.299268081123,1580.417943146781,154.88132493434205,0.7732558784691013,0.7728597097442985,-424
420,2018-02-25,2018,180344,180344,312868761.45,2810515.3666666686,138747,0,99,0.8249456594064678,29459043,3241925660,180868,180868,539873,720741,286043338.3000084,2809489.8499999065,139091,0,99,0.20758080919498034,3097186462,-524,-524,26825423.149991572,1025.5166667620651,-344,0,0,0.6173648502114875,-3067727419,1734.844305604844,1581.5032968795388,153.3410087253053,0.769346360289225,0.7690193953601522,-344
421,2018-02-26,2018,187308,187308,313483024.66666675,2875681.666666671,143922,0,82,0.8283575714865349,29341429,3249876230,187825,187825,550104,737929,286750555.9500071,2874280.0499999104,144309,0,82,0.21142819973195423,3105831751,-517,-517,26732468.716659665,1401.6166667607613,-387,0,0,0.6169293717545806,-3076490322,1673.623255102114,1526.6900356715405,146.93321943057344,0.7683708117111923,0.7683162518301611,-387
422,2018-02-27,2018,191821,191821,313977251.31666654,2930586.9000000004,147968,0,117,0.8322029391985237,30182636,3257264074,192624,192624,556735,749359,287406935.6833306,2929889.2333333446,148417,0,117,0.2143698814586848,3107958509,-803,-803,26570315.633335948,697.6666666558012,-449,0,0,0.617833057739839,-3077775873,1636.8241814851688,1492.0619221038428,144.76225938132598,0.7713858232414594,0.7705010798239056,-449
423,2018-02-28,2018,188603,188603,314195236.5666666,2913841.016666669,145848,0,108,0.8316251597270448,29769931,3262728690,189549,189549,568828,758377,287858470.7333341,2915730.266666328,146244,0,109,0.2080363724110756,3115276749,-946,-946,26336765.83333248,-1889.249999659136,-396,0,-1,0.6235887873159691,-3085506818,1665.9079472047983,1518.6493768541861,147.25857035061222,0.7733068933155889,0.7715366475159458,-396
424,2018-03-01,2018,189396,189396,314481731.14999974,2908749.8333333363,145815,0,95,0.8265855667490336,30161105,3268705440,190944,190944,250677,441621,288302969.36666775,2909046.099999844,146413,0,95,0.35724523969648414,3097990425,-1548,-1548,26178761.78333199,-296.2666665078141,-598,0,0,0.46934032705254947,-3067829320,1660.4454748252326,1509.8823182015028,150.5631566237298,0.7698948235443198,0.7667850259762025,-598
425,2018-03-02,2018,189800,189800,314889892.46666646,2902991.949999997,144180,0,122,0.8176712328767123,30370191,3275785034,190398,190398,267227,457625,288784053.54999924,2901863.399999712,144543,0,123,0.3409975416552851,3106949600,-598,-598,26105838.916667223,1128.5500002847984,-363,0,-1,0.47667369122142716,-3076579409,1659.0616041447126,1516.7389024569545,142.32270168775813,0.7596417281348788,0.7591623861595185,-363
426,2018-03-03,2018,190926,190926,315279437.3666665,2925299.900000004,146439,0,146,0.8247436179462203,30679646,3284265310,191554,191554,284030,475584,289182562.21666706,2926107.949999743,146831,0,146,0.33299059682411103,3117454341,-628,-628,26096875.14999944,-808.0499997390434,-392,0,0,0.4917530211221093,-3086774695,1651.3174599932252,1509.6660065394983,141.65145345372684,0.7669934948618836,0.7665253662152709,-392
427,2018-03-04,2018,191582,191582,315866548.8166667,2916323.949999999,146853,0,184,0.8175350502656828,30464300,3293604680,192552,192552,299070,491622,289898747.016677,2917606.9333332255,147333,0,186,0.32048809857980887,3126376528,-970,-970,25967801.7999897,-1282.983333226759,-480,0,-2,0.497046951685874,-3095912228,1648.7276926677177,1505.5608200209658,143.16687264675193,0.7665281707049723,0.7651595413187087,-480
428,2018-03-05,2018,193498,193498,316396930.533334,2938609.83333333,148412,0,158,0.8198275951172621,30739316,3304167701,193967,193967,315218,509185,290328707.2999969,2936527.3999998113,148795,0,160,0.3133006667517708,3135324360,-469,-469,26068223.233337104,2082.433333518915,-383,0,-2,0.5065269283654913,-3104585044,1635.1431566906842,1496.7943376966025,138.34881899408174,0.766995007700338,0.7671150247206999,-383
429,2018-03-06,2018,192303,192303,316754802.8999998,2968580.9333333313,149080,0,131,0.8328263209622317,30306487,3310871656,192823,192823,328276,521099,290809573.7500006,2964556.58333314,149505,0,132,0.3095764912233554,3139796025,-520,-520,25945229.1499992,4024.35000019148,-425,0,-1,0.5232498297388763,-3109489538,1647.165165910047,1508.1684952002645,138.99667070978262,0.7752349157319438,0.7753483764903565,-425
430,2018-03-07,2018,193748,193748,317311191.3833334,3006345.7000000034,152026,0,145,0.8452422734686293,30886806,3319344059,194511,194511,339760,534271,291454930.06666684,3003254.633333074,152487,0,145,0.3086804262256478,3146645791,-763,-763,25856261.316666543,3091.066666929517,-461,0,0,0.5365618472429816,-3115758985,1637.75208716133,1498.3981886200104,139.35389854131972,0.7846584222804881,0.7839505220784428,-461
431,2018-03-08,2018,191643,191643,317562474.8666664,2986247.700000003,148440,0,165,0.8347604660749407,30122458,3324702655,192155,192155,354879,547034,291799949.46666634,2982626.0999997263,148747,0,168,0.29386656039661047,3155695014,-512,-512,25762525.400000036,3621.600000276696,-307,0,-3,0.5408939056783302,-3125572556,1657.0523048932982,1518.5654782163688,138.48682667692947,0.7745652071821042,0.774099034633499,-307
432,2018-03-09,2018,206785,206785,317972844.45000017,3110408.616666666,159956,0,136,0.8368256885170586,31443114,3330543999,207222,207222,366791,574013,292416919.2333335,3105179.6666663885,160280,0,137,0.3030088168734891,3166847953,-437,-437,25555925.21666664,5228.95000027772,-324,0,-1,0.5338168716435696,-3135404839,1537.6978235848837,1411.128737457092,126.5690861277917,0.7735377324274004,0.7734699983592476,-324
433,2018-03-10,2018,206666,206666,318389820.46666706,3108808.8166666655,158230,0,172,0.8269913773915408,31060268,3336828970,207113,207113,378874,585987,292954538.90000963,3103947.4666665737,158633,0,173,0.2930252718916968,3175032264,-447,-447,25435281.566657424,4861.350000091828,-403,0,-1,0.533966105499844,-3143971996,1540.6008751641152,1414.46716961277,126.1337055513452,0.7656315020371034,0.7659248815863804,-403
434,2018-03-11,2018,204548,204548,318920563.2166669,3084303.916666666,156348,0,136,0.8260603868040743,30223894,3344408228,210728,210728,394683,605411,293552702.10001695,3088623.0499999393,157143,0,136,0.2813625784797506,3186765589,-6180,-6180,25367861.116649926,-4319.133333273232,-795,0,0,0.5446978083243237,-3156541695,1559.147795220031,1393.040801886873,166.10699333315802,0.7643584879832607,0.7457148551687484,-795
435,2018-03-12,2018,209229,209229,319643477.76666665,3144257.266666668,159409,0,106,0.8215209172724632,29187800,3352657795,210077,210077,413172,623249,293692165.30000705,3141334.099999901,159938,0,106,0.27770441669381624,3192859604,-848,-848,25951312.466659606,2923.1666667670943,-529,0,0,0.543816500578647,-3163671804,1527.7207163761555,1398.021512588275,129.69920378788038,0.7618876924326934,0.7613303693407655,-529
436,2018-03-13,2018,210013,210013,320221775.88333315,3178643.6833333424,160824,0,146,0.8295105541085561,30576308,3357587175,210931,210931,418521,629452,294058204.0000123,3174850.616666556,161464,0,147,0.2794954976709893,3189552986,-918,-918,26163571.883320868,3793.066666786559,-640,0,-1,0.5500150564375668,-3158976678,1524.7712088458006,1394.096666682528,130.6745421632727,0.7657811659278235,0.7654825511660212,-640
437,2018-03-14,2018,213923,213923,320723779.1999997,3170876.0000000005,164112,0,112,0.8314300005142035,30196293,3364162870,214963,214963,432046,647009,294644641.3333417,3166617.7833332187,164782,0,112,0.2773500832291331,3197840875,-1040,-1040,26079137.866657972,4258.216666781809,-670,0,0,0.5540799172850703,-3167644582,1499.2486978959705,1370.676076037931,128.5726218580396,0.7671545369128144,0.7665598265748059,-670
438,2018-03-15,2018,207155,207155,320744072.76666665,3090273.5666666673,158870,0,97,0.8312760976080711,30429910,3368114309,207649,207649,451212,658861,294721672.0500072,3085112.349999867,159231,0,98,0.26268514906785173,3207567355,-494,-494,26022400.716659427,5161.216666800436,-361,0,-1,0.5685909485402194,-3177137445,1548.328897524398,1419.3262286358577,129.00266888854026,0.7669136636817842,0.7668276755486422,-361
439,2018-03-16,2018,207062,207062,320666661.43333364,3103223.366666667,159323,0,189,0.833354261042587,30392413,3371515252,207560,207560,468345,675905,294767744.8166728,3099193.133333224,159690,0,190,0.2565819160976811,3214720739,-498,-498,25898916.616660833,4030.2333334432915,-367,0,-1,0.5767723449449059,-3184328326,1548.6504594437108,1420.1567971510542,128.4936622926566,0.7694458664554578,0.7693678936211216,-367
440,2018-03-17,2018,205632,205632,320426051.2333335,3098914.9666666626,157591,0,55,0.8292580921257384,31804492,3373740912,206114,206114,481759,687873,294552016.40000755,3095500.8999999873,157973,0,55,0.24939487376303374,3219785217,-482,-482,25874034.833325982,3414.066666675266,-382,0,0,0.5798632183627047,-3187980725,1558.2499379149817,1429.0733108862453,129.17662702873645,0.7663739106753813,0.7664350796161348,-382
441,2018-03-18,2018,203769,203769,320567175.1833341,3082330.349999994,157166,0,105,0.8396763001241605,31509953,3378306588,204244,204244,495708,699952,294856042.816674,3079104.7666665297,157619,0,105,0.24636403639106605,3230346039,-475,-475,25711132.366660118,3225.5833334643394,-453,0,0,0.5933122637330944,-3198836086,1573.1891268217153,1443.6460450082939,129.5430818134214,0.771294946728894,0.7717191202679149,-453
442,2018-03-19,2018,209530,209530,321197868.36666656,3101878.2333333283,162270,0,62,0.8416074070538824,30988771,3388004458,210109,210109,509199,719308,295593638.75000614,3099248.766666567,162700,0,62,0.24667041100613163,3239804974,-579,-579,25604229.616660416,2629.46666676132,-430,0,0,0.5949369960477507,-3208816203,1532.9445347523817,1406.8585293823974,126.08600536998438,0.7744475731398845,0.7743599750605638,-430
443,2018-03-20,2018,203877,203877,321390667.2500002,3098380.183333334,158408,0,116,0.8418458188025139,32454633,3393478858,204294,204294,522285,726579,295905295.51667655,3094177.1499999217,158773,0,116,0.23774014938499902,3242960939,-417,-417,25485371.733323634,4203.033333412372,-365,0,0,0.6041056694175149,-3210506306,1576.3949207119988,1448.42871311285,127.9662075991489,0.776978276117463,0.7771789675663504,-365
444,2018-03-21,2018,207958,207958,321930646.116667,3171883.6666666623,161866,0,127,0.8409919310630037,33786889,3402017532,208381,208381,534942,743323,296596856.7666704,3167746.933332811,162196,0,129,0.2366669671192787,3252877507,-423,-423,25333789.349996567,4136.733333851211,-330,0,-2,0.604324963943725,-3219090618,1548.0560791922742,1423.3392524590554,124.7168267332188,0.7783590917396782,0.7783627106118121,-330
445,2018-03-22,2018,183765,183765,316806530.81666696,2758481.2333333376,146929,0,47,0.8480341740810281,13641672,3352478403,184149,184149,556853,741002,291687259.9166799,2755118.2499999395,147996,0,47,0.2121681183046749,3242810544,-384,-384,25119270.899987042,3362.9833333981223,-1067,0,0,0.6358660557763531,-3229168872,1723.9764417417189,1583.974172635637,140.00226910608194,0.799548336190243,0.8036752846879429,-1067
446,2018-03-23,2018,219655,219655,317097910.75,3279838.133333337,168626,0,159,0.8321003391682406,33015389,3355979219,220264,220264,560325,780589,292112863.2833318,3275349.6999999443,168990,0,159,0.23542222603700783,3254481807,-609,-609,24985047.46666819,4488.433333392721,-364,0,0,0.5966781131312328,-3221466418,1443.6179952653024,1326.1943090261314,117.42368623917105,0.7676856889212629,0.7672157047906148,-364
447,2018-03-24,2018,220797,220797,317967540.5166667,3291619.999999997,168364,0,155,0.8273708429009461,33553245,3366350820,221236,221236,561594,782830,293026879.64999825,3286698.6333332905,168810,0,157,0.23490029763805834,3221073620,-439,-439,24940660.866668463,4921.366666706745,-446,0,-2,0.5924705452628878,-3187520375,1440.089949214286,1324.4990853658458,115.59086384844022,0.7625284763832842,0.7630313330561029,-446
448,2018-03-25,2018,179067,179067,315116485.61666656,2736659.4333333317,141479,0,63,0.8343525049283235,12956853,3333706202,179360,179360,593523,772883,290306771.41667336,2732671.466666611,142494,0,63,0.19503987020027871,3214221675,-293,-293,24809714.199993193,3987.9666667208076,-1015,0,0,0.6393126347280448,-3201264822,1759.7686096079487,1618.5703134292671,141.19829617868163,0.790089742945378,0.7944580731489741,-1015
449,2018-03-26,2018,216887,216887,316173151.2333332,3283619.9666666645,168589,0,173,0.8424386892713719,33253133,3346871529,217379,217379,600129,817508,291444931.4500002,3280786.866666228,168898,0,173,0.22466079842643466,3231602044,-492,-492,24728219.783332944,2833.1000004364178,-309,0,0,0.6177778908449372,-3198348911,1457.7782496568866,1340.7225695674385,117.05568008944806,0.777312609792196,0.7769747767723653,-309
450,2018-03-27,2018,217323,217323,317237031.40000004,3294506.0166666666,168394,0,330,0.8452349728284625,34109494,3359824077,217800,217800,595891,813691,292644409.816665,3289996.499999958,168792,0,334,0.22720664232491292,3218100325,-477,-477,24592621.583335042,4509.516666708514,-398,0,-4,0.6180283305035496,-3183990831,1459.7489975750382,1343.6382452555786,116.1107523194596,0.7748558597111213,0.7749862258953168,-398
451,2018-03-28,2018,217385,217385,318119982.2999999,3282695.0666666636,167516,0,116,0.8423902293166509,33772969,3370953764,217999,217999,610086,828085,293577806.4166674,3278466.666666162,167967,0,116,0.22249648284898252,3232060896,-614,-614,24542175.88333249,4228.400000501424,-451,0,0,0.6198937464676684,-3198287927,1463.394357016353,1346.6933628900472,116.70099412630589,0.7705959472824712,0.7704943600658719,-451
452,2018-03-29,2018,217780,217780,318964613.4833335,3271930.166666666,167784,0,178,0.8443520984479755,33914965,3382302822,218274,218274,624605,842879,294412888.7833313,3267647.666666641,168178,0,178,0.21922838272160083,3242910696,-494,-494,24551724.700002253,4282.500000025146,-394,0,0,0.6251237157263747,-3208995731,1464.6184841736317,1348.822529404928,115.79595476870372,0.7704288731747635,0.7704903011810843,-394
453,2018-03-30,2018,217929,217929,319801841.0833337,3286445.483333333,168123,0,113,0.8460599553065447,33839805,3395085972,218600,218600,638629,857229,295289332.8166658,3281446.9666666193,168605,0,113,0.21666439189528244,3257116727,-671,-671,24512508.266667843,4998.516666713636,-482,0,0,0.6293955634112622,-3223276922,1467.4588562482904,1350.8203697011245,116.63848654716594,0.7714576765827402,0.7712946020128087,-482
454,2018-03-31,2018,216678,216678,320416902.20000035,3249453.5666666646,166229,0,394,0.8438420144177068,33370067,3405824197,217116,217116,653028,870144,295988892.5333422,3245455.3999995287,166664,0,394,0.21160750404531783,3274228922,-438,-438,24428009.666658163,3998.166667135898,-435,0,0,0.632234510372389,-3240858855,1478.7698898826848,1363.275357566196,115.49453231648886,0.7671706403049686,0.7676265222277492,-435
455,2018-04-01,2018,203294,203294,320210234.7333333,3140925.416666672,164665,0,262,0.8985262722952956,26487478,3405477887,177863,177863,306561,484424,293025305.5333326,2721867.6333333147,142935,0,158,0.3186856968275733,3240864439,25431,25431,27184929.200000703,419057.7833333574,21730,0,104,0.5798405754677223,-3214376961,1575.10912635559,1647.4775840581378,-72.36845770254786,0.8099845543892097,0.8036241376790001,21730
456,2018-04-02,2018,218365,218365,320962263.84999967,3261128.4333333364,168455,0,327,0.8487807111945594,33150519,3416942839,225879,225879,311336,537215,294058379.60000825,3270163.7499998417,170513,0,327,0.3509674897387376,3258370565,-7514,-7514,26903884.249991417,-9035.3166665053,-2058,0,0,0.49781322145582185,-3225220046,1469.8429869713539,1301.8402755457932,168.00271142556062,0.7714377304055137,0.7548864657626428,-2058
457,2018-04-03,2018,213763,213763,321321302.38333327,3201159.250000002,164171,0,182,0.8380168691494784,31920348,3423301823,214363,214363,317454,531817,291502942.7000126,3197383.916666588,164706,0,182,0.33989887498895144,3195139259,-600,-600,29818359.68332064,3775.333333414048,-535,0,0,0.49811799416052693,-3163218911,1503.1661343793512,1359.8566109823646,143.3095233969866,0.7680047529273073,0.7683508814487575,-535
458,2018-04-04,2018,211377,211377,321272554.283333,3164698.950000004,162558,0,215,0.8397413152802805,32011038,3427770942,212139,212139,332428,544567,291768718.6666775,3161402.716666543,163164,0,217,0.33134214889995395,3205089427,-762,-762,29503835.61665553,3296.2333334609866,-606,0,-2,0.5083991663803266,-3173078389,1519.9030844573108,1375.3657680420738,144.537316415237,0.7690429895400162,0.7691372166362621,-606
459,2018-04-05,2018,208353,208353,321367968.6500003,3174012.283333333,161438,0,307,0.8452482085691109,32925200,3432952850,209566,209566,348128,557694,292164745.96667546,3169542.7499998324,162276,0,307,0.319497789110159,3213222926,-1213,-1213,29203222.683324814,4469.533333500847,-838,0,0,0.5257504194589518,-3180297726,1542.4206450111124,1394.1419217176233,148.27872329348907,0.7748292561182224,0.7743431663533207,-838
460,2018-04-06,2018,225694,225694,321318792.1000001,3145791.866666667,160864,0,95,0.7760950667718228,33269607,3437612508,226273,226273,364376,590649,291865227.45000696,3141829.9666664214,161229,0,99,0.29800270549852853,3216365990,-579,-579,29453564.64999312,3961.900000245776,-365,0,-4,0.4780923612732943,-3183096383,1423.6922208831431,1289.8809290105623,133.8112918725808,0.7127526651129406,0.7125419294392172,-365
461,2018-04-07,2018,230751,230751,321255413.44999963,3181926.35,166212,0,86,0.7947094487131157,34134274,3442205240,231258,231257,398274,629532,292094964.6333444,3177101.5166665656,166804,0,86,0.295667257581821,3226344341,-507,-506,29160448.81665522,4824.833333434537,-592,0,0,0.49904219113129467,-3192210067,1392.2167767420276,1263.07512695116,129.14164979086763,0.7203089044034479,0.7212896418718487,-592
462,2018-04-08,2018,181813,181813,317515715.99999946,2725579.383333333,145911,0,49,0.8664066925907388,13592674,3400376556,182272,182272,436911,619183,289117480.15001297,2721394.8666666127,147233,0,49,0.2614267510574429,3215918450,-459,-459,28398235.849986494,4184.516666720156,-1322,0,0,0.6049799415332959,-3202325776,1746.3862100069823,1586.1870180280732,160.19919197890908,0.8025333722011078,0.8077653177668539,-1322
463,2018-04-09,2018,224207,224207,318013457.3999998,3342106.6166666658,171628,0,155,0.8362361567658455,32534490,3405964860,226743,226743,436212,662955,289981187.95000863,3339207.9833327294,172352,0,155,0.28517169340301085,3228756563,-2536,-2536,28032269.449991167,2898.6333339363337,-724,0,0,0.5510644633628347,-3196222073,1418.392188468691,1278.8980826310344,139.49410583765666,0.7654890346866958,0.7601204888353775,-724
464,2018-04-10,2018,220203,220203,318969878.24999994,3308558.199999999,170292,0,324,0.8517322652279933,32589257,3416583024,221252,221252,435564,656816,290600022.2666783,3306665.983333202,170862,0,324,0.28880995590849917,3203763406,-1049,-1049,28369855.983321667,1892.2166667967103,-570,0,0,0.5629223093194942,-3171174149,1448.5264880587456,1313.4345554692309,135.09193258951473,0.7733409626571845,0.7722506463218411,-570
465,2018-04-11,2018,224450,224450,320058486.1833329,3373456.866666668,172423,0,262,0.8564268211182886,33213666,3428838617,225401,225401,445612,671013,291827999.8666788,3369163.7499998966,173031,0,262,0.2908572561187327,3216400192,-951,-951,28230486.316654146,4293.1166667714715,-608,0,0,0.5655695649995559,-3183186526,1425.9678600282152,1294.7058791517286,131.26198087648663,0.7682022722209846,0.7676585285779566,-608
466,2018-04-12,2018,189615,189615,317916678.96666634,2854111.25,150539,0,85,0.8526329668011507,14198323,3400622990,190252,190252,474605,664857,290021826.00001156,2850226.083333293,151710,0,85,0.2474080892582903,3208556672,-637,-637,27894852.966654778,3885.166666707024,-1171,0,0,0.6052248775428605,-3194358349,1676.643087132697,1524.4088156761115,152.23427145658547,0.7939192574427129,0.7974160587010912,-1171
467,2018-04-13,2018,221463,221463,318412122.54999983,3309861.666666667,171193,0,352,0.8546393754261432,32870293,3406115411,231439,231439,483006,714445,290767954.08335453,3317835.266666577,173569,0,352,0.2698710187628054,3221723519,-9976,-9976,27644168.4666453,-7973.5999999102205,-2376,0,0,0.5847683566633378,-3188853226,1437.7666813418036,1256.348126648294,181.41855469350958,0.773009486912035,0.7499557118722427,-2376
468,2018-04-14,2018,215923,215923,318633121.7,3225635.200000001,166959,0,112,0.8519286968039536,32585881,3411842420,219000,219000,492860,711860,287107169.433344,3221243.7166665522,168055,0,112,0.262183575422137,3147626435,-3077,-3077,31525952.26665598,4391.483333448879,-1096,0,0,0.5897451213818166,-3115040554,1475.6793935801188,1310.9916412481462,164.68775233197266,0.77323397692696,0.7673744292237443,-1096
469,2018-04-15,2018,210352,210352,318990735.43333346,3220973.966666666,164049,0,102,0.8885772419563398,31963519,3419196598,211066,211066,505873,716939,286709048.46667665,3215656.0333332345,164741,0,102,0.2732310559196847,3139419334,-714,-714,32281686.966656804,5317.933333431371,-692,0,0,0.6153461860366551,-3107455815,1516.461623532619,1358.3857583252473,158.07586520737163,0.7798784893892142,0.7805188898259312,-692
470,2018-04-16,2018,217697,217697,319792805.2666669,3302426.250000001,169842,0,160,0.946613871573793,33450835,3428391416,223649,223649,516415,740064,287702653.966661,3297975.616666629,173648,0,160,0.34217716305617046,3153004313,-5952,-5952,32090151.300005913,4450.633333371952,-3806,0,0,0.6044367085176225,-3119553478,1468.9812228311225,1286.4025949888485,182.57862784227405,0.7801761163451953,0.7764309252444679,-3806
471,2018-04-17,2018,225864,225864,320634644.4000004,3374146.55,174316,0,223,0.9424033931923633,33912821,3438889068,227518,227518,525103,752621,286301633.9166639,3368766.5999999316,175796,0,225,0.3398921900930186,3117426046,-1654,-1654,34333010.48333651,5379.950000068173,-1480,0,-2,0.6025112030993447,-3083513225,1419.5916321326124,1258.3691572388288,161.22247489378356,0.7717741649842383,0.7726685361158238,-1480
472,2018-04-18,2018,220263,220263,320883546.73333347,3342406.6999999965,175815,0,153,0.9891357150315754,28768597,3440490979,195570,195570,550332,745902,284826706.06667453,2917409.683333307,155928,0,93,0.318083340706961,3110941198,24693,24693,36056840.66665894,424997.0166666894,19887,0,60,0.6710523743246144,-3082172601,1456.8200139530175,1456.3926270219079,0.427386931109595,0.7982048732651421,0.7973001994170885,19887
473,2018-04-19,2018,232694,232694,321926195.13333374,3468150.033333338,179865,0,243,0.9386662311877406,33092886,3451435113,234999,234999,553939,788938,286048842.5333338,3463016.6999999294,181647,0,243,0.354176120303498,3126550061,-2305,-2305,35877352.599999964,5133.33333340846,-1782,0,0,0.5844901108842426,-3093457175,1383.474413321073,1217.2342968835346,166.2401164375383,0.7729679321340472,0.7729692466776454,-1782
474,2018-04-20,2018,232471,232471,322696393.08333355,3423329.2,179106,0,124,0.9199470041424523,32500441,3459825882,234325,234325,553753,788078,287177236.6499984,3418526.8333332953,180585,0,103,0.32035026989713805,3121937992,-1854,-1854,35519156.433335125,4802.366666704882,-1479,0,21,0.5995967342453143,-3089437551,1388.1146168052512,1225.550993918696,162.56362288655532,0.7704444855487351,0.7706604075536114,-1479
475,2018-04-21,2018,228395,228395,323005184.2833332,3392882.216666665,176205,0,129,0.9704546947174858,33664602,3467683484,230620,230620,572843,803463,287778696.0833409,3386342.83333285,178192,0,106,0.3684749639996005,3133459859,-2225,-2225,35226488.1999923,6539.383333814796,-1987,0,23,0.6019797307178854,-3099795257,1414.2392971971067,1247.8479580406768,166.39133915642992,0.7714923706736136,0.772664990026884,-1987
476,2018-04-22,2018,228740,228740,323656117.6833334,3369396.400000002,177367,0,214,1.0301127918160364,33691062,3477682584,231228,231228,587631,818859,288670306.41667587,3364396.3833327927,179637,0,214,0.40114964847427437,3149509631,-2488,-2488,34985811.26665753,5000.0166672091,-2270,0,0,0.6289631433417621,-3115818569,1414.9519877736006,1248.4227966192498,166.52919115435088,0.7754087610387339,0.7768825574757382,-2270
477,2018-04-23,2018,224994,224994,323918958.3833335,3343001.650000002,175280,0,136,0.9770838333466675,33592371,3486308314,226813,226813,605739,832552,289194525.44999605,3340282.433333301,176891,0,136,0.3234692848014373,3165947667,-1819,-1819,34724432.93333745,2719.216666700784,-1611,0,0,0.6536145485452303,-3132355296,1439.6782064558765,1275.0350528849583,164.64315357091823,0.7790429967021343,0.7798979776291483,-1611
478,2018-04-24,2018,221541,221541,323939165.28333306,3323636.6333333356,173163,0,172,1.002374278350284,32993211,3490143059,223850,223850,620448,844298,289470796.93334186,3320998.2166661667,175156,0,173,0.3451565679416414,3174349446,-2309,-2309,34468368.3499912,2638.41666716896,-1993,0,-1,0.6572177104086426,-3141356235,1462.2086443743283,1293.1462896285095,169.06235474581877,0.7816295854943329,0.782470404288586,-1993
479,2018-04-25,2018,231737,231737,324525378.18333274,3410615.183333333,178617,0,185,0.9980667739722185,34080834,3498059125,234494,234494,631486,865980,290265330.983329,3409922.599999938,180781,0,185,0.3385886510081023,3183715300,-2757,-2757,34260047.20000374,692.5833333949558,-2164,0,0,0.6594781229641162,-3149634466,1400.4038120081505,1237.836921129449,162.56689087870154,0.77077462813448,0.7709408343070612,-2164
480,2018-04-26,2018,236195,236195,325251124.8500001,3463209.6499999976,180862,0,130,0.9532970638667208,30964370,3501662644,246444,246444,642573,889017,291324322.14999145,3470329.066666639,186082,0,85,0.3106656003203541,3187835240,-10249,-10249,33926802.70000863,-7119.416666641366,-5220,0,45,0.6426314635463666,-3156870870,1377.0449198755268,1182.111644633229,194.9332752422979,0.765731704735494,0.7550680884906916,-5220
481,2018-04-27,2018,237482,237482,326057090.96666706,3485217.1,183174,0,164,0.9699514068434655,35217217,3510475828,239717,239717,662039,901756,290622616.24999505,3483558.6666665995,184970,0,164,0.29518628098954225,3164431182,-2235,-2235,35434474.716672,1658.433333400637,-1796,0,0,0.6747651258539232,-3129213965,1372.9760190947823,1212.3571388345217,160.61888026026054,0.7713174051085977,0.7716181997939237,-1796
482,2018-04-28,2018,239424,239424,326849871.5833333,3526707.450000004,183585,0,181,0.9886811681368619,36259807,3522694371,241622,241621,669582,911204,291536195.6833304,3522519.1499999883,185506,0,181,0.3183644935711444,3175513186,-2198,-2197,35313675.9000029,4188.300000015646,-1921,0,0,0.6703166745657175,-3139253379,1365.1508269151518,1206.5846746902398,158.566152224912,0.7667777666399358,0.7677529364047976,-1921
483,2018-04-29,2018,236607,236607,327527888.9833331,3464796.883333331,181633,0,192,0.9880392380614273,35736059,3532614267,238847,238847,683977,922824,292385644.64999646,3461134.5833333135,183664,0,193,0.3068515773321896,3189937444,-2240,-2240,35142244.33333665,3662.300000017509,-2031,0,-1,0.6811876607292378,-3154201385,1384.2696496018,1224.154561916191,160.11508768560907,0.7676569163211571,0.7689608829083053,-2031
484,2018-04-30,2018,239100,239100,327947612.25000024,3434541.4833333306,183508,0,163,0.9900125470514433,36383663,3541291928,241296,241295,701214,942510,292957334.2499976,3429804.733333299,185489,0,164,0.31183117420504713,3207154083,-2196,-2195,34990278.00000262,4736.750000031665,-1981,0,-1,0.6781813728463961,-3170770420,1371.5918538268518,1214.104454091455,157.48739973539682,0.7674947720618988,0.7687197467011472,-1981
485,2018-05-01,2018,220490,220490,327286465.20000005,3235980.3333333335,168811,0,142,0.992262687650233,35136140,3544045530,224036,224036,296477,520513,292529788.6166809,3232809.333333214,171000,0,144,0.5411411434488629,3186919444,-3546,-3546,34756676.58331913,3171.000000119675,-2189,0,-2,0.4511215442013701,-3151783304,1484.359677082861,1305.7267073893522,178.6329696935088,0.7656174883214658,0.76327018871967,-2189
486,2018-05-02,2018,212669,212669,326982464.1000002,3217324.266666674,163007,0,135,0.9716178662616569,35150516,3549075563,217725,217725,320477,538202,292284156.5333361,3217859.216666514,165624,0,104,0.505295409530261,3197078405,-5056,-5056,34698307.5666641,-534.9499998399988,-2617,0,31,0.46632245673139594,-3161927889,1537.5182283266495,1342.4464647299856,195.0717635966639,0.7664821859321292,0.7607027213227695,-2617
487,2018-05-03,2018,213193,213193,327298371.59999996,3222610.349999997,163154,0,138,0.9618655396753177,34716552,3558478089,215282,215282,334820,550102,292400333.266672,3218274.1999998465,165063,0,93,0.4980839916960863,3199623219,-2089,-2089,34898038.33332795,4336.1500001503155,-1909,0,45,0.46378154797923143,-3164906667,1535.2210044419844,1358.2200707289603,177.0009337130241,0.7652877908749349,0.7667292202785184,-1909
488,2018-05-04,2018,220968,220968,327818930.0666671,3249312.033333334,166789,0,134,0.9390635748162623,35934571,3568365690,230303,230303,345584,575887,293100403.4500016,3280717.5499997186,170585,0,88,0.44251215950351397,3213421783,-9335,-9335,34718526.61666548,-31405.516666384414,-3796,0,46,0.4965514153127484,-3177487212,1483.5583888466524,1272.6729719109244,210.88541693572802,0.7548106513160276,0.7406981237760689,-3796
489,2018-05-05,2018,219625,219625,328152116.433333,3243632.0666666715,166370,0,127,0.9331724530449629,35309562,3577234599,221525,221525,369242,590767,291804085.1000094,3238249.716666375,168105,0,96,0.44006351065648536,3208249165,-1900,-1900,36348031.3333236,5382.350000296719,-1735,0,31,0.4931089423884775,-3172939603,1494.147371352683,1317.251258774447,176.89611257823594,0.7575184974388162,0.7588534025505022,-1735
490,2018-05-06,2018,219672,219672,328450071.5333331,3209469.066666669,166882,0,132,0.9297634655304271,35016073,3583789492,221207,221206,381126,602333,292004029.93334466,3205833.2166664824,168314,0,94,0.4223394700273761,3216304315,-1535,-1534,36446041.59998846,3635.8500001868233,-1432,0,38,0.5074239955030511,-3181288242,1495.1840541049069,1320.0547450491608,175.12930905574603,0.7596871699624895,0.7608891219536452,-1432
491,2018-05-07,2018,217021,217021,326928866.00000006,3153712.4333333317,167124,0,139,0.9342045239861593,33570648,3567722546,218838,218838,399607,618445,290728543.4166788,3150069.4833332403,168726,0,99,0.40353790555345026,3206121560,-1817,-1817,36200322.58332127,3642.950000091456,-1602,0,40,0.530666618432709,-3172550912,1506.438851539713,1328.510329178108,177.92852236160502,0.7700821579478484,0.7710086913607326,-1602
492,2018-05-08,2018,214017,214017,325523905.1000002,3221531.0333333337,164057,0,135,0.9424718597120789,33143360,3550357195,216426,216426,411621,628047,289700545.83334255,3217941.1499998383,165471,0,96,0.3999732504096007,3190752622,-2409,-2409,35823359.26665765,3589.8833334953524,-1414,0,39,0.5424986093024782,-3157609262,1521.0189148525594,1338.56628054551,182.4526343070495,0.7665606003261423,0.7645615591472374,-1414
493,2018-05-09,2018,215426,215426,325767140.0333331,3230575.683333334,165877,0,136,0.9568668591534912,31784805,3554423465,217311,217311,423015,640326,290194307.56667864,3228658.8333332087,167346,0,101,0.401668837435927,3199392230,-1885,-1885,35572832.46665448,1916.850000125356,-1469,0,35,0.5551980217175643,-3167607425,1512.1997346343205,1335.3871068039753,176.81262783034526,0.7699952651954731,0.770076066098817,-1469
494,2018-05-10,2018,216502,216502,326160236.9666668,3250668.9499999946,166661,0,132,1.0177042244413437,31933631,3558826122,218782,218782,436749,655531,290795977.2166785,3246269.7333331774,168676,0,106,0.456802195472071,3207080388,-2280,-2280,35364259.74998832,4399.216666817199,-2015,0,26,0.5609020289692727,-3175146757,1506.4998797547682,1329.1586017893542,177.34127796541406,0.7697896555228128,0.7709775027196022,-2015
495,2018-05-11,2018,220648,220648,326655476.41666687,3280164.9999999977,169694,0,135,0.9732107247743004,33766808,3567379000,222761,222761,448108,670869,291516369.4333472,3276868.916666478,171634,0,88,0.43008396572206975,3216582885,-2113,-2113,35139106.98331964,3296.083333519753,-1940,0,47,0.5431267590522306,-3182816077,1480.4370600080983,1308.6508384921383,171.78622151596005,0.7690710996700627,0.7704849592163799,-1940
496,2018-05-12,2018,217271,217271,326690156.74999994,3246148.0999999954,167495,0,142,1.0121000961932327,33183086,3569253668,219540,219540,462332,681872,291729236.0000101,3241754.683333177,169491,0,92,0.4389445526433132,3225470489,-2269,-2269,34960920.74998987,4393.416666818317,-1996,0,50,0.5731555435499195,-3192287403,1503.6068170625622,1328.8204245240506,174.78639253851156,0.7709036180622356,0.7720278764689806,-1996
497,2018-05-13,2018,218663,218663,327213070.283333,3230648.36666667,166109,0,145,0.9890699386727522,34504694,3578501501,220823,220823,475346,696169,292422238.40001214,3227067.8833331587,168109,0,104,0.41577260693882445,3237368167,-2160,-2160,34790831.88332087,3580.483333511278,-2000,0,41,0.5732973317339277,-3202863473,1496.4263285664836,1324.2381382374667,172.18819032901683,0.7596575552333957,0.7612839242289073,-2000
498,2018-05-14,2018,220607,220607,327851917.28333354,3270234.3666666644,167354,0,139,0.9791575063347941,34602245,3589241121,235536,235536,492063,727599,293203537.3999918,3308972.1166666015,173797,0,99,0.4135464727136743,3248702371,-14929,-14929,34648379.88334173,-38737.749999937136,-6443,0,40,0.5656110336211199,-3214100126,1486.1356044156964,1244.835343217138,241.30026119855847,0.7586069345034382,0.7378787106854154,-6443
499,2018-05-15,2018,218310,218310,328193952.85000044,3265505.833333332,166842,0,138,0.9722916952956806,34280718,3594349767,220405,220405,512916,733321,290810807.8166792,3261603.549999522,168606,0,95,0.370843055087737,3207716555,-2095,-2095,37383145.03332126,3902.2833338100463,-1764,0,43,0.6014486402079435,-3173435837,1503.3390721909232,1319.4383422185485,183.90072997237462,0.7642435069396729,0.7649826455842653,-1764
500,2018-05-16,2018,219263,219263,328595796.45,3260236.749999999,166190,0,139,0.9644354040581395,34336731,3601128804,221681,221681,517746,739427,291083748.1166628,3255561.46666667,168298,0,105,0.40591430932330486,3211352010,-2418,-2418,37512048.33333719,4675.283333329018,-2108,0,34,0.5585210947348347,-3177015279,1498.6376928619968,1313.0748603473585,185.56283251463833,0.7579482174375065,0.7591900072626883,-2108
501,2018-05-17,2018,220038,220038,328956274.8166667,3263707.6833333336,167417,0,141,0.9875248820658252,34423109,3605485816,222513,222513,533246,755759,291513863.5666647,3259499.5333333067,169715,0,102,0.4120665450229487,3218138712,-2475,-2475,37442411.25000203,4208.150000026915,-2298,0,39,0.5754583370428765,-3183715603,1494.9975677685977,1310.0981226564952,184.8994451121025,0.7608549432370773,0.7627194815583809,-2298
502,2018-05-18,2018,219014,219014,329321203.93333316,3262345.6833333336,168282,0,155,0.9878500917749551,33542556,3611256196,221567,221566,545999,767566,292030345.6166618,3258717.8333333377,170569,0,155,0.39494063051255845,3226675452,-2553,-2552,37290858.31667137,3627.849999995902,-2287,0,0,0.5929094612623966,-3193132896,1503.6536656712958,1318.0286940083847,185.6249716629111,0.7683618398823819,0.769830344771559,-2287
503,2018-05-19,2018,222060,222060,329433815.13333315,3277253.1666666684,168174,0,142,0.9816085742592098,35739762,3618847676,224377,224377,558377,782754,292317507.74999654,3274752.8333332953,170229,0,114,0.3880235680686442,3238246674,-2317,-2317,37116307.3833366,2500.3333333730698,-2055,0,28,0.5935850061905656,-3202506912,1483.5351487585929,1302.7962213150035,180.73892744358932,0.7573358551742773,0.7586740173903742,-2055
504,2018-05-20,2018,218306,218306,329730902.38333356,3259781.983333329,167426,0,146,1.033453042976372,34343998,3624073959,221042,221042,573461,794503,292843618.116663,3256626.083333332,169895,0,105,0.40799594211727586,3250173379,-2736,-2736,36887284.266670585,3155.899999997113,-2469,0,41,0.6254571008590961,-3215829381,1510.4069626273833,1324.832466755924,185.57449587145925,0.7669326541643381,0.7686095855086363,-2469
505,2018-05-21,2018,222216,222216,330320788.2833332,3285049.0833333284,169493,0,149,1.0270907585412397,34724283,3632439373,224776,224776,585558,810334,293540012.66666824,3279686.899999477,171756,0,108,0.3935118111790809,3262233062,-2560,-2560,36780775.616664946,5362.183333851397,-2263,0,41,0.6335789473621587,-3227508779,1486.4851688597273,1305.9223968157999,180.56277204392745,0.7627398567159881,0.764120724632523,-2263
506,2018-05-22,2018,218979,218979,329899170.3333334,3258661.3666666653,166793,0,141,0.985674425401522,33739529,3632290383,221098,221098,599387,820485,293332997.866665,3253669.6166666513,168693,0,114,0.34652918700525104,3267857069,-2119,-2119,36566172.46666837,4991.75000001397,-1900,0,27,0.6391452383962709,-3234117540,1506.5333677354147,1326.7103178982397,179.82304983717495,0.7616849104252006,0.7629784077648826,-1900
507,2018-05-23,2018,219828,219828,330264414.4166669,3299691.149999998,168071,0,142,0.9934357770620659,33967766,3638142268,222305,222305,611639,833944,293991254.23333985,3295990.366666157,170188,0,101,0.35761633874695486,3273570776,-2477,-2477,36273160.18332708,3700.7833338412456,-2117,0,41,0.635819438315111,-3239603010,1502.3764689514844,1322.4680247108245,179.90844424065995,0.7645568353439962,0.7655608285913498,-2117
508,2018-05-24,2018,225467,225467,331105822.8166669,3352093.0000000014,170824,0,281,0.9960748136090873,33341141,3647557765,227759,227758,621496,849255,294931291.133344,3347420.833332795,172799,0,281,0.3544082754885227,3282160557,-2292,-2291,36174531.68332291,4672.166667206213,-1975,0,0,0.6416665381205646,-3248819416,1468.533412058824,1294.9327405989866,173.60067145983749,0.7576452429845609,0.7586923019507462,-1975
509,2018-05-25,2018,222138,222138,331591381.53333354,3320532.3999999976,170420,0,243,1.0443823208996208,33293410,3655515288,224953,224953,636575,861528,295539732.1833393,3315988.599999454,173005,0,243,0.38838435895292495,3292160101,-2815,-2815,36051649.34999424,4543.800000543706,-2585,0,0,0.6559979619466958,-3258866691,1492.7269604179994,1313.7843557691576,178.94260464884178,0.7671807615086118,0.7690717616568794,-2585
510,2018-05-26,2018,219280,219280,331727380.883333,3311731.083333336,168803,0,212,1.0976924480116736,32636739,3659416651,222750,222750,651740,874490,295825279.5666636,3306855.4833333213,172076,0,212,0.4766526775606332,3302426112,-3470,-3470,35902101.316669405,4875.600000014529,-3273,0,0,0.6210397704510404,-3269789373,1512.8027220144702,1328.0596164608917,184.74310555357852,0.769805727836556,0.7725072951739619,-3273
511,2018-05-27,2018,218463,218463,332008470.28333294,3264605.3166666613,166524,0,147,1.0520271167199937,32046394,3662598945,221692,221692,662781,884473,296364197.79999757,3259774.6833332945,168922,0,123,0.3694606844980021,3311409836,-3229,-3229,35644272.483335376,4830.63333336683,-2398,0,24,0.6825664322219915,-3279363442,1519.7469149619521,1336.8285630514297,182.91835191052246,0.7622526469013059,0.7619670533893871,-2398
512,2018-05-28,2018,217617,217617,332574600.41666675,3315893.3000000063,167909,0,139,1.031835748126295,32371445,3670620343,219855,219855,678396,898251,297032167.18332815,3311519.5833333237,170015,0,139,0.35070820962069504,3322223211,-2238,-2238,35542433.233338594,4373.716666682623,-2106,0,0,0.6811275385055999,-3289851766,1528.256525991383,1351.0366704570201,177.21985553436275,0.7715803452855245,0.7733051329285211,-2106
513,2018-05-29,2018,217918,217918,332977138.63333297,3316592.4166666702,168048,0,135,1.016391486706009,32309917,3675163901,219863,219862,686396,906259,297619034.166663,3312037.566666688,169794,0,137,0.31701202415645074,3327212352,-1945,-1944,35358104.46666998,4554.849999982398,-1746,0,-2,0.6993794625495584,-3294902435,1527.9928167169896,1353.6629074904395,174.32990922655017,0.7711524518396828,0.7722718238175591,-1746
514,2018-05-30,2018,215944,215944,333563512.00000024,3272988.883333334,167371,0,133,0.9779155707035161,29021111,3678648691,218030,218030,697825,915855,298328290.1333285,3270286.533333333,169264,0,95,0.2993858198077237,3332799028,-2086,-2086,35235221.86667174,2702.350000000559,-1893,0,38,0.6785297508957924,-3303777917,1544.675990071501,1368.2900983044924,176.38589176700862,0.7750666839550995,0.7763335320827409,-1893
515,2018-05-31,2018,211653,211653,333566361.933333,3147196.000000002,164388,0,156,1.0166498939301607,27914492,3677808468,214021,214021,712447,926468,298508174.8333297,3142688.1166666737,166436,0,104,0.3045383110911525,3335768389,-2368,-2368,35058187.1000033,4507.88333332818,-2048,0,52,0.7121115828390082,-3307853897,1576.0058299827217,1394.7611441556187,181.244685827103,0.7766863687261697,0.7776620051303377,-2048
516,2018-06-01,2018,215080,215080,333878391.6166667,3163112.166666669,167028,0,151,1.010358936209781,30073144,3680516400,217390,217389,284161,501551,298907687.81666636,3158892.783333093,169291,0,103,0.5933913001868002,3308872000,-2310,-2309,34970703.80000031,4219.383333575912,-2263,0,48,0.4169676360229807,-3278798856,1552.345134911041,1374.989938850017,177.3551960610239,0.7765854565742979,0.7787432724596347,-2263
517,2018-06-02,2018,217609,217609,334122673.2333329,3302188.5833333298,168314,0,138,0.9798721560229582,29250069,3682073042,219551,219551,299477,519028,299261703.60000914,3297190.316666605,170198,0,94,0.5455890626324604,3312207440,-1942,-1942,34860969.63332373,4998.266666724812,-1884,0,44,0.43428309339049775,-3282957371,1535.426720555367,1363.0623572655518,172.36436328981517,0.7734698472949189,0.7752094046485782,-1884
518,2018-06-03,2018,218767,218767,334680781.2666663,3304268.683333331,169159,0,145,0.9555280275361455,31274079,3688422454,220655,220655,308739,529394,299960226.28333247,3299647.033333116,170864,0,101,0.5090764156752734,3321013692,-1888,-1888,34720554.983333826,4621.650000214577,-1705,0,44,0.4464516118608721,-3289739613,1529.8503945598115,1359.4082449223106,170.44214963750096,0.7732381940603473,0.7743490970066393,-1705
519,2018-06-04,2018,214829,214829,335380141.10000026,3300688.7499999986,167044,0,130,0.9492619711491475,31828851,3696664622,216934,216934,324995,541929,300833553.6500023,3298047.8499997584,168694,0,101,0.48203177907069733,3331979786,-2105,-2105,34546587.44999796,2640.900000240188,-1650,0,29,0.4672301920784501,-3300150935,1561.1492912968001,1386.7515172817646,174.39777401503557,0.7775672744368777,0.7776282187209013,-1650
520,2018-06-05,2018,215863,215863,335899388.68333375,3311204.383333336,167242,0,122,0.95991902271348,32524701,3701005552,217770,217770,335484,553254,301479293.1500132,3309286.1166665126,168769,0,95,0.46447020717427984,3337495957,-1907,-1907,34420095.533320546,1918.2666668235324,-1527,0,27,0.4954488155392001,-3304971256,1556.0767184896613,1384.3931356477624,171.6835828418989,0.7747599171696863,0.7749873719979795,-1527
521,2018-06-06,2018,218041,218041,336440489.4833334,3322134.5666666655,168612,0,124,0.9504450997748125,32346801,3707545253,219692,219692,349439,569131,302107880.58334506,3317954.8666665335,170055,0,105,0.45981856549722405,3346604961,-1651,-1651,34332608.89998835,4179.700000131968,-1443,0,19,0.49062653427758846,-3314258160,1543.0147975992286,1375.1428389897906,167.87195860943802,0.7733041033567082,0.7740609580685687,-1443
522,2018-06-07,2018,217183,217183,336858144.64999986,3317974.916666667,168545,0,112,0.9057062477265715,32510147,3711115647,226529,226529,361692,588221,302686979.6666686,3320328.2833330566,171671,0,75,0.3732984711528586,3356445946,-9346,-9346,34171164.98333126,-2353.3666663896292,-3126,0,37,0.532407776573713,-3323935799,1551.0336658486156,1336.195275954375,214.83838989424066,0.7760506116961272,0.7578323305183884,-3126
523,2018-06-08,2018,221595,221595,337330509.7833334,3329771.7666666685,169855,0,134,0.9315417766646356,31796725,3716892937,223152,223152,377829,600981,299930524.55000854,3325377.399999911,171204,0,100,0.4199350728225968,3312452943,-1557,-1557,37399985.233324885,4394.366666757502,-1349,0,34,0.5116067038420388,-3280656218,1522.2839404469119,1344.0637975461054,178.22014290080642,0.7665109772332408,0.7672080017208002,-1349
524,2018-06-09,2018,217311,217311,337570012.8499998,3295321.166666669,167801,0,128,0.9581705482005057,32651401,3722564717,218966,218966,391623,610589,300320237.5333456,3290943.9666665075,169445,0,89,0.4464083041129132,3321792491,-1655,-1655,37249775.316654205,4377.200000161305,-1644,0,39,0.5117622440875925,-3289141090,1553.3958835493822,1371.5382184144826,181.85766513489966,0.7721698395387256,0.7738416009791474,-1644
525,2018-06-10,2018,211919,211919,337549517.20000005,3250333.650000003,166282,0,140,0.9261746233230622,31485845,3721451727,213620,213620,405885,619505,300566591.1666738,3246372.8166665696,167550,0,85,0.3755692044454852,3333589924,-1701,-1701,36982926.03332627,3960.8333334336057,-1268,0,55,0.5506054188775771,-3302104079,1592.8232824805707,1407.0152193927245,185.80806308784622,0.7846488516838981,0.7843366725961989,-1268
526,2018-06-11,2018,214431,214431,337802202.48333293,3280771.7166666663,165308,0,138,0.9108058069961895,30727782,3724516107,215723,215723,419321,635044,301013677.8333422,3276891.1999998996,166406,0,109,0.36124898432233965,3341268532,-1292,-1292,36788524.64999074,3880.5166667667218,-1098,0,29,0.5495568226738499,-3310540750,1575.3421962464986,1395.371276281816,179.97091996468248,0.7709146531984647,0.7713873810395739,-1098
527,2018-06-12,2018,214695,214695,338269220.31666636,3279154.2166666635,165443,0,129,0.8972542443932088,30707420,3728861867,219582,219582,426660,646242,301702074.8333519,3280406.4666664787,168331,0,94,0.34678340312142664,3342457664,-4887,-4887,36567145.483314455,-1252.2499998151325,-2888,0,35,0.5504708412717821,-3311750244,1575.5803363686455,1373.9836363333602,201.59670003528527,0.7705954959360954,0.7665974442349555,-2888
528,2018-06-13,2018,210361,210361,338625745.7499998,3235892.600000002,163432,0,133,0.8941058466160562,30369490,3732526803,211817,211817,444328,656145,301536972.76667464,3233663.3166665416,164282,0,90,0.32407470909631325,3339688973,-1456,-1456,37088772.98332518,2229.2833334603347,-850,0,43,0.5700311375197429,-3309319483,1609.7363377717345,1423.573050164409,186.1632876073254,0.776912070203127,0.7755845848066963,-850
529,2018-06-14,2018,209899,209899,338623976.533333,3230134.383333331,162391,0,128,0.9272507253488593,29599817,3733735805,211465,211465,454251,665716,301648595.78334224,3230389.9666665397,163560,0,101,0.34864717086565805,3337580064,-1566,-1566,36975380.74999076,-255.58333320869133,-1169,0,27,0.5786035544832013,-3307980247,1613.2710328935964,1426.4705543865048,186.8004785070916,0.7736625710460745,0.7734613292979926,-1169
530,2018-06-15,2018,212509,212509,338778765.55000013,3248974.6333333403,164652,0,126,0.9120225496331915,30706095,3735904949,213599,213599,465293,678892,302005564.16667837,3244257.5833332073,165611,0,89,0.32356251067916436,3342352807,-1090,-1090,36773201.38332176,4717.050000132993,-959,0,37,0.5884600389540271,-3311646712,1594.1854959084092,1413.890346708919,180.2951491994902,0.7748001261123059,0.7753360268540583,-959
531,2018-06-16,2018,212667,212667,339155236.74999964,3271740.833333332,165335,0,121,0.9263449430330047,30559121,3739806456,214123,214123,476878,691001,302531214.48334205,3267186.266666504,166627,0,87,0.3418041363181801,3349336262,-1456,-1456,36624022.26665759,4554.566666828003,-1292,0,34,0.5845408067148247,-3318777141,1594.7713408756397,1412.885185072795,181.88615580284477,0.777436085523377,0.7781835673888372,-1292
532,2018-06-17,2018,215340,215340,339488379.8666668,3258246.899999998,165507,0,135,0.9315268877124547,31291638,3743685000,216901,216901,486345,703246,303001427.2666745,3252806.216666552,167028,0,86,0.35387759048753265,3360667963,-1561,-1561,36486952.599992275,5440.683333446272,-1521,0,49,0.5776492972249221,-3329376325,1576.5226147797289,1396.957262837306,179.56535194242292,0.7685845639453887,0.7700656059676996,-1521
533,2018-06-18,2018,210278,210278,339871412.3500001,3253317.3999999966,162810,0,132,0.9358325645098393,31363350,3748584358,211811,211811,502277,714088,303555982.416671,3248585.5833326504,164220,0,91,0.3407283135972065,3369339255,-1533,-1533,36315429.933329105,4731.816667346284,-1410,0,41,0.5951042509126327,-3337975905,1616.2956293573275,1433.1455043254173,183.1501250319102,0.774260740543471,0.7753138411130678,-1410
534,2018-06-19,2018,212851,212851,340229008.6333333,3279004.1666666633,165422,0,136,0.9435473641185623,31202382,3751467247,214473,214473,510592,725065,304136327.5833347,3274035.116666476,166729,0,96,0.33203505892575014,3372913618,-1622,-1622,36092681.04999864,4969.050000187475,-1307,0,40,0.6115123051928122,-3341711236,1598.4374451298481,1418.06347457878,180.37397055106817,0.7771727640462107,0.7773892284809742,-1307
535,2018-06-20,2018,215209,215209,340946516.1000003,3342694.316666667,168414,0,123,0.9448861339442117,31702232,3759024027,216889,216889,519601,736490,304998058.00000477,3336530.133332717,170013,0,82,0.345768442205583,3380121993,-1680,-1680,35948458.09999555,6164.183333949652,-1599,0,41,0.5991176917386287,-3348419761,1584.257703441772,1406.2403256965765,178.01737774519552,0.782560208913196,0.7838710123611617,-1599
536,2018-06-21,2018,215418,215418,341425202.1499995,3334586.3166666646,167771,0,115,0.9333667567241375,30091915,3762907051,217077,217077,528488,745565,305645257.1833268,3328684.9333333075,169257,0,89,0.32886602777759005,3386634917,-1659,-1659,35779944.96667272,5901.383333357051,-1486,0,26,0.6045007289465474,-3356543002,1584.9427724238435,1408.0038750458446,176.93889737799896,0.7788160692235561,0.7797095040008845,-1486
537,2018-06-22,2018,221190,221190,341805827.5666664,3352765.4833333367,170607,0,871,0.9401690854016901,32486790,3767725262,222994,222994,537966,760960,306220996.7999988,3347426.5999999414,172268,0,871,0.3452835891505438,3395794361,-1804,-1804,35584830.766667604,5338.883333395235,-1661,0,0,0.5948854962511463,-3363307571,1545.3041618819404,1373.2252742226194,172.07888765932103,0.7713142547131425,0.7725230275254042,-1661
538,2018-06-23,2018,221717,221717,341978138.8666664,3373432.0666666646,170405,0,225,0.9295182597635729,32618376,3771678226,222575,222575,552054,774629,306492289.48333687,3363022.66666596,171446,0,225,0.31014201637170147,3403755062,-858,-858,35485849.38332951,10409.400000704452,-1041,0,0,0.6193762433918715,-3371136686,1542.4082901476493,1377.0292687109372,165.37902143671204,0.7685698435392866,0.7702841738739751,-1041
539,2018-06-24,2018,221877,221877,342144151.1833338,3348552.6333333333,170954,0,122,0.9162869517795894,33215758,3776283264,223332,223332,562829,786161,306877821.3833306,3343590.949999923,172294,0,92,0.3051003547619375,3412513677,-1455,-1455,35266329.80000323,4961.683333410416,-1340,0,30,0.611186597017652,-3379297919,1542.0442460612583,1374.0880007492458,167.95624531201247,0.7704899561468742,0.7714702774344921,-1340
540,2018-06-25,2018,216129,216129,342243324.54999995,3333949.2166666626,169235,0,634,0.9341735722647118,30572288,3776947698,217449,217449,576798,794247,307161545.43332934,3329574.8833332728,170409,0,634,0.28606718061257896,3418894927,-1320,-1320,35081779.11667061,4374.333333389834,-1174,0,0,0.6481063916521328,-3388322639,1583.514126054347,1412.5682133894813,170.94591266486555,0.7830277288101087,0.7836734130761696,-1174
541,2018-06-26,2018,218873,218873,342141576.1833335,3346104.933333336,169025,0,229,0.8993891434758966,33047499,3778806827,220397,220397,583970,804367,307311993.5000024,3342126.383333142,170119,0,229,0.26954735835756727,3422668257,-1524,-1524,34829582.68333113,3978.5500001939945,-1094,0,0,0.6298417851183293,-3389620758,1563.1968136011913,1394.3565180106916,168.84029559049964,0.772251488306004,0.7718752977581365,-1094
542,2018-06-27,2018,221038,221038,342878897.56666714,3364335.166666668,171200,0,114,0.9215338539074731,32596638,3786813548,222842,222842,594766,817608,308193591.11666274,3360515.9166666805,172623,0,84,0.29785422843220727,3431218460,-1804,-1804,34685306.4500044,3819.249999987427,-1423,0,30,0.6236796254752659,-3398621822,1551.221498415056,1383.013934162603,168.20756425245304,0.7745274568173798,0.7746430206155034,-1423
543,2018-06-28,2018,222206,222206,343529125.48333335,3364600.6333333356,171661,0,111,0.9176349873540768,32582938,3792547328,223969,223969,605715,829684,309001374.00000244,3361681.516666276,172936,0,85,0.2854809783001779,3440416416,-1763,-1763,34527751.483330905,2919.116667059716,-1275,0,26,0.6321540090538988,-3407833478,1545.993922231323,1379.661354919665,166.33256731165807,0.7725308947553171,0.7721425733025553,-1275
544,2018-06-29,2018,222156,222156,343882121.64999956,3368407.71666667,173871,0,103,0.9156718702173239,32241600,3797137114,223575,223575,618001,841576,309494433.7333455,3364009.83333273,175004,0,72,0.2743412359668058,3450455000,-1419,-1419,34387687.91665405,4397.883333940059,-1133,0,31,0.6413306342505181,-3418213400,1547.93083081258,1384.298037496793,163.632793315787,0.7826527305136931,0.7827529911662753,-1133
545,2018-06-30,2018,221451,221451,344063263.2166663,3359731.333333333,172426,0,107,0.8932179127662563,32958590,3801844075,222568,222568,628741,851309,309774525.866663,3355178.4333333243,173450,0,75,0.25938995123980046,3458153374,-1117,-1117,34288737.3500033,4552.900000008754,-1024,0,32,0.6338279615264558,-3425194784,1553.6767195301277,1391.819694954634,161.8570245754936,0.7786191979264036,0.7793123899212825,-1024
546,2018-07-01,2018,218197,218197,344049918.3999998,3316759.3500000015,170109,0,123,0.9084130395926618,33432572,3804560373,219500,219500,273802,493302,309931701.8000065,3312464.016666482,171319,0,82,0.46928453563942035,3445858220,-1303,-1303,34118216.59999329,4295.333333519287,-1210,0,41,0.4391285039532415,-3412425648,1576.7857413254985,1411.9895298405763,164.7962114849222,0.7796120019981942,0.780496583143508,-1210
547,2018-07-02,2018,218378,218378,344309372.8000005,3319999.9833333334,169345,0,107,0.9071609777541696,34184873,3811882943,224696,224696,290712,515408,310253656.7000004,3317319.8833330227,171836,0,82,0.4451677117933788,3455378032,-6318,-6318,34055716.10000008,2680.100000310689,-2491,0,25,0.4619932659607908,-3421193159,1576.6669389773717,1380.7707155445598,195.8962234328119,0.7754673089780106,0.7647488161783031,-2491
548,2018-07-03,2018,221888,221888,344393474.7,3344451.300000005,172376,0,119,0.895041642630517,34035347,3813023871,223643,223643,303715,527358,308139365.0333446,3340272.4999998305,173587,0,80,0.42262372050864366,3418121181,-1755,-1755,36254109.66665536,4178.800000174437,-1211,0,39,0.47241792212187333,-3384085834,1552.105002073118,1377.8180628651226,174.28693920799537,0.7768603980386501,0.776178999566273,-1211
549,2018-07-04,2018,222608,222608,341611900.99999934,3370950.9333333327,172385,0,119,0.907532523539136,34603598,3780138325,229697,229697,314624,544321,305680275.18334144,3382654.0166665176,174736,0,91,0.4342566243080754,3393217021,-7089,-7089,35931625.8166579,-11703.083333184943,-2351,0,28,0.47327589923106067,-3358613423,1534.5895071156442,1330.7978562338274,203.79165088181685,0.7743881621505068,0.7607239101947348,-2351
550,2018-07-05,2018,221219,221219,342152481.7499998,3356708.5999999936,171878,0,128,0.9427128772845007,35154943,3789068482,223113,223112,331821,554934,305802951.13334477,3352066.7166665224,173501,0,89,0.4523060399975487,3393779563,-1894,-1893,36349530.61665505,4641.883333471138,-1623,0,39,0.490406837286952,-3358624620,1546.668603284527,1370.625296413213,176.04330687131414,0.7769585795071852,0.777637340719725,-1623
551,2018-07-06,2018,216713,216713,342043125.0833335,3301330.116666666,169731,0,125,0.9346924273116974,34293909,3791655747,218667,218667,344160,562827,305953341.60000813,3297285.4166665324,171221,0,89,0.42432932322011246,3403980860,-1954,-1954,36089783.48332536,4044.700000133831,-1490,0,36,0.510363104091585,-3369686951,1578.3230589920008,1399.1747341848936,179.1483248071072,0.7832063604859884,0.7830216722230606,-1490
552,2018-07-07,2018,217237,217237,341947906.8833329,3306927.316666662,169911,0,125,0.9293628617592765,33902090,3794985416,220847,220847,357836,578683,305926030.2333478,3304040.033333189,171854,0,85,0.39994262834747235,3412950072,-3610,-3610,36021876.649985135,2887.283333473373,-1943,0,40,0.5294202334118041,-3379047982,1574.0776519807073,1385.2396918832846,188.83796009742264,0.782145767065463,0.7781586347109084,-1943
553,2018-07-08,2018,216126,216126,342257058.6166666,3301295.2333333357,171723,0,116,0.9229939942440989,33564706,3800390906,217417,217417,370474,587891,306082089.00000876,3296587.149999871,172803,0,79,0.38140233478655144,3417862804,-1291,-1291,36174969.61665785,4708.083333464805,-1080,0,37,0.5415916594575474,-3384298098,1583.5996530573213,1407.8112061154775,175.78844694184386,0.7945504011548818,0.7947998546571795,-1080
554,2018-07-09,2018,217535,217535,342657729.0666671,3318728.8666666653,170692,0,125,0.9123221550555081,34502292,3808771764,218779,218779,380341,599120,306659735.6166785,3314085.966666504,171750,0,125,0.3643610628922425,3426371889,-1244,-1244,35997993.4499886,4642.900000161491,-1058,0,0,0.5479610921632656,-3391869597,1575.1843568467928,1401.6872534232193,173.49710342357344,0.7846645367412141,0.7850387834298539,-1058
555,2018-07-10,2018,215272,215272,342824943.0666665,3324737.266666665,169766,0,119,0.9151817235869044,34216651,3814150900,216645,216645,391597,608242,306994618.50001264,3320604.5166664524,170889,0,76,0.36263855504881604,3431706327,-1373,-1373,35830324.56665385,4132.750000212807,-1123,0,43,0.5525431685380884,-3397489676,1592.519896069468,1417.03994322515,175.47995284431795,0.7886116169311382,0.7887973412725888,-1123
556,2018-07-11,2018,215529,215529,343167770.9000006,3326667.816666665,169656,0,109,0.9110050155663502,33081297,3819814165,216504,216504,402490,618994,307492510.95001036,3322038.149999855,170510,0,88,0.358257107500228,3439151511,-975,-975,35675259.94999021,4629.666666809935,-854,0,21,0.5527479080661222,-3406070214,1592.2115859118753,1420.2624937645971,171.94909214727818,0.7871608925017051,0.7875605069652293,-854
557,2018-07-12,2018,221802,221802,343800443.2999998,3361389.050000002,174115,0,113,0.9015112577884784,31078645,3824817624,223100,223100,411743,634843,308337382.55001366,3358325.8499998786,175075,0,73,0.35512087240467227,3446423918,-1298,-1298,35463060.74998611,3063.2000001235865,-960,0,40,0.5463903853838061,-3415345273,1550.0331074561986,1382.0590880771567,167.97401937904192,0.7850019386660174,0.7847377857463022,-960
558,2018-07-13,2018,226899,226899,344385610.21666664,3416231.700000001,177971,0,114,0.9079634551055747,35828842,3833229965,228352,228352,421151,649503,309104195.3833422,3412080.1166665694,179100,0,79,0.36013690467942194,3458721297,-1453,-1453,35281414.83332443,4151.583333431743,-1129,0,35,0.5478265504261528,-3422892455,1517.7925430110606,1353.6303399284534,164.16220308260722,0.7843622052102477,0.7843154428251121,-1129
559,2018-07-14,2018,225275,225275,344840778.68333304,3420498.766666669,176465,0,94,0.8791787814892903,36066782,3841646495,226504,226504,434151,660655,309707532.7333424,3418039.8833331624,177275,0,72,0.3208770084234593,3468840725,-1229,-1229,35133245.94999063,2458.8833335065283,-810,0,22,0.5583017730658311,-3432773943,1530.7547605519167,1367.3380281731995,163.41673237871714,0.783331483742093,0.7826572599159397,-810
560,2018-07-15,2018,222999,222999,345657090.0500001,3391816.3833333333,175140,0,105,0.8996497742142333,36148078,3853624911,224416,224416,446917,671333,310693999.9166749,3388500.949999848,176091,0,76,0.32871019300406223,3485373642,-1417,-1417,34963090.13332516,3315.4333334853873,-951,0,29,0.5709395812101711,-3449225564,1550.038744792578,1384.4556534145288,165.58309137804918,0.7853846878237122,0.7846633038642521,-951
561,2018-07-16,2018,226068,226068,346411202.85000026,3402336.950000002,175649,0,119,0.9187501105861954,36033392,3866916441,227993,227993,462126,690119,311647863.5666779,3399335.44999984,177179,0,82,0.3590105474563067,3502206041,-1925,-1925,34763339.283322334,3001.50000016205,-1530,0,37,0.5597395631298887,-3466172649,1532.3318773554872,1366.91856138863,165.41331596685723,0.7769741847585682,0.7771247362857632,-1530
562,2018-07-17,2018,224565,224565,346891241.2500002,3423072.6833333294,175768,0,113,0.9327544363547317,36139556,3874441202,226835,226835,473978,700813,312249855.2166766,3420023.6666665017,177143,0,87,0.3511592964171659,3508221973,-2270,-2270,34641386.033323586,3049.0166668277234,-1375,0,26,0.5815951399375657,-3472082417,1544.7253189499706,1376.5505994078364,168.1747195421342,0.7827043395008126,0.7809332774924505,-1375
563,2018-07-18,2018,224563,224563,347590634.14999974,3450617.149999998,177192,0,126,0.949359422522855,35963805,3883586894,232714,232714,484299,717013,313152943.6166702,3460092.0499995346,179897,0,85,0.3654215474475309,3519715889,-8151,-8151,34437690.53332955,-9474.899999536574,-2705,0,41,0.5839378750753241,-3483752084,1547.8535384279678,1345.6557990351685,202.19773939279935,0.7890525153297738,0.7730390092559967,-2705
564,2018-07-19,2018,231380,231380,348021747.5666664,3482438.750000003,180236,0,127,0.9488417322154029,35992829,3892716755,233244,233244,497744,730988,312839805.7333297,3476855.4999999823,181920,0,87,0.36740958811908836,3521205122,-1864,-1864,35181941.83333671,5583.250000020489,-1684,0,40,0.5814321440963146,-3485212293,1504.1133527818586,1341.2555338329378,162.8578189489208,0.7789610165096378,0.7799557544888615,-1684
565,2018-07-20,2018,232531,232531,348547074.3999998,3483192.8833333324,182666,0,122,0.9325982342139336,36007579,3899773359,238545,238545,504857,743402,313542845.5666594,3483941.4999999385,184504,0,84,0.3318742752911545,3530963329,-6014,-6014,35004228.83334041,-748.6166666061617,-1838,0,38,0.6007239589227791,-3494955750,1498.9273447411304,1314.3970553424276,184.53028939870273,0.7855554743238536,0.7734557421031671,-1838
566,2018-07-21,2018,224152,224152,348494901.0499996,3434609.1000000034,177180,0,122,0.9215487704771754,34716492,3903493769,225554,225554,524307,749861,313194783.83333033,3429114.999999972,178497,0,72,0.3156585020423785,3533537890,-1402,-1402,35300117.21666926,5494.100000031292,-1317,0,50,0.6058902684347969,-3498821398,1554.7258157411025,1388.5578789705805,166.16793677052192,0.7904457689425033,0.7913714675864759,-1317
567,2018-07-22,2018,219832,219832,348189518.28333336,3349963.999999997,172432,0,237,0.9059509079660834,34519279,3905183349,220890,220890,535577,756467,313074357.0999971,3344730.5833332925,173366,0,237,0.2946143057132698,3546235420,-1058,-1058,35115161.18333626,5233.416666704696,-934,0,0,0.6113366022528135,-3511716141,1583.8891439068623,1417.3315093485314,166.55763455833085,0.7843807998835475,0.7848521888722894,-934
568,2018-07-23,2018,224183,224183,348608673.05,3413332.9666666677,176814,0,300,0.9110191227702367,34334286,3910893271,225241,225241,549230,774471,313684306.40001345,3408071.616665908,177799,0,300,0.2899269307695149,3554852158,-1058,-1058,34924366.649986565,5261.350000759587,-985,0,0,0.6210921920007217,-3520517872,1555.018324538435,1392.6607784551368,162.3575460832983,0.7887038713907835,0.7893722723660435,-985
569,2018-07-24,2018,228091,228091,348884236.24999994,3458647.516666665,180109,0,112,0.925937454787782,35635817,3917145548,229506,229506,553605,783111,314113111.1833298,3454436.8333332874,181302,0,75,0.31307183783652565,3558299173,-1415,-1415,34771125.06667012,4210.6833333778195,-1193,0,37,0.6128656169512563,-3522663356,1529.5835269694987,1368.6487986515813,160.93472831791746,0.7896365924126774,0.789966275391493,-1193
570,2018-07-25,2018,231988,231988,349652505.9833337,3521561.1499999966,183596,0,117,0.9330827456592576,35637196,3925934635,233554,233554,561195,794749,315061355.8666705,3517843.9666660116,184932,0,81,0.32490509582270705,3566823964,-1566,-1566,34591150.11666322,3717.183333985042,-1336,0,36,0.6081776498365505,-3531186768,1507.2008292814012,1348.9871972506164,158.21363203078477,0.7914030036036347,0.7918168817489746,-1336
571,2018-07-26,2018,231059,231059,350329174.3166667,3510405.500000002,182142,0,111,0.9107457402654737,34183709,3932415363,232487,232487,570880,803367,315962975.3333286,3509861.9166666497,183279,0,91,0.28556935995628235,3575664898,-1428,-1428,34366198.98333812,543.583333352115,-1137,0,20,0.6251763803091914,-3541481189,1516.189260390925,1359.0565293256336,157.1327310652914,0.7882921678012975,0.7883408534670756,-1137
572,2018-07-27,2018,232077,232077,350828481.5666661,3511302.650000002,182804,0,120,0.9143258487484768,32994301,3935016759,233259,233258,582033,815292,316511096.98333144,3507511.3833332704,183922,0,93,0.29395725703184067,3578725986,-1182,-1181,34317384.583334684,3791.2666667313315,-1118,0,27,0.6203685917166362,-3545731685,1511.6900061904719,1356.9142193765335,154.77578681393834,0.7876868453142707,0.7884883327117067,-1118
573,2018-07-28,2018,225872,225872,350840549.16666704,3479319.3999999953,178931,0,121,0.9393019055040017,33747107,3938461185,227131,227131,595527,822658,316640305.2166637,3472468.399999977,180063,0,77,0.3010169475043065,3589206523,-1259,-1259,34200243.950003326,6851.000000018161,-1132,0,44,0.6382849579996952,-3555459416,1553.271539485492,1394.0866954165822,159.1848440689098,0.792178756109655,0.792771572352519,-1132
574,2018-07-29,2018,223713,223713,350941345.1666672,3434842.73333333,177831,0,122,0.9274874504387317,32636292,3941366943,225039,225038,607607,832646,316929514.3166618,3429078.9499999853,178984,0,74,0.2760909197906472,3598914333,-1326,-1325,34011830.85000545,5763.783333344851,-1153,0,48,0.6513965306480844,-3566278041,1568.7123464736837,1408.3377665845846,160.3745798890991,0.7949068672808465,0.7953465843698203,-1153
575,2018-07-30,2018,225116,225116,351355343.5666664,3475048.4499999965,180166,0,108,0.9308401002150001,31782551,3945439016,226271,226271,617247,843518,317459843.31667656,3468523.216666192,181212,0,103,0.27929694446355513,3604875290,-1155,-1155,33895500.24998987,6525.233333804645,-1046,0,5,0.651543155751445,-3573092739,1560.7746387047853,1403.0072051507996,157.7674335539857,0.8003251656923541,0.8008626823587645,-1046
576,2018-07-31,2018,231257,231257,351714602.46666676,3510993.399999996,183532,0,152,0.950911756184677,32641171,3948510495,232654,232654,621463,854117,318050210.4333426,3506554.3166661863,184795,0,152,0.30202419574835837,3607097976,-1397,-1397,33664392.03332418,4439.08333380986,-1263,0,0,0.6488875604363187,-3574456805,1520.8819731582903,1367.0524058616768,153.8295672966135,0.7936278685618166,0.7942910932113783,-1263
577,2018-08-01,2018,242043,242043,352115766.8833329,3602122.7166666654,189180,0,247,0.909536735208207,33088847,3950171818,243647,243647,275608,519255,318703107.28334534,3596982.883333182,190616,0,250,0.4855109724509144,3590916203,-1604,-1604,33412659.599987566,5139.8333334834315,-1436,0,-3,0.4240257627572926,-3557827356,1454.7653387345756,1308.0526634161115,146.7126753184641,0.781596658444987,0.7823449498659947,-1436
578,2018-08-02,2018,242172,242172,351631005.05000013,3598296.2166666714,190072,0,209,0.8921303866673267,33976581,3941234867,243387,243387,290119,533506,318249077.20000994,3591228.1999998093,191146,0,209,0.4351122574066625,3589556973,-1215,-1215,33381927.84999019,7068.016666862182,-1074,0,0,0.4570181292606642,-3555580392,1451.9886900632614,1307.5845349176823,144.40415514557913,0.784863650628479,0.7853582976905094,-1074
579,2018-08-03,2018,240844,240844,349701214.20000017,3538929.433333335,188976,0,208,0.9099084884821712,34586776,3917432293,242447,242447,308857,551304,316481851.20001733,3533470.0833332017,190086,0,208,0.4460243350311234,3574846663,-1603,-1603,33219362.999982834,5459.350000133272,-1110,0,0,0.46388415345104783,-3540259887,1451.9822549035898,1305.3650950517736,146.61715985181627,0.7846406802743685,0.7840311490758805,-1110
580,2018-08-04,2018,231470,231470,349347780.8166665,3516502.033333335,184461,0,153,0.9192076727005659,34007432,3916296726,234678,234678,326755,561433,316371452.50001097,3513667.7666665027,185914,0,153,0.42001806092622873,3577838914,-3208,-3208,32976328.316655517,2834.26666683238,-1453,0,0,0.4991896117743372,-3543831482,1509.2572722887048,1348.1086957448545,161.14857654385037,0.7969110467879207,0.7922088990020368,-1453
581,2018-08-05,2018,233076,233076,349164216.5666665,3513954.8500000006,184109,0,91,0.8957679040313027,34039510,3917311578,253519,253519,336136,589655,316016409.93335104,3533764.933333224,191670,0,92,0.389027482171779,3572070341,-20443,-20443,33147806.633315444,-19810.083333223592,-7561,0,-1,0.5067404218595237,-3538030831,1498.070228451949,1246.5196294295538,251.55059902239532,0.7899097290154284,0.7560380089855199,-7561
582,2018-08-06,2018,236228,236228,349115014.1999997,3501230.7833333313,186247,0,107,0.9105059518770006,33998803,3917505536,247443,247443,352133,599576,307197875.9500176,3501623.083333212,190637,0,107,0.41027325977024026,3394455036,-11215,-11215,41917138.24998212,-392.29999988060445,-4390,0,0,0.5002326921067604,-3360456233,1477.873131889529,1241.4894579762513,236.3836739132778,0.7884205089997799,0.7704279369390122,-4390
583,2018-08-07,2018,234070,234070,347562980.46666664,3421123.0833333316,183122,0,111,0.9102405263382741,33337765,3900500230,247919,247919,361476,609395,303049693.4000209,3419595.1666666474,189039,0,68,0.4099426480361704,3327601331,-13849,-13849,44513287.06664574,1527.9166666842066,-5917,0,43,0.5002978783021037,-3294263566,1484.867691146523,1222.373813221338,262.49387792518496,0.782338616653138,0.7625030756013053,-5917
584,2018-08-08,2018,234493,234493,347470378.06666666,3510234.8833333394,184404,0,107,0.9185135590401423,33917895,3898626563,237203,237203,376384,613587,300921298.4166804,3506372.0499999053,185730,0,70,0.3908133646899214,3288474082,-2710,-2710,46549079.64998627,3862.8333334340714,-1326,0,37,0.5277001943502209,-3254556187,1481.7942457415218,1268.6234930278301,213.17075271369163,0.786394476594184,0.7830002150057124,-1326
585,2018-08-09,2018,234296,234296,348005764.7833332,3518681.949999997,184105,0,113,0.9172585106019726,33954395,3905246875,236564,236564,384646,621210,301596210.26667714,3514557.933333177,185456,0,66,0.3821718903430363,3295954129,-2268,-2268,46409554.51665604,4124.016666819807,-1351,0,47,0.5350866202589364,-3261999734,1485.325250039835,1274.9032408425505,210.42200919728452,0.7857795267524841,0.7839569841565073,-1351
586,2018-08-10,2018,236037,236037,347854219.2333333,3513019.633333333,184318,0,115,0.9356372094205568,34160744,3906036085,238398,238398,396885,635283,301704790.5500122,3508967.733333162,186263,0,79,0.42736071955332305,3305507465,-2361,-2361,46149428.68332112,4051.9000001708046,-1945,0,36,0.5082764898672338,-3271346721,1473.727505574691,1265.5508458544625,208.17665972022837,0.7808860475264471,0.7813110848245371,-1945
587,2018-08-11,2018,237669,237669,347601208.5166669,3539064.0166666666,186777,0,108,0.9331675565597527,34926184,3906048648,239326,239326,412161,651487,301765939.16667944,3533472.099999343,188261,0,76,0.38910523157023597,3314338210,-1657,-1657,45835269.34998745,5591.9166673235595,-1484,0,32,0.5440623249895167,-3279412026,1462.543320822938,1260.8991048472772,201.64421597566093,0.7858702649483105,0.7866299524497965,-1484
588,2018-08-12,2018,227754,227754,347286206.54999965,3464066.0000000005,180101,0,120,0.9613706016140217,33392765,3905158880,230132,230132,424216,654348,301646199.73335034,3458334.0666665444,181899,0,79,0.4071931143672824,3322800537,-2378,-2378,45640006.81664932,5731.933333456051,-1798,0,41,0.5541774872467393,-3289407772,1524.8303281171775,1310.7529580125768,214.07737010460073,0.7907698657323252,0.7904115898701615,-1798
589,2018-08-13,2018,230867,230867,347530340.0333328,3464667.7166666673,182309,0,133,0.9584392745606772,33625834,3909018200,233266,233266,439203,672469,302118098.3833463,3460503.566666557,184090,0,82,0.40023406283412255,3331031308,-2399,-2399,45412241.649986506,4164.150000110269,-1781,0,51,0.5582052117265547,-3297405474,1505.3270499176272,1295.165598001193,210.1614519164341,0.7896711093400096,0.7891848790651016,-1781
590,2018-08-14,2018,231141,231141,347488669.98333365,3469038.299999999,181594,0,122,0.9373196447190237,33680047,3910456990,233138,233138,448266,681404,302316182.48334366,3464402.1999998693,183035,0,79,0.36804744322017896,3331745832,-1997,-1997,45172487.49998999,4636.100000129547,-1441,0,43,0.5692722014988447,-3298065785,1503.3623198970915,1296.7263272540026,206.6359926430889,0.785641664611644,0.7850929492403641,-1441
591,2018-08-15,2018,234893,234893,347666437.33333313,3493511.316666668,184599,0,123,0.9444896186774402,34898491,3914173382,237581,237581,459357,696938,302715003.1500096,3488277.933333213,186285,0,81,0.37397444248984996,3339352652,-2688,-2688,44951434.18332356,5233.38333345484,-1686,0,42,0.5705151761875902,-3304454161,1480.105568634796,1274.1549330544512,205.95063558034485,0.7858854882861558,0.7840904786157142,-1686
592,2018-08-16,2018,234928,234928,347927243.4666663,3513322.199999997,185393,0,131,0.9626694136075731,34060686,3916627719,237808,237808,469881,707689,303267627.58332825,3509052.633333281,187191,0,114,0.38589973844442976,3347177489,-2880,-2880,44659615.883338034,4269.566666715778,-1798,0,17,0.5767696751631433,-3313116803,1480.9952132852034,1275.2625125451132,205.7327007400902,0.7891481645440305,0.7871518199555945,-1798
593,2018-08-17,2018,235781,235781,347839831.4666668,3497577.316666668,186376,0,126,0.9538597257624662,33923440,3917398354,237453,237453,484137,721590,303502603.1333472,3491358.283332739,187816,0,124,0.3488615418728096,3353757286,-1672,-1672,44337228.333319604,6219.03333392879,-1440,0,2,0.6049981838896566,-3319833846,1475.2665883454004,1278.1586382709304,197.10795007446995,0.7904623358116218,0.7909607374933144,-1440
594,2018-08-18,2018,236010,236010,347665110.4999996,3521349.2499999963,186671,0,135,0.9617304351510526,35155729,3917722443,237793,237793,495856,733649,303487747.7833292,3515978.4666666267,188272,0,114,0.3591254128336583,3361201830,-1783,-1783,44177362.716670394,5370.783333369531,-1601,0,21,0.6026050223173943,-3326046101,1473.0948286089554,1276.2686360966436,196.82619251231176,0.7909452989280116,0.7917474442056747,-1601
595,2018-08-19,2018,230009,230009,347867722.43333364,3484903.0000000037,182671,0,128,0.9480150776708738,34692334,3918839415,231513,231513,506757,738270,303905707.2166653,3479212.366666631,184021,0,86,0.33301773064055346,3371821583,-1504,-1504,43962015.21666831,5690.6333333728835,-1350,0,42,0.6149973470303203,-3337129249,1512.4091771771264,1312.6939187720143,199.71525840511208,0.7941906621045264,0.7948624915231542,-1350
596,2018-08-20,2018,235883,235883,348365322.3499997,3537443.9833333385,186105,0,169,0.9109770521826503,34930262,3924714467,237310,237309,517743,755053,304666376.8833461,3533127.0333327237,187135,0,169,0.30159604690001135,3381373629,-1427,-1426,43698945.466653645,4316.950000614859,-1030,0,0,0.6093810052826389,-3346443367,1476.8564175883796,1283.8382736573249,193.01814393105474,0.7889716511999593,0.788567696262273,-1030
597,2018-08-21,2018,244839,244839,349094797.13333315,3629750.900000002,194940,0,116,0.9126732260791782,36123540,3933544656,246670,246670,520680,767350,305576587.14999723,3629396.133333276,196129,0,108,0.31306704893464615,3385161366,-1831,-1831,43518209.98333591,354.76666672574356,-1189,0,8,0.599606177144532,-3349037826,1425.8136862727472,1238.8072613207817,187.00642495196553,0.7961966843517577,0.7951068228807718,-1189
598,2018-08-22,2018,240868,240868,349696798.10000026,3631789.0333333346,190795,0,143,0.9007838318082922,35944663,3942486495,243307,243307,530015,773322,306354067.6666621,3630412.116666591,191869,0,144,0.29476466465456547,3396586131,-2439,-2439,43342730.433338165,1376.9166667438112,-1074,0,-1,0.6060191671537267,-3360641468,1451.8192458109847,1259.1255807135105,192.6936650974742,0.792114353089659,0.7885880800798991,-1074
599,2018-08-23,2018,246004,246004,350452020.8166664,3591784.3666666634,192162,0,76,0.8874002048747174,36238211,3953121898,247612,247612,543708,791320,307313354.35000736,3588379.0166660706,193182,0,71,0.289550371531103,3409486537,-1608,-1608,43138666.46665907,3405.35000059288,-1020,0,5,0.5978498333436144,-3373248326,1424.5785467580463,1241.108485655006,183.47006110304028,0.7811336401034129,0.7801802820541816,-1020
600,2018-08-24,2018,238090,238090,350847810.1666666,3538075.2666666657,187044,0,69,0.8722079885757483,35586734,3961859163,239285,239285,562055,801340,307867124.3833256,3532978.5999999996,187815,0,58,0.2664162527765964,3416754629,-1195,-1195,42980685.78334105,5096.666666666046,-771,0,11,0.6057917357991519,-3381167895,1473.5932217508785,1286.6127186548492,186.98050309602922,0.7856020832458314,0.7849008504502999,-771
601,2018-08-25,2018,242928,242928,350542229.44999987,3602799.0166666657,189314,0,194,0.877391655140617,36595225,3962332711,244152,244152,571241,815393,307875452.28332806,3597208.083333277,190262,0,194,0.271527962589821,3428456920,-1224,-1224,42666777.16667181,5590.93333338853,-948,0,0,0.6058636925507961,-3391861695,1442.988167070078,1260.9991000824407,181.98906698763722,0.7793008628070869,0.7792768439332874,-948
602,2018-08-26,2018,237619,237619,350813637.19999987,3570985.916666664,186907,0,81,0.8792436631750828,36298585,3966701922,238442,238442,582324,820766,308411540.96666527,3564840.8666666453,187652,0,82,0.2609635389380227,3439773169,-823,-823,42402096.2333346,6145.050000018906,-745,0,-1,0.6182801242370601,-3403474584,1476.3703121383385,1293.4446992000792,182.9256129382593,0.7865827227620686,0.7869922245242029,-745
603,2018-08-27,2018,236352,236352,351329783.84999985,3556563.9500000044,185483,0,89,0.876967404549147,36381119,3975687776,239749,239749,596246,835995,309173239.0833432,3553364.549999433,186851,0,73,0.25781733144336233,3452232562,-3397,-3397,42156544.76665664,3199.4000005712733,-1368,0,16,0.6191500731057846,-3415851443,1486.4684193491057,1289.5705053340919,196.89791401501384,0.7847744042783644,0.7793609149568924,-1368
604,2018-08-28,2018,237606,237606,351963879.05000013,3565719.749999999,187015,0,72,0.8768507529271153,35783192,3983501697,251103,251103,606279,857382,309119221.8166593,3567626.416666683,192588,0,61,0.2547569228185368,3444425321,-13497,-13497,42844657.23334086,-1906.666666683741,-5573,0,11,0.6220938301085785,-3408642129,1481.2920509162232,1231.0455144568534,250.24653645936974,0.7870802925852041,0.7669681365814028,-5573
605,2018-08-29,2018,239147,239147,352425085.8666668,3558264.3833333342,186942,0,128,0.8680393230941643,36194004,3990902371,257332,257331,616000,873332,307823214.19999325,3562500.283333314,193984,0,128,0.2512664141472014,3415322383,-18185,-18184,44601871.66667354,-4235.899999979883,-7042,0,0,0.6167729089469629,-3379128379,1473.675546281855,1196.2150467685326,277.4604995133225,0.7817033038256804,0.7538277400401039,-7042
606,2018-08-30,2018,236551,236551,353079174.2333337,3569458.2333333325,187083,0,86,0.8900237158160408,36239642,4000420429,237460,237460,630954,868414,306655405.0333307,3564440.149999957,187834,0,78,0.25048767062714505,3396572559,-909,-909,46423769.20000303,5018.083333375398,-751,0,8,0.6395360451888957,-3360332917,1492.6133232720797,1291.3981514079453,201.2151718641344,0.7908780770320143,0.7910132232797102,-751
607,2018-08-31,2018,250946,250946,353611100.73333305,3664234.0500000003,197033,0,92,0.8869358348011129,36238140,4005637887,252011,252011,636282,888293,307437925.8166611,3658833.0333332745,198037,0,58,0.25993675510220293,3409185015,-1065,-1065,46173174.91667193,5401.016666725744,-1004,0,34,0.62699907969891,-3372946875,1409.1123219072351,1219.9385178292262,189.17380407800897,0.7851609509615615,0.7858268091472198,-1004
608,2018-09-01,2018,253065,253065,353658824.6166667,3696508.7499999986,196968,0,75,0.8781656886570649,37310278,4007685955,254409,254409,299377,553786,307729893.3166778,3690557.133333181,198213,0,73,0.4160903309220598,3392824940,-1344,-1344,45928931.299988866,5951.616666817572,-1245,0,2,0.4620753577350051,-3355514662,1397.5019248677877,1209.5872917887252,187.91463307906247,0.7783296781459309,0.7791115880334422,-1245
609,2018-09-02,2018,242267,242267,353707969.3333335,3622905.0666666655,191685,0,80,0.8826212402019262,34796306,4004663393,243309,243308,319442,562751,307995948.8000108,3617937.233333163,192723,0,61,0.3921201383915872,3401748835,-1042,-1041,45712020.53332269,4967.833333502524,-1038,0,19,0.490501101810339,-3366952529,1459.9923610451835,1265.868564946532,194.1237960986516,0.7912138260679333,0.7920915379209154,-1038
610,2018-09-03,2018,248522,248522,354503994.10000014,3703187.116666664,195365,0,192,0.8864969700871556,35789097,4014052564,250130,250130,334026,584156,309019846.7500101,3700712.3333331873,196335,0,192,0.3881788426379355,3414866783,-1608,-1608,45484147.34999007,2474.783333476633,-970,0,0,0.49831812744922005,-3379077686,1426.4491437377783,1235.436959780954,191.01218395682417,0.7861074673469552,0.7849318354455683,-970
611,2018-09-04,2018,248941,248941,355098763.0166662,3724366.4000000013,196846,0,165,0.8913115959203183,36690236,4023057138,251086,251086,342363,593449,309844439.48334205,3720137.433333186,197945,0,168,0.38353422113779234,3420365521,-2145,-2145,45254323.53332412,4228.966666815337,-1099,0,-3,0.5077773747825259,-3383675285,1426.4374410670246,1234.0171872718593,192.4202537951653,0.7907335473063899,0.7883553842109875,-1099
612,2018-09-05,2018,251993,251993,355808667.63333344,3758300.5499999956,198323,0,96,0.9035568448329918,35632711,4030728611,254149,254149,352520,606669,310707878.8166745,3753519.049999849,199428,0,85,0.3878622444858734,3430016943,-2156,-2156,45100788.81665897,4781.500000146683,-1105,0,11,0.5156946003471183,-3394384232,1411.9783788967688,1222.542204835252,189.4361740615168,0.7870178933541805,0.7846892964363424,-1105
613,2018-09-06,2018,245760,245760,356084563.2000004,3660755.95,194319,0,74,0.8958943684895831,34099865,4033132133,246871,246871,366984,613855,311279604.91668236,3655102.1833331664,195270,0,62,0.36874669099380286,3443374630,-1111,-1111,44804958.28331804,5653.766666833777,-951,0,12,0.5271476774957803,-3409274765,1448.9117968750018,1260.899842090332,188.0119547846698,0.79068603515625,0.7909799044845284,-951
614,2018-09-07,2018,244498,244498,355791259.2999998,3598678.4833333343,194278,0,94,0.8951606966110142,35226610,4034308306,245617,245617,382988,628605,311267550.38334846,3593073.1666665617,195175,0,68,0.3564448262422336,3456030057,-1119,-1119,44523708.91665131,5605.316666772589,-897,0,26,0.5387158703687805,-3420803447,1455.1908780439912,1267.2883000091545,187.90257803483678,0.7945995468265589,0.794631479091431,-897
615,2018-09-08,2018,235705,235705,355178859.8166662,3579986.949999999,188203,0,219,0.8998748435544422,35361025,4034257308,236934,236934,397031,633965,310915693.4666792,3576560.3833331494,189132,0,219,0.34581404336201416,3465264006,-1229,-1229,44263166.34998697,3426.566666849423,-929,0,0,0.5540608001924281,-3429902981,1506.8787671736543,1312.2459987451325,194.63276842852179,0.7984684245136929,0.7982476132593886,-929
616,2018-09-09,2018,235090,235090,355136157.6166668,3555702.950000004,186557,0,184,0.8867540091028965,34780021,4036114634,236017,236017,407702,643719,311112878.6000113,3550542.8833331466,187333,0,184,0.32919177467186256,3474925304,-927,-927,44023279.016655505,5160.066666857339,-776,0,0,0.5575622344310339,-3440145283,1510.6391493328802,1318.1799556812064,192.4591936516738,0.7935556595346464,0.7937267230750328,-776
617,2018-09-10,2018,240261,240261,355295399.70000005,3591461.083333332,187861,0,71,0.8774707505587672,35479179,4037850188,241460,241459,419930,661390,311492666.5666779,3586633.6166664683,188818,0,56,0.32776727800541283,3484073731,-1199,-1198,43802733.13332212,4827.466666863766,-957,0,15,0.5497034725533544,-3448594552,1478.7893153695359,1290.0437199138485,188.7455954556874,0.7819038462338873,0.7819845937215274,-957
618,2018-09-11,2018,244569,244569,355552476.6499998,3641946.600000002,192887,0,70,0.8940748827529241,36282147,4041992651,246523,246523,428817,675340,311978808.45001054,3636066.9333331822,194052,0,50,0.3389803654455483,3487878535,-1954,-1954,43573668.19998926,5879.666666819714,-1165,0,20,0.5550945173073758,-3451596388,1453.7920858735154,1265.5160307557937,188.27605511772163,0.7886813128401392,0.7871557623426617,-1165
619,2018-09-12,2018,244858,244858,355894975.3833335,3676161.766666669,191731,0,87,0.887253020117783,36027680,4046970563,246251,246251,439285,685536,312549193.9500108,3670689.6166665135,192732,0,52,0.32838538019884883,3494456875,-1393,-1393,43345781.43332273,5472.150000155438,-1001,0,35,0.5588676399189341,-3458429195,1453.4749748153358,1269.230151146638,184.2448236686978,0.7830293476218869,0.7826648419701849,-1001
620,2018-09-13,2018,245168,245168,356055879.5333333,3686262.516666667,192489,0,79,0.8944519676303606,35661132,4046954693,246406,246406,449642,696048,313072237.8166613,3680025.933333328,193485,0,78,0.3248181159919997,3501993995,-1238,-1238,42983641.716672,6236.5833333390765,-996,0,1,0.5696338516383609,-3466332863,1452.293445854815,1270.5544419237408,181.7390039310742,0.7851310122038765,0.7852284441125622,-996
621,2018-09-14,2018,242427,242427,356298018.36666703,3623577.050000001,191064,0,92,0.8961543062447661,35902536,4051807226,243491,243491,461689,705180,313555385.3833289,3618151.299999928,191983,0,77,0.31942057347060365,3511895373,-1064,-1064,42742632.98333812,5425.750000073109,-919,0,15,0.5767337327741624,-3475992837,1469.712607781588,1287.7493845083757,181.9632232732124,0.7881300350208517,0.788460353770776,-919
622,2018-09-15,2018,231626,231626,355725155.08333325,3528901.533333332,183992,0,195,0.9027742999490561,35456618,4050967802,232793,232793,479703,712496,313169452.11667347,3527395.3499994283,184902,0,195,0.3055638207091657,3522438805,-1167,-1167,42555702.966659784,1506.183333903551,-910,0,0,0.5972104792398905,-3486982187,1535.7738556264549,1345.2700558722704,190.50379975418446,0.7943495117128474,0.7942764602028412,-910
623,2018-09-16,2018,238753,238753,355256262.0000004,3522315.299999999,188921,0,141,0.8944264574685981,34807948,4050800051,252653,252653,489560,742213,312906904.79998916,3563579.716666673,191211,0,131,0.29837930620994313,3533396375,-13900,-13900,42349357.20001125,-41264.41666667396,-2290,0,10,0.5960471512586549,-3498588427,1487.965646504967,1238.4848183080715,249.48082819689557,0.7912822037838269,0.7568127035895081,-2290
624,2018-09-17,2018,250727,250727,355461590.04999965,3659954.5666666664,194574,0,99,0.8923610141707912,36030696,4057856593,255804,255804,506019,761823,308456574.05001193,3659299.983332679,196432,0,69,0.3059542702176094,3486657682,-5077,-5077,47005015.99998772,654.583333987277,-1858,0,30,0.5864067439531817,-3450626986,1417.7236199132908,1205.8317072837483,211.8919126295425,0.7760392777802151,0.7679004237619428,-1858
625,2018-09-18,2018,252447,252447,356020027.0500002,3719921.9333333303,195401,0,103,0.8956573062860728,37110341,4065869826,253919,253919,507461,761380,308156305.78334194,3712929.1833326193,196646,0,103,0.3146300139220851,3455227515,-1472,-1472,47863721.26665825,6992.750000711065,-1245,0,0,0.5810272923639876,-3418117174,1410.276323545141,1213.6008167303034,196.6755068148375,0.7740278157395414,0.7744438186980888,-1245
626,2018-09-19,2018,245077,245077,356478397.8666663,3670170.9499999983,191627,0,206,0.9077514413837278,36601476,4071037770,246355,246354,518176,764531,308886479.98332924,3663934.633333295,192737,0,206,0.30891880119969306,3463584753,-1278,-1277,47591917.88333708,6236.316666703206,-1110,0,0,0.5988326401840347,-3426983277,1454.5567224450533,1253.8318029475033,200.72491949755,0.7819052787491279,0.7823547319924499,-1110
627,2018-09-20,2018,244949,244949,356995644.81666636,3656609.9333333313,192831,0,95,0.9183136081388371,35794435,4077550728,246264,246264,529421,775685,309657137.7999961,3650569.833333267,193997,0,93,0.307856926458552,3475661634,-1315,-1315,47338507.01667029,6040.100000064354,-1166,0,2,0.6104566816802851,-3439867199,1457.428463952359,1257.4194271188485,200.00903683351044,0.787229178318752,0.7877602897703277,-1166
628,2018-09-21,2018,245429,245429,357397727.5166667,3658785.1166666658,194146,0,92,0.9245036242660808,35773946,4081014970,246652,246652,539669,786321,310322238.48332894,3652698.766666579,195310,0,70,0.308374060975098,3486960074,-1223,-1223,47075489.03333777,6086.350000086706,-1164,0,22,0.6161295632909828,-3451186128,1456.21637017902,1258.1379371881394,198.07843299088063,0.7910475127226204,0.7918443799361043,-1164
629,2018-09-22,2018,242858,242858,356907089.4666666,3621280.0999999996,192263,0,105,0.9328002371756345,35977505,4078908813,244089,244089,551376,795465,310137505.0333295,3615051.8333333232,193437,0,105,0.30457153991690866,3493580133,-1231,-1231,46769584.43333709,6228.2666666763835,-1174,0,0,0.6282286972587259,-3457602628,1469.6122403489553,1270.5918948962449,199.02034545271044,0.7916683823468859,0.7924855278197707,-1174
630,2018-09-23,2018,237115,237115,357126082.16666627,3512441.3166666673,187414,0,102,0.9179132488454971,35401415,4082324700,238371,238371,564302,802673,310524981.7999977,3507271.7499999967,188521,0,64,0.2882743034834845,3504435759,-1256,-1256,46601100.36666858,5169.566666670609,-1107,0,38,0.6296389453620126,-3469034344,1506.1302834770734,1302.696140889612,203.43414258746134,0.7903928473525504,0.7908722118042882,-1107
631,2018-09-24,2018,227907,227907,356900118.7666663,3476844.166666667,181692,0,72,0.8998231734874302,34510593,4085778144,228962,228962,582151,811113,310528241.2833321,3472271.1000000034,182540,0,58,0.2611929533862728,3516956603,-1055,-1055,46371877.48333418,4573.066666663624,-848,0,14,0.6386302201011574,-3482446010,1565.9901572424994,1356.2435744068102,209.7465828356892,0.7972199186510287,0.7972501987229322,-848
632,2018-09-25,2018,229691,229691,356997889.09999967,3508171.4333333327,182984,0,82,0.9069097178383131,35083237,4087712193,230948,230948,588912,819860,310903547.13332856,3503453.2833333304,184034,0,61,0.2682336008586882,3525765166,-1257,-1257,46094341.96667111,4718.150000002235,-1050,0,21,0.6386761169796249,-3490681929,1554.2528401199859,1346.2058434510304,208.04699666895544,0.7966528945409267,0.7968633631813222,-1050
633,2018-09-26,2018,234841,234841,357176270.43333334,3565166.716666666,185377,0,79,0.8932809858585177,36273250,4092299149,235996,235996,596514,832510,311357525.68333066,3558503.0833327738,186367,0,64,0.26456378902356126,3533835949,-1155,-1155,45818744.75000268,6663.633333892096,-990,0,15,0.6287171968349564,-3497562699,1520.9280765851506,1319.3339110973518,201.59416548779882,0.7893723838682343,0.7897040627807251,-990
634,2018-09-27,2018,239992,239992,357541074.5999998,3607315.76666667,188250,0,74,0.8752583419447306,36624856,4096875406,241185,241185,604267,845452,311972050.550014,3601840.999999388,189156,0,61,0.25366431210760665,3542402470,-1193,-1193,45569024.04998577,5474.766667281743,-906,0,13,0.621594029837124,-3505777614,1489.8041376379203,1293.4969029998301,196.30723463809022,0.7844011467048901,0.7842776292057964,-906
635,2018-09-28,2018,241837,241837,357930885.4166668,3631065.6833333303,190653,0,72,0.8928865310105563,36688364,4102252711,243106,243106,614892,857998,312637961.0833288,3629087.2666666675,191797,0,64,0.26013463900849,3549825634,-1269,-1269,45292924.33333802,1978.4166666627862,-1144,0,8,0.6327518920020663,-3513137270,1480.050138798723,1286.0149938024103,194.03514499631274,0.7883533123550159,0.7889439174681003,-1144
636,2018-09-29,2018,246684,246684,358157413.6499997,3668212.099999992,194339,0,74,0.8963248528481786,36543516,4105659587,247744,247744,623346,871090,313126041.6166605,3661222.0333332904,195268,0,59,0.26258480753997704,3559505685,-1060,-1060,45031372.0333392,6990.066666701809,-929,0,15,0.6337400453082016,-3522962169,1451.8874902709526,1263.9096874865202,187.97780278443247,0.7878054515088129,0.7881845776285198,-929
637,2018-09-30,2018,246011,246011,357740707.66666675,3583190.0833333293,195817,0,75,0.911418595103471,35654106,4105040098,257567,257567,635694,893261,312955575.3833321,3583491.049999949,201385,0,64,0.27121412442724385,3571200326,-11556,-11556,44785132.28333467,-300.96666661975905,-5568,0,11,0.6402044706762271,-3535546220,1454.1654953098307,1215.0453100875968,239.12018522223389,0.7959684729544614,0.7818742307826702,-5568
638,2018-10-01,2018,241099,241099,357608740.7999999,3578770.5000000014,191141,0,90,0.8957731056536943,35246021,4106444272,244577,244577,317136,561713,310071018.2500142,3573228.6333331764,192988,0,64,0.40073845540338043,3492980464,-3478,-3478,47537722.54998571,5541.866666825023,-1847,0,26,0.49503465025031385,-3457734443,1483.2443967001102,1267.7848622315842,215.45953446852604,0.7927905134405369,0.7890684733233296,-1847
639,2018-10-02,2018,238889,238889,357786823.8666668,3628571.883333338,189026,0,74,0.8999158605042507,35538402,4109053807,246451,246451,321412,567863,310235490.43333334,3635666.7499998016,191888,0,54,0.39894481591511466,3490378016,-7562,-7562,47551333.43333346,-7094.866666463669,-2862,0,20,0.500971044589136,-3454839614,1497.7115893434473,1258.8120577045065,238.89953163894074,0.7912712598738326,0.7786050776827849,-2862
640,2018-10-03,2018,248486,248486,358265806.05,3679436.1500000013,197328,0,83,0.899024492325523,35446381,4112738829,249920,249920,334949,584869,310003195.0500101,3673541.4333331627,198445,0,56,0.3991885362363083,3486488512,-1434,-1434,48262610.99998993,5894.71666683862,-1117,0,27,0.49983595608921466,-3451042131,1441.794733103676,1240.4097113076589,201.3850217960171,0.7941211979749362,0.7940340909090909,-1117
641,2018-10-04,2018,248072,248072,357960383.46666676,3674326.9999999963,195904,0,76,0.899291334773775,36395174,4112935700,249041,249041,342097,591138,310084843.6000129,3668470.0499998317,196759,0,59,0.39203197899642833,3495829210,-969,-969,47875539.86665386,5856.950000164565,-855,0,17,0.5072593557773466,-3459434036,1442.9697163189185,1245.1156379873712,197.85407833154727,0.7897062143248734,0.7900666958452625,-855
642,2018-10-05,2018,246424,246424,357981126.4166665,3650918.5333333304,195568,0,81,0.9035199493555819,35937759,4115889028,247473,247473,356186,603659,310471877.9500138,3645293.4666665196,196347,0,64,0.3811340508465864,3502699500,-1049,-1049,47509248.46665269,5625.066666810773,-779,0,17,0.5223858985089955,-3466761741,1452.7039834458758,1254.5686921402084,198.13529130566735,0.7936239976625653,0.7934077656956516,-779
643,2018-10-06,2018,248466,248466,357703306.28333384,3556602.5666666673,198491,0,67,0.8919369249716267,34674968,4117010745,249940,249940,369302,619242,310473134.13334703,3551023.1999998586,199391,0,54,0.3655226874146095,3511799732,-1474,-1474,47230172.1499868,5579.366666808724,-900,0,13,0.5264142375570171,-3477124764,1439.646898502547,1242.1906622923384,197.45623621020854,0.7988658407991436,0.7977554613107146,-900
644,2018-10-07,2018,235529,235529,357493506.84999967,3501770.516666665,185611,0,62,0.8826726220550332,34304005,4117476559,236540,236540,384941,621481,310418652.08334005,3495998.466666514,186440,0,48,0.34256719030830873,3519822836,-1011,-1011,47074854.76665962,5772.050000151154,-829,0,14,0.5401054317467244,-3485518831,1517.832228090807,1312.3304814548915,205.50174663591542,0.7880600690360847,0.7881964995349624,-829
645,2018-10-08,2018,237043,237043,358018792.3333336,3552172.666666669,186706,0,63,0.885729593364917,34060229,4124670054,238037,238036,395087,633124,311174895.2999996,3547062.183332735,187514,0,51,0.3390868139574636,3530378755,-994,-993,46843897.03333402,5110.483333933633,-808,0,12,0.5466427794074533,-3496318526,1510.3537853188393,1307.2598064998554,203.09397881898394,0.7876461232772113,0.7877514840129896,-808
646,2018-10-09,2018,239297,239297,358106873.18333334,3545608.2333333367,187878,0,80,0.8939769407890624,34253829,4125625176,240301,240301,402724,643025,311583037.81667805,3539793.766666471,188752,0,60,0.342775164262662,3535845471,-1004,-1004,46523835.36665529,5814.466666865628,-874,0,20,0.5512017765264003,-3501591642,1496.4954562043542,1296.6364593433987,199.85899686095559,0.7851247612799157,0.7854815418995343,-874
647,2018-10-10,2018,238200,238200,358289483.90000033,3500246.533333338,186565,0,85,0.8826238455079761,33377286,4128548546,239371,239371,414948,654319,311994612.7500153,3496172.1999993552,187324,0,61,0.3296450202424187,3542083827,-1171,-1171,46294871.149985015,4074.3333339826204,-759,0,24,0.5529788252655574,-3508706541,1504.1540046179696,1303.393530335819,200.76047428215065,0.7832283795130143,0.7825676460389939,-759
648,2018-10-11,2018,233066,233066,358477595.94999975,3509931.0999999973,183740,0,82,0.891193910737731,34437862,4132833082,234178,234178,428476,662654,312318930.66667855,3505200.7666665213,184698,0,74,0.3261068370522184,3549176398,-1112,-1112,46158665.2833212,4730.333333475981,-958,0,8,0.5650870736855127,-3514738536,1538.094771223601,1333.6817748323008,204.4129963913001,0.7883603786052019,0.7887077351416444,-958
649,2018-10-12,2018,235703,235703,358673620.33333343,3538515.466666664,186096,0,86,0.9021734980038444,34540123,4135314962,237013,237013,439423,676436,312792815.1000078,3534288.3833332,187221,0,65,0.3312804167726088,3555693746,-1310,-1310,45880805.23332566,4227.083333463874,-1125,0,21,0.5708930812312356,-3521153623,1521.7185200584356,1319.7285174231276,201.99000263530797,0.789535983844075,0.7899186964428112,-1125
650,2018-10-13,2018,236702,236702,358844433.7666667,3562533.3333333354,187899,0,77,0.9028567565969032,35797335,4138656412,237704,237704,448341,686045,313254623.5500129,3557217.233333169,188722,0,65,0.3212908774205726,3565856617,-1002,-1002,45589810.216653824,5316.100000166334,-823,0,12,0.5815658791763306,-3530059282,1516.017751293469,1317.834885193404,198.18286610006498,0.7938209225101605,0.7939369972739205,-823
651,2018-10-14,2018,237992,237992,358917422.70000005,3565056.416666669,187991,0,82,0.8953284144004847,35452331,4140200607,239117,239117,457922,697039,313600358.6999982,3559132.4499994004,189036,0,62,0.3173294464154911,3578523007,-1125,-1125,45317064.00000185,5923.966667268425,-1045,0,20,0.5779989679849936,-3543070676,1508.1070905744732,1311.4933639180745,196.61372665639874,0.7899047026790816,0.7905585968375314,-1045
652,2018-10-15,2018,242090,242090,359399981.28333324,3601989.983333328,190434,0,98,0.9046511627906987,36356411,4147818960,243577,243577,469584,713161,314263317.7000073,3595947.133332705,191752,0,66,0.3237585902762555,3593396381,-1487,-1487,45136663.58332592,6042.850000622682,-1318,0,32,0.5808925725144432,-3557039970,1484.571776130089,1290.201117921673,194.370658208416,0.7866248089553471,0.7872336058002193,-1318
653,2018-10-16,2018,237370,237370,359420325.5,3549972.549999999,188387,0,88,0.9058305598854118,35525349,4151277140,254556,254556,477503,732059,314565363.3333243,3582570.0500000073,193957,0,64,0.31332037445068767,3597840315,-17186,-17186,44854962.16667569,-32597.500000008382,-5570,0,24,0.5925101854347241,-3562314966,1514.177551923158,1235.741303812616,278.436248110542,0.7936428360786957,0.761942362387844,-5570
654,2018-10-17,2018,233558,233558,358908388.61666703,3502178.0833333344,184551,0,88,0.8899374031289868,34830829,4150303730,234561,234561,500111,734672,309354205.7833303,3496593.1333333347,185389,0,58,0.29642752139729733,3518893778,-1003,-1003,49554182.83333671,5584.949999999721,-838,0,30,0.5935098817316895,-3484062949,1536.6991865689338,1318.8646270408565,217.8345595280773,0.790172034355492,0.79036583234212,-838
655,2018-10-18,2018,233365,233365,358955956.6166665,3501430.6666666633,186285,0,83,0.914653011377028,34970452,4152355080,234793,234792,504433,739226,309518679.1666622,3495801.8499999978,187530,0,65,0.31018795334579685,3523480955,-1428,-1427,49437277.45000428,5628.816666665487,-1245,0,18,0.6044650580312312,-3488510503,1538.173919039558,1318.267569451524,219.90634958803412,0.7982559509780816,0.7987035388618912,-1245
656,2018-10-19,2018,239640,239640,358890066.66666704,3543970.633333332,188189,0,87,0.9122684026039056,35302764,4151809257,241301,241301,511221,752522,309811428.03332835,3537973.2166666496,189675,0,63,0.31327721980221024,3524144695,-1661,-1661,49078638.63333869,5997.416666682344,-1486,0,24,0.5989911828016954,-3488841931,1497.6217103432944,1283.9210282316624,213.70068211163198,0.7852987815055917,0.7860514461191623,-1486
657,2018-10-20,2018,240285,240285,358948109.8666667,3597686.4500000007,190230,0,125,0.9413945939197207,35877557,4152948933,241936,241936,523134,765070,310211583.29999256,3591713.63333331,191794,0,125,0.3311252565124772,3526279807,-1651,-1651,48736526.56667411,5972.816666690633,-1564,0,0,0.6102693374072434,-3490402250,1493.8431856614716,1282.205142268999,211.63804339247258,0.7916848742118734,0.7927468421400701,-1564
658,2018-10-21,2018,240842,240842,359242369.0500003,3609861.266666664,189514,0,97,0.9329352853738135,36532966,4156132693,242537,242537,530014,772551,310810263.4666615,3603504.6166666327,191097,0,79,0.3262166510689885,3538682118,-1695,-1695,48432105.5833388,6356.650000031106,-1583,0,18,0.606718634304825,-3502149152,1491.6101388046948,1281.496280842352,210.11385796234276,0.7868810257347141,0.7879086489896387,-1583
659,2018-10-22,2018,239334,239334,359758117.1500002,3591206.5333333355,189016,0,86,0.9177759950529385,36269683,4163636741,240856,240856,542176,783032,311508517.43332756,3584551.1166666285,190309,0,70,0.30069013782323256,3551849716,-1522,-1522,48249599.71667266,6655.416666707024,-1293,0,16,0.617085857229706,-3515580033,1503.1634333191282,1293.3392459948166,209.82418732431165,0.7897582457987582,0.7901360148802604,-1293
660,2018-10-23,2018,238440,238440,359789729.3499999,3566445.483333332,188470,0,85,0.8934490857238723,36471492,4166419737,239623,239623,551833,791456,311807122.88334894,3560444.883332752,189499,0,67,0.27935981280070327,3557988173,-1183,-1183,47982606.46665096,6000.600000579841,-1029,0,18,0.6140892729231691,-3521516681,1508.9319298355977,1301.240377106325,207.69155272927264,0.7904294581446066,0.790821415306544,-1029
661,2018-10-24,2018,245122,245122,360351787.23333293,3617571.366666666,190653,0,100,0.9060386256639557,36433640,4173197742,246752,246752,559505,806257,312573228.91666245,3611475.6166666225,192100,0,64,0.29775121332279975,3569296830,-1630,-1630,47778558.31667048,6095.750000043772,-1447,0,36,0.6082874123411559,-3532863190,1470.0915757595521,1266.7505386649852,203.3410370945669,0.7777882034252331,0.7785144598625341,-1447
662,2018-10-25,2018,246131,246131,360395056.79999965,3584031.4833333325,193344,0,93,0.9074801630026288,37052056,4175028497,247612,247610,570537,818149,312931385.6166768,3577921.599999433,194700,0,64,0.2891368198213381,3579137025,-1481,-1479,47463671.18332285,6109.883333899546,-1356,0,29,0.6183433431812907,-3542084969,1464.2408181009287,1263.807542573712,200.43327552721667,0.7855329072729563,0.7863108411547098,-1356
663,2018-10-26,2018,232650,232650,359949137.88333386,3465577.933333334,183609,0,91,0.9055791962174936,35978787,4175141369,234010,234010,587342,821352,312779956.966669,3459741.899999483,184799,0,69,0.2704613856178439,3590490795,-1360,-1360,47169180.91666484,5836.0333338510245,-1190,0,22,0.6351178105996498,-3554512008,1547.170160684865,1336.6093627053076,210.5607979795575,0.7892069632495164,0.7897055681381138,-1190
664,2018-10-27,2018,222755,222755,359342134.5166666,3397623.149999997,176456,0,94,0.9124643666808826,35075550,4175920741,224164,224164,605156,829320,312420783.7833403,3392413.0999994962,177669,0,66,0.2622039743404163,3599704858,-1409,-1409,46921350.733326316,5210.050000500865,-1213,0,28,0.6502603923404663,-3564629308,1613.1720253941173,1393.7152432296903,219.45678216442707,0.7921528136293237,0.7925848932031905,-1213
665,2018-10-28,2018,227922,227922,359245257.4833334,3436698.716666667,178333,0,91,0.9052044120356967,35174283,4179653934,229176,229175,613810,842986,312498917.9333314,3431350.699999973,179494,0,73,0.2599307699060241,3612798030,-1254,-1253,46746339.55000204,5348.016666693613,-1161,0,18,0.6452736421296725,-3577623747,1576.176312437296,1363.5820570888245,212.5942553484715,0.7824299541071068,0.7832146472580026,-1161
666,2018-10-29,2018,235437,235437,359809951.4499995,3527125.6333333314,185158,0,100,0.9146353376911872,35705687,4186394977,237344,237344,618734,856078,313333411.28332645,3522088.1666666027,186525,0,77,0.2703328435025798,3622806466,-1907,-1907,46476540.166673064,5037.466666728724,-1367,0,23,0.6443024941886074,-3587100779,1528.2642551935317,1320.1657142515776,208.09854094195407,0.7864439319223402,0.7858846231630039,-1367
667,2018-10-30,2018,229251,229251,359913258.6666666,3498292.0833333293,181249,0,88,0.9301333472918334,35294370,4190323793,232208,232208,627356,859564,313696717.59999645,3494221.2833332755,182800,0,74,0.2741075708149715,3627172748,-2957,-2957,46216541.06667018,4070.8000000538304,-1551,0,14,0.6560257764768619,-3591878378,1569.9528406273762,1350.929845655604,219.02299497177228,0.7906137814011717,0.7872252463308758,-1551
668,2018-10-31,2018,229183,229183,359912409.1166665,3486377.716666668,179783,0,99,0.9271237395443818,34720785,4191392490,231069,231069,638782,869851,313971327.38332796,3482067.1666666493,181218,0,73,0.2735169586515371,3636529397,-1886,-1886,45941081.733338535,4310.550000018906,-1435,0,26,0.6536067808928447,-3601808612,1570.4149483891322,1358.7773668615348,211.63758152759738,0.7844517263496856,0.784259247237838,-1435
669,2018-11-01,2018,229120,229120,359864995.3999997,3482414.9333333345,179344,0,98,0.9107149092178759,34441140,4192252992,230810,230810,298563,529373,314119671.800007,3477088.549999853,180853,0,77,0.4301787208641136,3591542468,-1690,-1690,45745323.59999269,5326.383333481383,-1509,0,21,0.48053618835376233,-3557101328,1570.6398193086577,1360.9448108834408,209.69500842521688,0.7827513966480447,0.7835579047701573,-1509
670,2018-11-02,2018,236986,236986,360259742.816666,3515707.6999999974,183741,0,88,0.8935844311478317,35936572,4198440023,238425,238425,310817,549242,314739387.08334386,3509615.249999842,185102,0,60,0.41663965974925393,3600191146,-1439,-1439,45520355.73332214,6092.4500001552515,-1361,0,28,0.47694477139857777,-3564254574,1520.1731022788942,1320.077118940312,200.0959833385823,0.775324280759201,0.7763531508860229,-1361
671,2018-11-03,2018,243520,243520,360587368.8833338,3562278.51666667,187426,0,95,0.9016959592641268,36606802,4203340345,245576,245576,320500,566076,315246882.6666793,3555175.266666505,189363,0,71,0.44221270642104626,3611017914,-2056,-2056,45340486.21665448,7103.250000164844,-1937,0,24,0.45948325284308056,-3574411112,1480.729997057054,1283.703955869789,197.02604118726504,0.7696534165571617,0.7710973385021338,-1937
672,2018-11-04,2018,234969,234969,361043938.90000033,3489963.216666668,180631,0,79,0.8912835310189844,35509554,4210658228,236810,236810,333617,570427,315828893.4166724,3482984.0666665183,182149,0,64,0.40238452948404896,3623058400,-1841,-1841,45215045.483327925,6979.15000014985,-1518,0,15,0.48889900153493543,-3587548846,1536.5598819418747,1333.6805600129742,202.87932192890048,0.7687439619694513,0.7691778218825218,-1518
673,2018-11-05,2018,233941,233941,361378315.55000013,3488420.6166666667,180944,0,83,0.8876426107437349,35252005,4217729991,235357,235357,349274,584631,316403166.40001047,3481945.1833331445,182235,0,67,0.38399948001388484,3633674490,-1416,-1416,44975149.149989665,6475.4333335221745,-1291,0,16,0.50364313072985,-3598422485,1544.7412618993683,1344.354178545828,200.38708335354022,0.7734599749509492,0.7742918205109685,-1291
674,2018-11-06,2018,234282,234282,361457028.083333,3488037.333333334,181441,0,80,0.8891506816571475,35190114,4221506876,235637,235637,358118,593755,316672960.65001506,3482188.5499998424,182661,0,59,0.37894922990121793,3639074486,-1355,-1355,44784067.43331796,5848.783333491534,-1220,0,21,0.5102014517559296,-3603884372,1542.8288476422986,1343.9016820364163,198.92716560588224,0.7744555706370955,0.7751796194994843,-1220
675,2018-11-07,2018,233457,233457,361554783.73333323,3465407.383333334,181547,0,86,0.8998102434281268,35008329,4223723240,234781,234781,369842,604623,316998229.983345,3459569.099999798,182788,0,65,0.37965145222725616,3650520725,-1324,-1324,44556553.74998826,5838.283333535772,-1241,0,21,0.5201587912008706,-3615512396,1548.6996908781198,1350.1868975059522,198.5127933721676,0.7776464188265934,0.7785468159689243,-1241
676,2018-11-08,2018,227872,227872,361644382.61666685,3402748.6499999966,179426,0,84,0.922144888358376,34254425,4228044837,229425,229425,384244,613669,317251222.0166817,3397397.2999998396,180956,0,66,0.3858529598203626,3659047161,-1553,-1553,44393160.59998518,5351.350000157021,-1530,0,18,0.5362919285380134,-3624792736,1587.0505486267152,1382.8101646145,204.24038401221515,0.7873981884566774,0.7887370600414079,-1530
677,2018-11-09,2018,231854,231854,361450750.4666665,3391079.133333329,181740,0,89,0.9111725482415655,34645261,4228530203,237217,237217,398387,635604,317340246.45002025,3390901.216666526,184328,0,70,0.3710281873619398,3670203240,-5363,-5363,44110504.016646266,177.9166668029502,-2588,0,19,0.5401443608796257,-3635557979,1558.9584413754626,1337.7635095714904,221.19493180397217,0.7838553572506837,0.777043803774603,-2588
678,2018-11-10,2018,226725,226725,361288378.18333393,3387268.6500000097,176031,0,87,0.9125504465762485,34907765,4227837921,228114,228114,411565,639679,316854318.9166826,3382015.24999988,177391,0,68,0.36267409122387756,3666544421,-1389,-1389,44434059.26665133,5253.400000129826,-1360,0,19,0.5498763553523709,-3631636656,1593.5092212298332,1389.0174163649867,204.49180486484647,0.7764075421766458,0.777641880813979,-1360
679,2018-11-11,2018,230842,230842,361336840.683333,3419679.3333333367,179405,0,81,0.9029292763015395,35274774,4228881647,231974,231974,420314,652288,317080108.1333456,3415263.4666664964,180497,0,64,0.347504476550237,3672987841,-1132,-1132,44256732.549987376,4415.866666840389,-1092,0,17,0.5554247997513025,-3637713067,1565.2993852216364,1366.8777886027985,198.42159661883784,0.7771765969797524,0.7780915102554596,-1092
680,2018-11-12,2018,236809,236809,361965330.2833338,3483923.783333337,182963,0,91,0.8975292324193769,35179429,4235469482,250100,250100,425961,676061,317959154.3833553,3536638.633333214,189644,0,72,0.358781234237737,3684273486,-13291,-13291,44006175.89997846,-52714.84999987716,-6681,0,19,0.5387479981816399,-3649094057,1528.511713166872,1271.3280862989018,257.18362686797013,0.7726184393329646,0.7582726909236306,-6681
681,2018-11-13,2018,193753,193753,349277340.50000036,2839155.3999999966,138893,0,48,0.7564269972593972,24129881,4170948898,194418,194418,466631,661049,302531403.7666711,2834981.8166665845,139330,0,35,0.22256897748880813,3631519101,-665,-665,46745936.73332924,4173.583333412185,-437,0,13,0.5338580197705891,-3607389220,1802.6938447404705,1556.0874186889646,246.60642605150588,0.7168559970684325,0.7166517503523336,-437
682,2018-11-14,2018,234212,234212,349550483.1500004,3444253.4833333306,181802,0,75,0.8746904513859248,35135114,4172707423,235137,235137,466481,701618,302454222.3333471,3439900.2166660875,182650,0,64,0.3037393567439825,3607607947,-925,-925,47096260.81665331,4353.266667243093,-848,0,11,0.5709510946419423,-3572472833,1492.4533463272608,1286.2893646399634,206.16398168729734,0.7762283742933752,0.7767811956433909,-848
683,2018-11-15,2018,239672,239672,350188218.216667,3464033.5999999973,185821,0,76,0.8762225040889215,35718418,4177622117,242293,242293,455387,697680,303280438.29999495,3457745.249999946,187236,0,69,0.31736039445017794,3564535687,-2621,-2621,46907779.91667205,6288.350000051316,-1415,0,7,0.5588621096387436,-3528817269,1461.1144322935804,1251.7094521921597,209.40498010142073,0.7753137621415935,0.7727668566570227,-1415
684,2018-11-16,2018,236514,236514,350418868.31666726,3455916.566666662,183440,0,85,0.8751913205983576,35515719,4179925455,240536,240536,468655,709191,303320075.4166603,3454769.9499999597,184848,0,61,0.30082587060467425,3566580787,-4022,-4022,47098792.90000695,1146.6166667025536,-1408,0,24,0.5743654499936833,-3531065068,1481.5988411538735,1261.0173754309556,220.58146572291798,0.7755989074642516,0.7684837196926864,-1408
685,2018-11-17,2018,229897,229897,350586700.9166662,3398930.283333334,179442,0,95,0.8858793285688807,33168310,4181360748,241753,241753,482541,724294,303701711.9333353,3446219.3166661444,183384,0,67,0.2972605047121821,3573960344,-11856,-11856,46884988.983330905,-47289.03333281027,-3942,0,28,0.5886188238566986,-3540792034,1524.9729266439588,1256.24795528219,268.72497136176867,0.7805321513547371,0.7585593560369468,-3942
686,2018-11-18,2018,223493,223493,350747252.06666666,3375585.933333332,174595,0,91,0.8857011181558253,35207310,4184449274,224469,224469,501507,725976,301177225.4333428,3370212.383332731,175499,0,84,0.28053268978588786,3554252961,-976,-976,49570026.63332385,5373.5500006009825,-904,0,7,0.6051684283699375,-3519045651,1569.3880885158223,1341.7319337340248,227.65615478179757,0.7812101497586054,0.7818406996066272,-904
687,2018-11-19,2018,228561,228561,351247277.81666636,3402367.433333328,177939,0,93,0.8747511605216982,35322719,4192682838,230068,230068,507558,737626,301821549.86666226,3397058.7499999385,178762,0,66,0.27891370423493944,3561807662,-1507,-1507,49425727.9500041,5308.683333389461,-823,0,27,0.5958374562867588,-3526484943,1536.776955896528,1311.8797480165092,224.89720788001887,0.7785186449131741,0.7769963662917051,-823
688,2018-11-20,2018,231375,231375,351747474.283333,3407893.1333333324,180635,0,99,0.895593733117235,35185783,4197634476,233412,233412,514064,747476,302588125.64999443,3403232.19999996,181784,0,68,0.29165618695449613,3568181944,-2037,-2037,49159348.63333857,4660.933333372232,-1149,0,31,0.6039375461627389,-3532996161,1520.2484031694564,1296.3691911726664,223.87921199679,0.7807023230686115,0.7788117149075454,-1149
689,2018-11-21,2018,229621,229621,351967367.04999965,3418577.8333333335,178698,0,85,0.9021300316608672,34921600,4200052571,232401,232401,521887,754288,303105260.83332855,3414043.8166666115,179957,0,63,0.29293718049339595,3576964688,-2780,-2780,48862106.21667111,4534.016666722018,-1259,0,22,0.6091928511674713,-3542043088,1532.8187188889503,1304.2338924244239,228.5848264645265,0.7782302141354667,0.7743383204030964,-1259
690,2018-11-22,2018,225167,225167,352166316.21666676,3392714.733333334,177485,0,79,0.8994257595473588,34720181,4206902235,226242,226242,537503,763745,303586415.5166613,3388467.06666665,178460,0,67,0.27743815016792683,3584676796,-1075,-1075,48579900.70000547,4247.666666683741,-975,0,12,0.621987609379432,-3549956615,1564.0227751698374,1341.865858313935,222.1569168559024,0.7882371750745003,0.7888013719822138,-975
691,2018-11-23,2018,225062,225062,352413427.9000006,3379690.9666666607,177371,0,81,0.880730643111676,34115147,4208534749,225894,225894,546064,771958,304143269.34999883,3374430.599999488,178117,0,61,0.261715015583745,3594411673,-832,-832,48270158.55000174,5260.3666671728715,-746,0,20,0.619015627527931,-3560296526,1565.8504229945552,1346.3981750289906,219.45224796556454,0.7880983906656832,0.7884981451477242,-746
692,2018-11-24,2018,225780,225780,352568602.95000064,3380046.733333335,176784,0,94,0.8874169545575337,33571226,4210614914,226785,226785,556838,783623,304604197.11666185,3374751.2166666994,177784,0,77,0.2665490931225797,3604414918,-1005,-1005,47964405.8333388,5295.516666635405,-1000,0,17,0.620867861434954,-3570843692,1561.5581670209967,1343.1408475722021,218.41731944879461,0.7829922933829392,0.7839319178958044,-1000
693,2018-11-25,2018,221762,221762,353093117.2333332,3355571.0499999984,173732,0,79,0.905587972691443,32991395,4215893571,222949,222949,565579,788528,305344382.33332944,3349933.733333338,174833,0,64,0.2743846762575364,3616831075,-1187,-1187,47748734.90000373,5637.316666660365,-1101,0,15,0.6312032964339066,-3583839680,1592.2165079379388,1369.570540048753,222.64596788918584,0.7834164554792976,0.7841838267944687,-1101
694,2018-11-26,2018,226859,226859,353523827.73333335,3299607.900000001,176802,0,93,0.8903019055889348,33695840,4222253517,227944,227944,576795,804739,306079162.64999384,3293835.80000004,177830,0,77,0.26451060530184334,3628514189,-1085,-1085,47444665.08333951,5772.099999960978,-1028,0,16,0.6257913002870915,-3594818349,1558.341647161159,1342.7822739356764,215.55937322548266,0.7793475242331139,0.7801477555890921,-1028
695,2018-11-27,2018,225453,225453,353690423.6166668,3305837.0,174984,0,90,0.8820330623234103,33683659,4222824940,226332,226332,586467,812799,306445507.98333603,3300476.166666181,175853,0,79,0.2535780678864194,3632659918,-879,-879,47244915.63333076,5360.833333819173,-869,0,11,0.6284549944369908,-3598976259,1568.7989231310596,1353.9645652551828,214.83435787587678,0.7761440300195607,0.7769692310411255,-869
696,2018-11-28,2018,230344,230344,354344172.3000003,3413117.3666666667,178970,0,89,0.8937936303962764,34778305,4230016173,231505,231505,592805,824310,307294917.56666225,3407611.7166666277,180054,0,74,0.26387038856741457,3639024733,-1161,-1161,47049254.73333806,5505.650000039022,-1084,0,15,0.6299232418288618,-3604246428,1538.326035407913,1327.3791821630732,210.94685324483976,0.7769683603653665,0.777754260167167,-1084
697,2018-11-29,2018,230324,230324,354804005.5833324,3423469.516666666,178937,0,88,0.8952996648199929,34276418,4234881763,231608,231608,603272,834880,308037009.21667343,3418106.049999562,180035,0,69,0.26345822154082554,3649964967,-1284,-1284,46766996.366658986,5363.466667104047,-1098,0,19,0.6318414432791674,-3615688549,1540.456077453207,1329.9929588644322,210.4631185887747,0.7768925513624286,0.7773263445131429,-1098
698,2018-11-30,2018,230747,230747,355458979.9333332,3425496.433333338,180025,0,84,0.8820526377374353,34722610,4242461766,231936,231936,612460,844396,308808952.58332574,3420675.9333333606,180868,0,66,0.24677876257111447,3660120168,-1189,-1189,46650027.350007474,4820.499999977183,-843,0,18,0.6352738751663207,-3625397558,1540.470645049917,1331.4403653737486,209.03027967616845,0.7801834910096339,0.7798185706401766,-843
699,2018-12-01,2018,224999,224999,355498969.61666673,3403555.050000003,175893,0,88,0.892603967128743,34653840,4244797078,227286,227286,283026,510312,309106500.78334135,3399135.8333331943,177120,0,65,0.4086715577920908,3623724351,-2287,-2287,46392468.833325386,4419.2166668088175,-1227,0,23,0.4839324093366522,-3589070511,1580.0024427515978,1359.9891800785854,220.01326267301238,0.7817501411117382,0.7792824899025896,-1227
700,2018-12-02,2018,226930,226930,355766208.80000037,3401904.1333333375,176653,0,93,0.8955316617459116,34970785,4251033064,229188,229188,296225,525413,309468098.6833429,3397301.016666531,177882,0,74,0.4080066538132824,3634176695,-2258,-2258,46298110.116657495,4603.116666806396,-1229,0,19,0.4875250079326292,-3599205910,1567.735463799411,1350.2805499561184,217.45491384329262,0.778447098224122,0.7761401120477512,-1229
701,2018-12-03,2018,233040,233040,356608832.11666673,3475726.950000002,182165,0,90,0.8953613113628555,35176725,4262470958,235435,235435,307120,542555,310469492.45001006,3470971.0333332173,183442,0,71,0.4044364165844903,3647789256,-2395,-2395,46139339.66665667,4755.916666784789,-1277,0,19,0.49092489477836515,-3612612531,1530.2473056842891,1318.705767834052,211.5415378502371,0.7816898386543083,0.7791619767664111,-1277
702,2018-12-04,2018,228423,228423,356747564.7166668,3430886.566666666,179420,0,127,0.9019056749977012,34665485,4265359147,230589,230589,319684,550273,310873420.5166764,3426355.033333255,180533,0,127,0.39370457936333425,3653453204,-2166,-2166,45874144.19999039,4531.533333410975,-1113,0,0,0.508201095634367,-3618787719,1561.7847796266874,1348.1710771835449,213.61370244314253,0.7854725662477071,0.7829211280676875,-1113
703,2018-12-05,2018,226805,226805,357052343.8999997,3404253.6833333327,178290,0,189,0.8915720552897869,34690746,4270434468,228085,228085,334506,562591,311516674.0000124,3399656.6833331687,179296,0,189,0.3724517455842756,3663305135,-1280,-1280,45535669.89998728,4597.000000163913,-1006,0,0,0.5191203097055113,-3628614389,1574.2701611516486,1365.792024903051,208.4781362485976,0.7860937810013007,0.7860929039612425,-1006
704,2018-12-06,2018,218315,218315,357126925.0333334,3316280.0500000003,171902,0,203,0.8994480452557082,34042705,4275733810,219346,219346,348003,567349,311806992.4166771,3310873.5666665295,172823,0,203,0.3580089151474713,3674887176,-1031,-1031,45319932.6166563,5406.4833334707655,-921,0,0,0.5414391301082369,-3640844471,1635.8331998870137,1421.5303329747392,214.30286691227457,0.7874035224331815,0.7879013066114723,-921
705,2018-12-07,2018,207612,207612,356736006.81666726,3239252.2833333365,163219,0,215,0.895998304529603,33340804,4273285567,208644,208643,365494,574138,311619707.7166801,3234034.1333332295,164066,0,215,0.3368980976699005,3685319532,-1032,-1031,45116299.09998715,5218.150000107009,-847,0,0,0.5591002068597026,-3651978728,1718.2822130544828,1493.5545775160447,224.7276355384381,0.7861732462478084,0.7863442035237055,-847
706,2018-12-08,2018,209198,209198,356265434.79999995,3240062.533333333,163375,0,206,0.8959837092132817,32924491,4270740099,210510,210510,378014,588524,311329397.78334445,3235606.4499998437,164240,0,206,0.3336771312639719,3690671290,-1312,-1312,44936037.016655505,4456.083333489485,-865,0,0,0.5623065779493098,-3657746799,1703.0059312230517,1478.929256488264,224.07667473478773,0.7809587089742732,0.780200465536079,-865
707,2018-12-09,2018,207958,207958,355975820.266667,3246257.816666666,162408,0,225,0.8986189519037507,32519892,4271582188,209667,209667,387019,596686,311452756.16667783,3243480.0333332177,163423,0,225,0.33034125151252114,3699123647,-1709,-1709,44523064.099989176,2777.7833334482275,-1015,0,0,0.5682777003912296,-3666603755,1711.767858253431,1485.4638840002376,226.30397425319347,0.7809653872416545,0.7794407322086928,-1015
708,2018-12-10,2018,217057,217057,356554342.3500001,3323003.433333336,169542,0,224,0.8926641389128196,33390665,4278981783,218003,218003,394915,612918,312262130.0833392,3318202.499999848,170477,0,224,0.3336384312420296,3708466561,-946,-946,44292212.26666087,4800.933333487716,-935,0,0,0.5590257076707901,-3675075896,1642.676082089037,1432.3753805376036,210.30070155143335,0.7810943669174456,0.7819938257730398,-935
709,2018-12-11,2018,211955,211955,356867095.89999986,3280607.8333333335,166300,0,233,0.9005921068151262,33509547,4283917909,212943,212943,402231,615174,312765178.3166803,3275295.049999837,167255,0,233,0.32994892501958906,3710685391,-988,-988,44101917.583319545,5312.783333496656,-955,0,0,0.5706431817955372,-3677175844,1683.692745629968,1468.7741711006247,214.91857452934323,0.7846005048241372,0.785444931272688,-955
710,2018-12-12,2018,217569,217569,357015604.58333355,3281806.183333334,171958,0,236,0.9022838731620776,32236066,4285069867,235317,235317,413467,648784,313184242.0500169,3353374.533333131,177456,0,236,0.3332958272707113,3716269396,-17748,-17748,43831362.53331667,-71568.34999979706,-5498,0,0,0.5689880458913663,-3684033330,1640.9304845052998,1330.9035983376334,310.02688616766636,0.790360759115499,0.7541146623490865,-5498
711,2018-12-13,2018,214384,214384,356939445.61666715,3282473.0999999973,168934,0,135,0.9120969848496158,32775770,4284819204,244322,244322,425890,670212,310347464.8000102,3396545.833333224,178350,0,135,0.3245898312772673,3676391719,-29938,-29938,46591980.81665695,-114072.73333322676,-9416,0,0,0.5875071535723484,-3643615949,1664.9537540892377,1270.2395396239806,394.7142144652571,0.7879972385998956,0.7299792896259854,-9416
712,2018-12-14,2018,215627,215627,356681946.43333393,3285198.616666665,169023,0,173,0.8931163537033856,32032351,4280912008,219013,219013,445186,664199,302072953.4000181,3283329.8166665398,170701,0,173,0.3093063976308297,3553683814,-3386,-3386,54608993.03331584,1868.8000001250766,-1678,0,0,0.5838099560725559,-3521651463,1654.1617999292016,1379.2466812473144,274.9151186818872,0.7838675119535123,0.7794103546364828,-1678
713,2018-12-15,2018,218282,218282,356711850.8666664,3297531.6333333342,169878,0,165,0.8807918197560952,33169105,4279205527,230913,230913,443308,674221,301593479.5500101,3295033.0166665483,174658,0,165,0.30112233229163593,3541243652,-12631,-12631,55118371.31665629,2498.616666785907,-4780,0,0,0.5796694874644592,-3508074547,1634.178955968272,1306.091383118361,328.0875728499111,0.7782501534711979,0.7563801085257218,-4780
714,2018-12-16,2018,214587,214587,356697692.5500002,3292097.900000006,167201,0,168,0.8851281764505768,33010502,4280908115,215452,215452,453020,668472,299041692.26667905,3287324.5166665195,168009,0,168,0.293711628908911,3491388169,-865,-865,57656000.28332114,4773.383333486505,-808,0,0,0.5914165475416658,-3458377667,1662.2521054397525,1387.9736194914833,274.27848594826924,0.7791758121414625,0.7797978203961904,-808
715,2018-12-17,2018,222418,222418,357430245.74999976,3336013.783333337,174307,0,153,0.8879721964948882,32973100,4288532447,224082,224082,461785,685867,300048124.9333476,3332648.433333201,175335,0,153,0.30224081345217596,3501759590,-1664,-1664,57382120.81665218,3365.3500001360662,-1028,0,0,0.5857313830427122,-3468786490,1607.0203209722224,1339.0103842939084,268.00993667831403,0.7836910681689432,0.7824590997938254,-1028
716,2018-12-18,2018,223134,223134,358014541.5833336,3377405.0499999984,174389,0,149,0.8831733397868547,33872977,4293634161,225363,225363,467150,692513,300995420.4833448,3375414.0166665046,175436,0,149,0.29714243631527193,3506030246,-2229,-2229,57019121.09998882,1991.0333334938623,-1047,0,0,0.5860309034715828,-3472157269,1604.482246467744,1335.6026520917133,268.8795943760308,0.7815438256832218,0.7784596406686102,-1047
717,2018-12-19,2018,226353,226353,358568168.43333316,3426055.433333332,176868,0,181,0.8938913997163723,34351462,4299424314,228573,228573,475342,703915,301942546.01667833,3425206.89999987,177922,0,181,0.30110169551721505,3518292001,-2220,-2220,56625622.416654825,848.5333334621973,-1054,0,0,0.5927897041991572,-3483940539,1584.11051955721,1320.9895570197632,263.12096253744676,0.7813812938198301,0.7784033984766354,-1054
718,2018-12-20,2018,224361,224361,358945203.9,3382183.583333332,175887,0,222,0.9007626102575754,33625857,4303548079,226004,226004,484430,710434,302744878.0166631,3381184.366666626,176968,0,225,0.3024292193222771,3528413349,-1643,-1643,56200325.8833369,999.2166667059064,-1081,0,-3,0.5983333909352984,-3494787492,1599.8556072579458,1339.5553973233352,260.3002099346106,0.7839464077981467,0.7830303888426754,-1081
719,2018-12-21,2018,222357,222357,359029999.9666667,3350329.8500000034,173304,0,93,0.8975566319027516,33968492,4304410163,227588,227588,497183,724771,303137651.86666095,3353311.8166666673,176420,0,89,0.2986019032218463,3540819720,-5231,-5231,55892348.100005746,-2981.966666663997,-3116,0,4,0.5989547286809053,-3506851228,1614.655711161181,1331.95797610885,282.6977350523309,0.7793952967525196,0.7751726804576691,-3116
720,2018-12-22,2018,215834,215834,358736961.8499996,3275140.049999997,169503,0,93,0.9132388780266324,33955283,4303145029,217938,217938,514859,732797,302906479.5166734,3272383.649999528,171262,0,67,0.2977345704199088,3548497292,-2104,-2104,55830482.33332622,2756.400000468828,-1759,0,26,0.6155043076067236,-3514542009,1662.0966198559986,1389.874549260218,272.2220705957807,0.7853396591825199,0.7858289972377465,-1759
721,2018-12-23,2018,208387,208387,358069871.7666666,3199849.400000001,161834,0,87,0.8994323062379134,33739970,4300012893,209839,209839,524917,734756,302377844.73333967,3197024.733332892,163061,0,68,0.27747034389647074,3552696816,-1452,-1452,55692027.033326924,2824.6666671088897,-1227,0,19,0.6219619623414426,-3518956846,1718.2927522670157,1440.9992648332277,277.29348743378796,0.7766031470293252,0.7770767111928669,-1227
722,2018-12-24,2018,207937,207937,358325520.61666626,3195089.3499999987,161903,0,146,0.8973390978998435,34059484,4304855287,209378,209378,537526,746904,302953480.3666597,3192382.9499999955,163116,0,146,0.2676916979959975,3564763072,-1441,-1441,55372040.25000656,2706.4000000031665,-1213,0,0,0.6296473999038459,-3530703588,1723.2407922431614,1446.9212637748938,276.31952846826766,0.778615638390474,0.779050330025122,-1213
723,2018-12-25,2018,211057,211057,358202700.633333,3221581.8166666683,164291,0,121,0.8997758899254711,34065953,4303988438,212505,212505,546640,759145,303114724.89999604,3217198.7000000086,165685,0,121,0.27737520500036034,3576270267,-1448,-1448,55087975.733336985,4383.116666659713,-1394,0,0,0.6224006849251107,-3542204314,1697.1846498023426,1426.3886727370934,270.7959770652492,0.7784200476648488,0.7796757723347686,-1394
724,2018-12-26,2018,213911,213911,358532983.3833333,3261944.7,168167,0,105,0.9018143059496704,34381620,4309832004,215231,215231,553798,769029,303727004.566665,3256432.850000017,169384,0,105,0.26862836121914974,3586801918,-1320,-1320,54805978.81666833,5511.849999983329,-1217,0,0,0.6331859447305206,-3552420298,1676.0848361390172,1411.1675574924848,264.9172786465324,0.7861540547236935,0.7869870046601094,-1217
725,2018-12-27,2018,205294,205294,358919190.28333336,3220797.450000001,161223,0,110,0.9025641275439126,33718457,4317856458,206737,206737,563933,770670,304423367.93332857,3215766.2999999877,162503,0,107,0.2611364137698425,3592933839,-1443,-1443,54495822.35000479,5031.150000013411,-1280,0,3,0.64142771377407,-3559215382,1748.317974628257,1472.5151662901587,275.8028083380982,0.7853273841417674,0.7860373324562124,-1280
726,2018-12-28,2018,201371,201371,359173243.7000004,3194578.833333333,158126,0,144,0.8938228444016272,33329085,4323148155,202887,202887,574995,777882,304913259.34999686,3190405.166666684,159225,0,144,0.24792063577765971,3601743577,-1516,-1516,54259984.35000354,4173.666666648816,-1099,0,0,0.6459022086239674,-3568414492,1783.63937061444,1502.872334600033,280.76703601440704,0.7852471309175602,0.7847964630557897,-1099
727,2018-12-29,2018,201459,201459,359296978.3833335,3177999.8000000003,159030,0,145,0.8983713807772296,32459233,4326347711,203783,203783,586431,790214,305281120.3666624,3174089.5333333323,160164,0,145,0.24554867415662557,3610422031,-2324,-2324,54015858.01667112,3910.2666666680016,-1134,0,0,0.652822706620604,-3577962798,1783.4744458343062,1498.0696150643694,285.4048307699368,0.7893913898113264,0.7859536860287659,-1134
728,2018-12-30,2018,201373,201373,359196529.1666668,3156176.1500000013,158768,0,82,0.8883018080874798,32062228,4326759806,203691,203691,594916,798607,305491443.2666814,3152718.8333329167,159981,0,61,0.2414491733731456,3620273371,-2318,-2318,53705085.89998543,3457.316667084582,-1213,0,21,0.6468526347143342,-3588211143,1783.737289342001,1499.778798605149,283.9584907368521,0.7884274455860517,0.7854102537667349,-1213
729,2018-12-31,2018,201371,201371,359322819.09999985,3154162.5333333323,158002,0,85,0.8861752685341976,31998599,4327616685,203914,203914,604210,808124,305944531.14999616,3151270.983333321,159285,0,56,0.24220911642272963,3631663786,-2543,-2543,53378287.95000368,2891.5500000114553,-1283,0,29,0.6439661521114679,-3599665187,1784.3821558218406,1500.360598830861,284.02155699097966,0.7846313520814815,0.7811381268574007,-1283
730,2019-01-01,2019,196978,196978,359121845.1666667,3127184.8833333333,154284,0,77,0.8794992334169296,31883536,4327694319,202827,202827,277479,480306,306087116.10001063,3128082.0499998434,156834,0,52,0.3947920700553378,3600181826,-5849,-5849,53034729.06665605,-897.1666665100493,-2550,0,25,0.4847071633615918,-3568298290,1823.157130068671,1509.1043899481363,314.05274012053474,0.7832549827899562,0.7732402490792646,-2550
731,2019-01-02,2019,205598,205598,359801400.4333332,3184824.733333339,161886,0,82,0.8988073813947609,32356403,4334515079,214255,214255,289132,503387,306744579.4500159,3189968.933333203,164443,0,60,0.4001414418727465,3607673176,-8657,-8657,53056820.983317316,-5144.199999864213,-2557,0,22,0.49866593952201443,-3575316773,1750.0238350243349,1431.6799115540637,318.3439234702712,0.7873909279273145,0.7675106765303027,-2557
732,2019-01-03,2019,211555,211555,360170801.53333324,3236433.0500000007,166549,0,85,0.8988537259814232,32687830,4337683747,226250,226250,295293,521543,307208783.36668277,3287721.6499998746,172601,0,68,0.4025880895726713,3602549700,-14695,-14695,52962018.166650474,-51288.5999998739,-6052,0,17,0.49626563640875193,-3569861870,1702.4925032891363,1357.8288767588188,344.6636265303175,0.7872609959584977,0.7628773480662984,-6052
733,2019-01-04,2019,210773,210773,360447688.94999975,3227422.5833333377,165394,0,87,0.9008411893363948,32654835,4342201096,218641,218641,309666,528307,306010059.73334384,3236351.7833331972,168009,0,54,0.390131116945263,3580856187,-7868,-7868,54437629.21665591,-8929.199999859557,-2615,0,33,0.5107100723911318,-3548201352,1710.1226862548797,1399.6005311599556,310.5221550949241,0.7847020254017355,0.7684240375775815,-2615
734,2019-01-05,2019,205567,205567,360612347.2333339,3195882.0,161911,0,92,0.905874970204362,32693680,4345501097,223770,223770,319519,543289,305985481.5666721,3259633.316666493,168601,0,61,0.39425609574277676,3579895953,-18203,-18203,54626865.6666618,-63751.31666649319,-6690,0,31,0.5116188744615853,-3547202273,1754.232669802711,1367.4106518598207,386.82201794289017,0.787631283231258,0.753456674263753,-6690
735,2019-01-06,2019,204915,204915,360942771.7666667,3181487.833333333,161393,0,89,0.9054681209281906,32788224,4349331764,222774,222774,333940,556714,305068004.433346,3227719.716666567,167905,0,64,0.37607999798819686,3566520974,-17859,-17859,55874767.33332074,-46231.88333323412,-6512,0,25,0.5293881229399937,-3533732750,1761.4267953379047,1369.405785384946,392.0210099529586,0.78760949662055,0.7537010602673562,-6512
736,2019-01-07,2019,211297,211297,361769681.9000004,3237659.6000000015,165648,0,140,0.9005759665305229,33459477,4358033475,219714,219714,345205,564919,303755013.6166767,3273110.6666665967,169616,0,140,0.367558888973467,3533769070,-8417,-8417,58014668.283323705,-35451.06666659517,-3968,0,0,0.5330170775570559,-3500309593,1712.1382788208086,1382.5018597662265,329.6364190545821,0.7839581252928343,0.7719853992007792,-3968
737,2019-01-08,2019,210126,210126,361997254.04999983,3226414.6333333366,163712,0,158,0.8931165110457545,33106802,4361439570,223148,223148,347519,570667,303656137.4833388,3285927.1166665303,170639,0,158,0.36039056051953294,3524366677,-13022,-13022,58341116.56666106,-59512.4833331937,-6927,0,0,0.5327259505262216,-3491259875,1722.7627901830322,1360.7835942214977,361.9791959615345,0.7791134842903782,0.7646898022836862,-6927
738,2019-01-09,2019,213805,213805,362477320.8166668,3227292.033333337,167168,0,149,0.8894880849372098,33559747,4366391607,224967,224967,362311,587278,303048569.85001755,3263905.8833332653,173334,0,149,0.35236804375440045,3507476905,-11162,-11162,59428750.966649234,-36613.84999992838,-6166,0,0,0.5371200411828093,-3473917158,1695.3640972693192,1347.0801044153923,348.283992853927,0.781871331353336,0.7704863379962394,-6166
739,2019-01-10,2019,216026,216026,362789444.9166664,3275888.0833333307,168687,0,131,0.8962717450677229,34000854,4368880660,217525,217525,374278,591803,301839298.866675,3271140.6666665142,169984,0,131,0.35568930877335814,3481695617,-1499,-1499,60950146.04999137,4747.416666816454,-1297,0,0,0.5405824362943648,-3447694763,1679.3786160770758,1387.6073962380187,291.77121983905704,0.78086434040347,0.7814458108263418,-1297
740,2019-01-11,2019,215170,215170,363014537.23333293,3281689.383333336,168222,0,147,0.8949017056281071,33744686,4369817399,217504,217504,377305,594809,302239575.8833454,3277657.966666545,169359,0,147,0.34651291422961095,3485443561,-2334,-2334,60774961.34998751,4031.4166667913087,-1137,0,0,0.5483887913984962,-3451698875,1687.1057174946923,1389.581689915337,297.52402757935533,0.7818097318399405,0.7786477490069148,-1137
741,2019-01-12,2019,210603,210603,362981057.65000004,3237365.966666663,165185,0,161,0.893220894289255,32918020,4370982190,215720,215720,390229,605949,302553058.76667714,3234859.9999999166,167046,0,161,0.32690209902154144,3492975974,-5117,-5117,60427998.883322895,2505.966666746419,-1861,0,0,0.5663187952677136,-3460057954,1723.532227223734,1402.5266955621971,321.0055316615369,0.7843430530429291,0.7743649174856295,-1861
742,2019-01-13,2019,207396,207396,363122700.33333313,3207025.683333338,163088,0,168,0.8941059615421705,33016397,4373855840,209591,209591,404986,614577,303073236.80001235,3203890.766666555,164171,0,168,0.3157293553126762,3506380539,-2195,-2195,60049463.533320785,3134.9166667829268,-1083,0,0,0.5783766062294943,-3473364142,1750.8664599767264,1446.0221898841664,304.84427009256,0.7863603926787401,0.7832922215171453,-1083
743,2019-01-14,2019,212991,212991,364005944.0500001,3275655.566666666,168369,0,170,0.8984558032968543,33625651,4383787438,215655,215655,412042,627697,304197641.6166785,3272477.9833331606,169419,0,170,0.31762458638483315,3518512772,-2664,-2664,59808302.433321595,3177.5833335053176,-1050,0,0,0.5808312169120211,-3484887121,1709.0203062570722,1410.5754172946533,298.4448889624189,0.7904981900643689,0.7856020031995549,-1050
744,2019-01-15,2019,209657,209657,364123335.7166667,3239040.1666666656,164774,0,183,0.887659367443014,33390112,4384590679,211712,211711,420554,632266,304589424.3166778,3234735.933333174,165744,0,183,0.3051959143778057,3525182137,-2055,-2054,59533911.39998889,4304.23333349172,-970,0,0,0.5824634530652083,-3491792025,1736.7573499414125,1438.7038194362967,298.05353050511576,0.7859217674582771,0.7828748488512697,-970
745,2019-01-16,2019,209009,209009,364429427.6333322,3231947.899999998,164038,0,199,0.8849618915931845,33398175,4387983964,211187,211187,432429,643616,305237710.2166753,3227737.3333332124,165057,0,199,0.30190206582806806,3536463077,-2178,-2178,59191717.41665691,4210.566666785628,-1019,0,0,0.5830598257651165,-3503064902,1743.6063884011319,1445.34327499645,298.2631134046819,0.7848370165878025,0.7815679942420698,-1019
746,2019-01-17,2019,210808,210808,364741135.16666573,3244218.649999995,165969,0,134,0.8906587985275702,33352456,4392771404,213112,213112,442011,655123,305833595.1166762,3240199.649999897,167144,0,136,0.30791469693477097,3547893412,-2304,-2304,58907540.04998952,4019.000000097789,-1175,0,-2,0.5827441015927992,-3514540956,1730.205377246906,1435.0838766314248,295.1215006154812,0.7872993434784259,0.784301212507977,-1175
747,2019-01-18,2019,215645,215645,364971154.5333334,3271018.6666666674,168094,0,99,0.8788935519024318,33584865,4395015930,217855,217855,451624,669479,306389395.55000776,3266294.9166661478,169156,0,99,0.2954357044806417,3557970758,-2210,-2210,58581758.98332566,4723.750000519678,-1062,0,0,0.5834578474217901,-3524385893,1692.4628650482664,1406.3913867022,286.07147834606644,0.7794940759117995,0.776461407817126,-1062
748,2019-01-19,2019,212622,212622,365298025.94999975,3250565.8166666594,165523,0,83,0.878831917675499,33331785,4396979316,214661,214661,460897,675558,307000319.20001024,3246708.899999519,166511,0,83,0.285153902403643,3569024202,-2039,-2039,58297706.74998951,3856.9166671405546,-988,0,0,0.5936780152718559,-3535692417,1718.0631635014238,1430.1634633212846,287.89970018013923,0.7784848228311275,0.7756928366121466,-988
749,2019-01-20,2019,204202,204202,365019502.0833337,3180282.4666666645,159285,0,80,0.8744870275511508,32198651,4391325912,206095,206095,474536,680631,307165728.3333409,3176233.7333332407,160212,0,76,0.2707810840235019,3578892581,-1893,-1893,57853773.74999279,4048.7333334237337,-927,0,4,0.603705943527649,-3546693930,1787.5412683682514,1490.4084443258735,297.13282404237793,0.7800364345109254,0.7773696596229894,-927
750,2019-01-21,2019,211366,211366,365662374.8166665,3221394.8333333326,163602,0,156,0.8610656396960724,32471781,4398759950,213184,213184,486183,699367,308044022.53334653,3218519.83333319,164437,0,157,0.26828117426186043,3590583299,-1818,-1818,57618352.28331995,2875.0000001424924,-835,0,-1,0.592784465434212,-3558111518,1729.9961905730652,1444.9678331082378,285.0283574648274,0.7740223120085539,0.7713383743620534,-835
751,2019-01-22,2019,211168,211168,362251382.65000063,3252894.7833333346,163597,0,80,0.8638761554781019,32539800,4330645535,217329,217329,493659,710988,307343838.03334343,3252951.9499998535,164836,0,56,0.2642435596662688,3571837776,-6161,-6161,54907544.6166572,-57.16666651889682,-1239,0,24,0.5996325958118331,-3539297976,1715.4653292639066,1414.1869609363841,301.27836832752246,0.7747243900590999,0.7584629754887751,-1239
752,2019-01-23,2019,211580,211580,362796616.71666646,3269593.749999999,163970,0,82,0.8748227620758104,33422086,4336692188,212797,212797,505159,717956,307919789.5500116,3265094.6999998814,164964,0,82,0.2697853350344627,3580980199,-1217,-1217,54876827.166654885,4499.050000117626,-994,0,0,0.6050374270413477,-3547558113,1714.7018466616244,1447.0118918500334,267.68995481159095,0.7749787314490972,0.7752176957381918,-994
753,2019-01-24,2019,210923,210923,363218063.4999997,3261027.4500000034,164940,0,82,0.8771779274901271,32979214,4339812760,212979,212979,510418,723397,308527771.1833365,3257593.76666624,165893,0,67,0.26647331962947113,3588068963,-2056,-2056,54690292.316663206,3433.683333763387,-953,0,15,0.610704607860656,-3555089749,1722.0410457844791,1448.6300113313355,273.41103445314366,0.7819915324549718,0.7789171702374412,-953
754,2019-01-25,2019,211680,211680,363605346.8499996,3223681.416666673,165293,0,86,0.8785478080120933,32668594,4344140976,213631,213631,520631,734262,309196379.8333413,3220074.2499995194,166215,0,86,0.263612988279384,3598837457,-1951,-1951,54408967.016658306,3607.166667153593,-922,0,0,0.6149348197327094,-3566168863,1717.712333947466,1447.3385409109226,270.3737930365435,0.7808626228269085,0.7780471935252843,-922
755,2019-01-26,2019,199417,199417,362869701.3166665,3152146.4499999997,156002,0,89,0.8775229794852001,32272541,4337781801,201488,201488,537462,738950,308841120.6666622,3148726.4666666514,156935,0,91,0.24534000947289952,3608483729,-2071,-2071,54028580.65000427,3419.9833333482966,-933,0,-2,0.6321829700123005,-3576211188,1819.6527944792394,1532.801559728928,286.8512347503115,0.782290376447344,0.7788801318192646,-933
756,2019-01-27,2019,200104,200104,363054107.15,3120450.8499999978,156026,0,143,0.874765122136489,32154336,4342757393,202182,202182,548911,751093,309164368.91667384,3117229.0499995444,156951,0,143,0.2410180896373612,3620453939,-2078,-2078,53889738.23332614,3221.800000453368,-925,0,0,0.6337470324991279,-3588299603,1814.3270856654538,1529.1389387614815,285.1881469039722,0.7797245432375165,0.7762857227646378,-925
757,2019-01-28,2019,203686,203686,363324874.9999999,3150571.849999999,157888,0,147,0.8668489734198715,32377654,4347546319,205712,205712,557829,763541,309654615.8499938,3146556.6499999985,158735,0,148,0.23805008506419764,3635093812,-2026,-2026,53670259.150006056,4015.200000000652,-847,0,-1,0.6287988883556739,-3602716158,1783.7498649882657,1505.2822190732375,278.46764591502824,0.7751539133764717,0.7716370459671774,-847
758,2019-01-29,2019,197356,197356,363241156.96666723,3086599.816666665,153164,0,168,0.8676604714323358,31871628,4348018857,199499,199499,568413,767912,309884488.2166638,3082368.4333333196,154084,0,168,0.23260347539822745,3636237542,-2143,-2143,53356668.75000346,4231.3833333454095,-920,0,0,0.6350569960341084,-3604365914,1840.537693136602,1553.313491379224,287.22420175737807,0.7760797746204828,0.7723547486453566,-920
759,2019-01-30,2019,195348,195348,362753843.64999974,3038306.5000000033,151903,0,153,0.8593484448266674,31611753,4344794819,197425,197425,580302,777727,309659163.41666365,3034752.4000000176,152736,0,153,0.22195063306276086,3643504633,-2077,-2077,53094680.23333609,3554.0999999856576,-833,0,0,0.6373978117639065,-3611892880,1856.9621580461521,1568.490127474553,288.47203057159913,0.7776020230562893,0.7736406230214006,-833
760,2019-01-31,2019,184380,184380,362374211.0666673,2931738.583333331,143137,0,157,0.8411921032649967,30120234,4343107704,187406,187406,594658,782064,309510974.14999545,2930968.550000019,144457,0,157,0.2013748235438505,3651504832,-3026,-3026,52863236.91667187,770.0333333122544,-1320,0,0,0.6398172797211462,-3621384598,1965.3661517879777,1651.5531741246034,313.81297766337434,0.7763152185703438,0.7708237729848564,-1320
761,2019-02-01,2019,179734,179734,361713029.10000044,2881433.08333333,139439,0,179,0.8605550424516233,30576273,4339710570,182493,182493,264370,446863,309183716.9666683,2879483.633333112,141147,0,179,0.356711117277556,3625548972,-2759,-2759,52529312.13333213,1949.4500002181157,-1708,0,0,0.5038439251740673,-3594972699,2012.4908425784795,1694.2223371124828,318.26850546599667,0.7758075823160894,0.7734378852887508,-1708
762,2019-02-02,2019,173597,173597,360862604.50000006,2817134.266666666,134145,0,199,0.8644216201892888,29765208,4332968068,174529,174529,277248,451777,308272707.86666906,2813029.083333062,134938,0,199,0.3423968019620252,3626954746,-932,-932,52589896.633331,4105.183333604131,-793,0,0,0.5220248182272635,-3597189538,2078.737561709016,1766.312233879006,312.42532783001,0.772738008145302,0.7731551776495597,-793
763,2019-02-03,2019,166520,166520,359975402.66666573,2704396.6499999994,126697,0,171,0.8482044198895032,28797294,4327797153,167429,167429,290556,457985,307592356.0500013,2700786.316666431,127415,0,171,0.31744489448344104,3636875472,-909,-909,52383046.61666441,3610.3333335686475,-718,0,0,0.5307595254060622,-3608078178,2161.7547601889605,1837.1510075912854,324.6037525976751,0.7608515493634398,0.7610091441745457,-718
764,2019-02-04,2019,161198,161198,359364153.9833331,2686073.999999999,124118,0,180,0.8418838943411209,28513674,4326816894,162380,162379,304733,467113,307102239.6166699,2682913.3499999,124672,0,180,0.29847167601843255,3647284795,-1182,-1181,52261914.36666322,3160.6500000990927,-554,0,0,0.5434122183226884,-3618771121,2229.3338253783118,1891.2682035033465,338.06562187496525,0.76997233216293,0.7677792831629511,-554
765,2019-02-05,2019,163556,163556,359015387.1499995,2717570.366666666,126691,0,186,0.8604881508474153,28389676,4324798305,169568,169568,312317,481885,306985805.450001,2722034.116666398,127972,0,186,0.30638637849279526,3654221365,-6012,-6012,52029581.6999985,-4463.749999731779,-1281,0,0,0.55410177235462,-3625831689,2195.0609402895616,1810.3993999457505,384.6615403438111,0.7746031940130598,0.7546942819399887,-1281
766,2019-02-06,2019,167886,167886,359278277.2666669,2763381.0666666655,130699,0,198,0.8835459776276773,28512186,4326266494,178705,178705,318703,497408,307344716.5333328,2778288.2166664237,133932,0,198,0.32364577972207736,3658548521,-10819,-10819,51933560.733334064,-14907.149999758229,-3233,0,0,0.5599001979056,-3630036335,2140.0133261062083,1719.8439692976292,420.1693568085791,0.7784985049378745,0.7494586049634873,-3233
767,2019-02-07,2019,168288,168288,359531006.45000005,2750485.2333333343,131126,0,216,0.8675306617227613,28537233,4329879971,170446,170445,329785,500231,305556502.53333277,2747685.2666664375,131992,0,218,0.30833954712922756,3627177621,-2158,-2157,53974503.91666728,2799.9666668968275,-866,0,-2,0.5591911145935338,-3598640388,2136.4031092531854,1792.6985393137538,343.7045699394316,0.7791761741776003,0.7743918895133943,-866
768,2019-02-08,2019,168371,168371,359509460.5333333,2742930.766666671,130187,0,230,0.8658735768036054,28651803,4329741058,170510,170510,336754,507264,305784277.58333397,2741758.5333330743,130965,0,230,0.3045751324753927,3631400151,-2139,-2139,53725182.94999933,1172.233333596494,-778,0,0,0.5612984443282127,-3602748348,2135.2219831997986,1793.350991632948,341.87099156685053,0.7732151023632335,0.7680781185854202,-778
769,2019-02-09,2019,167893,167893,358978542.0333333,2736369.6999999983,130063,0,217,0.8621562542810011,28079808,4327050731,170164,170164,347471,517635,305660396.16667247,2737740.8666665927,130855,0,220,0.2894201512648886,3634376352,-2271,-2271,53318145.86666083,-1371.166666594334,-792,0,-3,0.5727361030161124,-3606296544,2138.138826713045,1796.2694586791124,341.8693680339327,0.7746779198656287,0.7689934416210245,-792
770,2019-02-10,2019,174721,174721,359184696.6999998,2794161.0000000033,135070,0,218,0.8484669845067276,29005912,4329349097,176767,176767,355404,532171,306142788.21667516,2795092.3499999363,135693,0,218,0.2831721382788508,3637351201,-2046,-2046,53041908.48332465,-931.3499999330379,-623,0,0,0.5652948462278768,-3608345289,2055.7614522581707,1731.9001183290725,323.86133392909824,0.7730610516194389,0.767637624669763,-623
771,2019-02-11,2019,181744,181744,359550929.8499995,2875671.4333333336,140620,0,211,0.8734043489743816,30013823,4333695202,183462,183462,362662,546124,306753865.80000675,2874403.999999913,141664,0,211,0.30726904512528275,3638484596,-1718,-1718,52797064.04999274,1267.4333334206603,-1044,0,0,0.5661353038490988,-3608470773,1978.3372757835168,1672.0294436995496,306.30783208396724,0.7737256800774716,0.7721708037631771,-1044
772,2019-02-12,2019,187759,187759,359966811.53333277,2942644.616666669,142286,0,88,0.8634632694038632,25868101,4333457724,191903,191903,365939,557842,307479035.43333614,2940442.1333331903,143828,0,74,0.31647133059182325,3631534150,-4144,-4144,52487776.09999663,2202.4833334786817,-1542,0,14,0.5469919388120399,-3605666049,1917.1747374737442,1602.2627860603334,314.91195141341086,0.7578118758621424,0.7494828116287916,-1542
773,2019-02-13,2019,192167,192167,360365805.54999983,2999687.416666664,148208,0,169,0.8719915490172613,30815901,4336378406,193185,193185,373355,566540,307951540.4000082,2995664.733333201,149008,0,169,0.3083683411586058,3629860428,-1018,-1018,52414265.14999163,4022.6833334630355,-800,0,0,0.5636232078586555,-3599044527,1875.274139420399,1594.075836115683,281.1983033047161,0.7712458434590747,0.7713228252711132,-800
774,2019-02-14,2019,197753,197753,360906361.3500004,3060945.8500000015,152697,0,134,0.8541564476897946,31170727,4339851962,198719,198719,380661,579380,308872536.33333695,3055939.599999872,153441,0,134,0.29680002761573426,3631959639,-966,-966,52033825.01666343,5006.250000129454,-744,0,0,0.5573564200740604,-3600788912,1825.0360871895768,1554.318089026902,270.7179981626748,0.7721602200725147,0.7721506247515336,-744
775,2019-02-15,2019,201753,201753,361696204.983333,3082751.799999998,155970,0,170,0.8505647995321023,32250479,4347940691,202512,202512,389365,591877,309890770.58334243,3078575.083333198,156616,0,173,0.2934646894540537,3638652147,-759,-759,51805434.39999056,4176.71666679997,-646,0,-3,0.5571001100780486,-3606401668,1792.7674184935688,1530.2341124641623,262.5333060294065,0.7730740063344783,0.7733665165521055,-646
776,2019-02-16,2019,195743,195743,361911485.5833328,3052743.683333333,151300,0,131,0.8589068319173612,31499639,4352122632,196857,196856,404178,601035,310320437.2500088,3049369.9666665373,152145,0,131,0.2872661325879498,3646058245,-1114,-1113,51591048.333323956,3373.716666795779,-845,0,0,0.5716406993294114,-3614558606,1848.9115093941177,1576.3829258443168,272.52858354980094,0.7729522894816162,0.7728706624605678,-845
777,2019-02-17,2019,194736,194736,362347081.85000014,3054132.300000005,151093,0,99,0.8664756388135744,31482167,4357383822,195610,195610,415534,611144,310932377.1000089,3049897.566666535,151849,0,99,0.28482158051130735,3657995533,-874,-874,51414704.74999124,4234.733333469834,-756,0,0,0.581654058302267,-3626513366,1860.7092774320113,1589.552564286125,271.1567131458862,0.7758863281570947,0.7762844435356065,-756
778,2019-02-18,2019,202105,202105,363094234.7833336,3112229.5333333383,155989,0,102,0.85656960490834,32265278,4365518381,202906,202905,424324,627230,311890589.23334515,3108332.3499998953,156648,0,102,0.2797394895014603,3669027720,-801,-800,51203645.54998845,3897.183333443012,-659,0,0,0.5768301154068797,-3636762442,1796.562355128936,1537.1261882819308,259.4361668470051,0.7718215778926796,0.7720225128877412,-659
779,2019-02-19,2019,202468,202468,363819589.03333354,3134777.900000003,156490,0,64,0.8622498370112811,31786229,4372500170,203269,203269,431995,635264,312782175.7666741,3129313.2333332393,157221,0,62,0.284266068909935,3671395907,-801,-801,51037413.26665944,5464.666666763835,-731,0,2,0.5779837681013461,-3639609678,1796.9239041889757,1538.7598490998337,258.16405508914204,0.7729122626785467,0.773462751329519,-731
780,2019-02-20,2019,209014,209014,364379705.6333332,3196845.500000006,161412,0,134,0.8655066167816508,32116401,4373969736,210329,210329,440154,650483,313730716.8000101,3191216.116666562,162522,0,134,0.29666109644679634,3682253002,-1315,-1315,50648988.83332312,5629.38333344413,-1110,0,0,0.5688455203348544,-3650136601,1743.32678975252,1491.6189246371641,251.70786511535584,0.7722544901298478,0.7727037165583444,-1110
781,2019-02-21,2019,208106,208106,365163471.48333305,3202108.050000006,161432,0,185,0.8722477967958638,32082428,4379384364,209338,209338,450520,659858,314736716.1166743,3196773.266666543,162350,0,185,0.2875285288652983,3690444644,-1232,-1232,50426755.36665875,5334.783333462663,-918,0,0,0.5847192679305655,-3658362216,1754.699391095562,1503.4858273064342,251.21356378912787,0.7757200657357308,0.7755400357316875,-918
782,2019-02-22,2019,207408,207408,365807280.68333346,3191422.066666668,160607,0,77,0.8665191313739103,32436485,4387476757,213219,213219,461955,675174,315589360.1833421,3195984.149999913,162383,0,80,0.28070393705918234,3699389544,-5811,-5811,50217920.49999136,-4562.083333245013,-1776,0,-3,0.5858151943147281,-3666953059,1763.7086355556846,1480.1183768019835,283.59025875370116,0.7743529661343824,0.7615784709617811,-1776
783,2019-02-23,2019,206172,206172,365756311.4166667,3179781.7333333357,160426,0,73,0.8809295151620974,32441007,4387893319,212795,212795,476845,689640,315858379.4500097,3176413.1333332215,162258,0,55,0.2769415927150418,3706979384,-6623,-6623,49897931.96665698,3368.60000011418,-1832,0,18,0.6039879224470556,-3674538377,1774.034841863428,1484.33177212815,289.70306973527795,0.7781173001183478,0.7625085175873493,-1832
784,2019-02-24,2019,212256,212256,366265127.8166668,3242065.9666666724,163567,0,65,0.8649649479873365,32987651,4391744226,214307,214307,488110,702417,315622520.8833425,3237720.549999846,164516,0,54,0.26691979265878035,3708110020,-2051,-2051,50642606.93332428,4345.416666826233,-949,0,11,0.5980451553285562,-3675122369,1725.581975617494,1472.7588034144592,252.8231722030348,0.7706119026081713,0.7676650786021921,-949
785,2019-02-25,2019,215847,215847,367177285.58333313,3290097.4666666635,167467,0,120,0.8658308894726346,33180392,4401516943,217753,217753,496415,714168,316640316.6999981,3287020.8333332455,168258,0,120,0.26647231463745585,3716626933,-1906,-1906,50536968.883335054,3076.6333334180526,-791,0,0,0.5993585748351788,-3683446541,1701.099786345574,1454.1260818450173,246.97370450055678,0.7758597525098797,0.7727011797770869,-791
786,2019-02-26,2019,219974,219974,367771427.2500001,3329747.700000002,170420,0,178,0.8716211915953709,33236411,4407813305,222005,222005,504340,726345,317460937.65000296,3326206.066666213,171314,0,178,0.2728042459161953,3720768158,-2031,-2031,50310489.59999716,3541.6333337891847,-894,0,0,0.5988169456791756,-3687531747,1671.885892196351,1429.972017071701,241.91387512465008,0.774727922390828,0.7716673047904327,-894
787,2019-02-27,2019,219206,219206,368504078.16666645,3347137.800000004,170676,0,131,0.8767734459823188,33783372,4415728169,220698,220698,513740,734438,318408443.6000035,3342595.399999569,171621,0,132,0.26903019723926413,3731171413,-1492,-1492,50095634.56666297,4542.4000004348345,-945,0,-1,0.6077432487430546,-3697388041,1681.0857283407684,1442.7337066942314,238.35202164653697,0.7786100745417552,0.7776282521817144,-945
788,2019-02-28,2019,217245,217245,369076444.9166668,3303421.283333333,169445,0,79,0.8759096872194985,32991968,4421948643,218850,218850,526296,745146,319146970.24999326,3300462.5499999938,170371,0,79,0.2643629570580816,3742169651,-1605,-1605,49929474.66667354,2958.733333339449,-926,0,0,0.6115467301614168,-3709177683,1698.8950029536552,1458.2909310029393,240.60407195071593,0.7799719211029023,0.7784829792095043,-926
789,2019-03-01,2019,215615,215615,369387372.7666661,3288486.4000000022,168510,0,68,0.8735013797741348,32383343,4426498369,217239,217239,253145,470384,319614820.8833449,3286666.3499998627,169498,0,65,0.41139579577536295,3724563766,-1624,-1624,49772551.883321226,1820.0500001395121,-988,0,3,0.46210558399877183,-3692180423,1713.1803110482392,1471.2589400768043,241.92137097143495,0.7815318971314612,0.7802374343465032,-988
790,2019-03-02,2019,209721,209721,369388947.85,3253823.35,164178,0,74,0.8879034526823733,31927441,4428458451,211538,211538,267961,479499,319833024.16667753,3251117.899999846,165116,0,66,0.4039674743847299,3732349106,-1817,-1817,49555923.68332249,2705.45000015432,-938,0,8,0.48393597829764334,-3700421665,1761.3350491843928,1511.9412312051618,249.39381797923102,0.7828400589354428,0.7805500666546908,-938
791,2019-03-03,2019,208732,208732,369467402.46666694,3224116.8333333354,162594,0,71,0.8673897629496197,32361112,4432088283,209530,209530,281835,491365,320035965.2666775,3220599.7666665334,163300,0,66,0.37437953456187467,3746005551,-798,-798,49431437.19998944,3517.0666668019257,-706,0,5,0.493010228387745,-3713644439,1770.056352004805,1527.3992519766978,242.65710002810715,0.778960581032137,0.7793633369923162,-706
792,2019-03-04,2019,214805,214805,370092182.78333384,3282980.15,167633,0,86,0.8723307185586933,33053310,4440596276,215743,215743,293249,508992,320901277.5333428,3279482.5333332513,168430,0,71,0.3757387149503409,3758993619,-938,-938,49190905.24999106,3497.616666748654,-797,0,15,0.4965920036083524,-3725940309,1722.9216395490507,1487.423821553157,235.49781799589368,0.780396173273434,0.7806974038555132,-797
793,2019-03-05,2019,217702,217702,370295906.2333333,3298755.63333333,169327,0,83,0.8631523826147667,33245058,4441312326,218668,218668,301340,520008,321338846.85000926,3293968.233333215,170153,0,65,0.36911355209920055,3762499133,-966,-966,48957059.38332403,4787.400000114925,-826,0,18,0.49403883051556613,-3729254075,1700.93019923259,1469.5284488357202,231.40175039686983,0.7777925788463128,0.7781339747928366,-826
794,2019-03-06,2019,211442,211442,370542912.9666667,3267222.4833333315,165608,0,75,0.8664314563804733,33149160,4445288850,212211,212211,314930,527141,321838645.5166795,3262624.6833332134,166291,0,65,0.354305584274411,3770561679,-769,-769,48704267.44998717,4597.800000118092,-683,0,10,0.5121258721060622,-3737412519,1752.4565269277944,1516.5973748612444,235.85915206655,0.7832313353070819,0.7836115941209456,-683
795,2019-03-07,2019,210895,210895,370806321.7999998,3266771.1333333286,164915,0,75,0.8801109556888501,33226829,4448654643,211895,211895,329496,541391,322344689.28333926,3262214.7333332505,165770,0,64,0.35515366897492323,3780481914,-1000,-1000,48461632.51666051,4556.400000078138,-855,0,11,0.5249572867139269,-3747255085,1758.2508916759514,1521.2472653122502,237.0036263637012,0.781976813106048,0.7823214327851058,-855
796,2019-03-08,2019,222592,222592,371348710.1166665,3359394.6999999997,171390,0,84,0.8622771707878077,33908630,4453046591,227523,227523,337684,565207,323119318.91668594,3359066.1666665277,173199,0,70,0.34776462428809307,3789226631,-4931,-4931,48229391.19998056,328.5333334719762,-1809,0,14,0.5145125464997147,-3755318001,1668.2931557138913,1420.1611218060852,248.1320339078061,0.7699737636572743,0.7612373254572066,-1809
797,2019-03-09,2019,221771,221771,371488596.1166669,3338538.0666666627,171671,0,69,0.8602026414634908,33429380,4454779662,221563,221563,354536,576099,323072009.8000067,3330974.049999878,172283,0,68,0.33485043369281847,3786137822,208,208,48416586.316660225,7564.016666784883,-612,0,1,0.5253522077706723,-3752708442,1675.0999730202186,1458.149645021988,216.9503279982307,0.7740912923691555,0.7775801916384956,-612
798,2019-03-10,2019,220973,220973,371566672.8166671,3341987.7499999995,170690,0,78,0.8656758970552965,33900507,4452793080,220543,220542,364406,584949,323283113.35001254,3335399.533333212,171270,0,59,0.33186311969077376,3789612737,430,431,48283559.46665454,6588.216666787397,-580,0,19,0.5338127773645227,-3755712230,1681.5025945100401,1465.8573575555338,215.64523695450634,0.7724473125675988,0.7765832513387412,-580
799,2019-03-11,2019,229633,229633,371894998.3833329,3414900.466666671,178269,0,85,0.8660950298955292,34147695,4453032174,229281,229281,374681,603962,323844044.85000634,3408600.966666518,178817,0,85,0.3341865878979157,3796473737,352,352,48050953.533326566,6299.500000153203,-548,0,0,0.5319084419976134,-3762326042,1619.5189645361638,1412.4329746032438,207.08598993292003,0.7763213475415119,0.7799032628085188,-548
800,2019-03-12,2019,226539,226539,372014356.2333328,3397345.93333333,175990,0,136,0.8785330561183728,33594378,4449278704,227078,227078,383082,610160,324314303.9000112,3391708.583333207,176737,0,136,0.3357430837813066,3796722581,-539,-539,47700052.33332163,5637.350000123028,-747,0,0,0.5427899723370663,-3763128203,1642.1647320476068,1428.2066245960032,213.9581074516036,0.7768640278274381,0.7783096557130149,-747
801,2019-03-13,2019,225607,225607,372087763.38333315,3396636.383333333,176128,0,77,0.8725837407527249,33849218,4447066581,225481,225481,397662,623143,324669534.61667955,3388978.666666525,176702,0,68,0.3224990090557078,3803350252,126,126,47418228.7666536,7657.716666807886,-574,0,9,0.5500847316970172,-3769501034,1649.2740180195347,1439.8975284688267,209.3764895507079,0.7806849964761732,0.7836669165029426,-574
802,2019-03-14,2019,225995,225995,372288666.7666668,3382878.68333333,175851,0,77,0.8741874820239377,33873789,4447496860,225592,225592,408051,633643,325173728.6500126,3374894.016666557,176465,0,61,0.3215706636071138,3812089332,403,403,47114938.11665422,7984.666666772682,-614,0,16,0.5526168184168239,-3778215543,1647.3314310788594,1441.424025009808,205.90740606905138,0.778118984933295,0.7822307528635767,-614
803,2019-03-15,2019,225885,225885,372093065.1833334,3377489.699999998,175570,0,70,0.8663390663390674,33682803,4446292458,224873,224873,422732,647605,325420865.6666759,3370096.6166665154,175865,0,70,0.30715636846534555,3816994606,1012,1012,46672199.51665747,7393.0833334825,-295,0,0,0.5591826978737219,-3783311803,1647.2677034036496,1447.1317840144256,200.135919389224,0.7772539123890475,0.7820636537067589,-295
804,2019-03-16,2019,228159,228159,371837251.4666667,3403076.083333333,177192,0,114,0.8771032481734232,33646780,4443411364,235280,235279,433769,669049,325419197.0166868,3398070.349999858,180236,0,117,0.31119095910762506,3823174499,-7121,-7120,46418054.4499799,5005.733333474956,-3044,0,-3,0.5659122890657982,-3789527719,1629.7286167394961,1383.120452810012,246.60816392948414,0.7766163070490316,0.7660489629377762,-3044
805,2019-03-17,2019,232767,232767,371550122.0333337,3447617.233333335,178689,0,76,0.8784707454235355,33265369,4433805930,232204,232204,444955,677159,322276880.58334327,3438975.7833331637,179515,0,68,0.3136264894950808,3766991278,563,563,49273241.44999045,8641.450000171084,-826,0,8,0.5648442559284548,-3733725909,1596.2319488300907,1387.904086851834,208.32786197825658,0.7676732526517934,0.77309176413843,-826
806,2019-03-18,2019,234650,234650,371952006.03333294,3487788.316666667,180556,0,81,0.8755550820370777,34473970,4438113693,235616,235616,454361,689977,323039752.6833452,3481442.966666556,181620,0,73,0.3138669839719273,3774579144,-966,-966,48912253.349987745,6345.3500001109205,-1064,0,8,0.5616880980651504,-3740105174,1585.1353336174427,1371.043361585568,214.09197203187477,0.7694694225442148,0.7708305038707048,-1064
807,2019-03-19,2019,234930,234930,372392556.08333373,3473957.083333334,181489,0,118,0.8742859575192615,34240558,4440286741,235687,235687,464543,700230,323735305.2333471,3468091.1333332676,182357,0,118,0.3038558759264877,3771613144,-757,-757,48657250.84998661,5865.95000006631,-868,0,0,0.5704300815927739,-3737372586,1585.1213386256916,1373.5815095162106,211.53982910948093,0.7725237304729068,0.7737253221433511,-868
808,2019-03-20,2019,225004,225004,371815924.51666635,3405142.9166666665,176430,0,151,0.8865353504826586,34165548,4436339562,226051,226051,479331,705382,323555862.5166751,3401280.349999858,177237,0,151,0.29353598475718473,3778670399,-1047,-1047,48260061.99999124,3862.566666808445,-807,0,0,0.592999365725474,-3744504851,1652.4858425479829,1431.3401069523034,221.14573559567953,0.7841193934330056,0.7840575799266537,-807
809,2019-03-21,2019,224429,224429,371878524.8666669,3396962.7333333343,177525,0,78,0.8849524794032864,33615132,4438229630,225685,225685,492027,717712,323843652.9500131,3393130.0499993702,178342,0,61,0.2883663642240918,3788200708,-1256,-1256,48034871.91665381,3832.683333964087,-817,0,17,0.5965861151791946,-3754585576,1656.9985379191946,1434.9365396460248,222.06199827316982,0.7910074010043265,0.7902253140439107,-817
810,2019-03-22,2019,222152,222152,371880667.2833335,3376719.9166666646,175738,0,93,0.8824093413518674,34208111,4440383335,223012,223012,504155,727167,324070826.10001415,3371449.999999391,176498,0,93,0.2766338406445761,3796250240,-860,-860,47809841.18331933,5269.916667273734,-760,0,0,0.6057755007072914,-3762042129,1673.991984242021,1453.154207396975,220.83777684504616,0.7910709784291836,0.7914282639499219,-760
811,2019-03-23,2019,216749,216749,371385790.8166669,3344396.416666667,171329,0,66,0.8817572399411306,33877953,4431708066,217468,217468,519144,736612,323979676.06666905,3340044.4833328016,171945,0,69,0.26544639511710355,3806514137,-719,-719,47406114.749997854,4351.933333865367,-616,0,-3,0.6163108448240271,-3772636184,1713.4371591872023,1489.7809151997951,223.65624398740715,0.7904488602023538,0.7906680523111447,-616
812,2019-03-24,2019,222886,222886,371306675.6000001,3373063.3499999945,175687,0,74,0.8816390441750498,34262931,4432026896,223453,223453,529097,752550,324152954.98332626,3367675.499999985,176183,0,65,0.2632011162049022,3815847133,-567,-567,47153720.61667383,5387.850000009406,-496,0,9,0.6184379279701475,-3781584202,1665.9039849968149,1450.6538510708124,215.2501339260025,0.788237035973547,0.7884566329384702,-496
813,2019-03-25,2019,235249,235249,372199229.68333364,3508773.249999997,184382,0,118,0.8767093590195917,34598967,4441073469,238424,238424,535381,773805,325252754.5500084,3506182.78333284,186022,0,117,0.2708511834376873,3825592436,-3175,-3175,46946475.13332522,2590.466667157132,-1640,0,1,0.6058581755819044,-3790993469,1582.150103436502,1364.1779122488022,217.97219118769976,0.7837737886239686,0.7802150790188908,-1640
814,2019-03-26,2019,242113,242113,372690839.3666666,3568343.7833333286,186106,0,136,0.8641832532742979,35580777,4440413426,243117,243117,543448,786565,325889100.3833266,3562149.1833332977,186931,0,136,0.2698238543540575,3820251776,-1004,-1004,46801738.983340025,6194.600000030827,-825,0,0,0.5943593989202405,-3784670999,1539.3260145744616,1340.4620013546012,198.86401321986045,0.7686741315005803,0.76889316666461,-825
815,2019-03-27,2019,233942,233942,373093685.7333333,3517852.983333327,182705,0,179,0.8741782151131465,34824937,4443803597,234959,234959,554629,789588,326479235.4333305,3511756.916666656,183506,0,179,0.26460635166694596,3824425394,-1017,-1017,46614450.30000281,6096.066666671075,-801,0,0,0.6095718634462006,-3789600457,1594.8127558682634,1389.5157684248336,205.29698744342977,0.7809841755648836,0.7810128575623833,-801
816,2019-03-28,2019,236636,236636,373406238.5166663,3536696.566666662,184843,0,147,0.8680927669500843,35046615,4449587070,237691,237691,568259,805950,326999833.18332744,3532371.8499999503,185570,0,149,0.2579365965630654,3835372881,-1055,-1055,46406405.33333886,4324.71666671196,-727,0,-2,0.6101561703870189,-3800326266,1577.977309102023,1375.7350222908206,202.24228681120235,0.7811279771463344,0.7807195055765679,-727
817,2019-03-29,2019,235775,235775,373656272.1166667,3509111.266666666,185239,0,189,0.8751945710953233,35402898,4451135528,236576,236576,578900,815476,327470354.7499946,3504273.8833332676,185953,0,189,0.2570081768194267,3842856450,-801,-801,46185917.3666721,4837.383333398495,-714,0,0,0.6181863942758965,-3807453552,1584.8002210440745,1384.2078433568688,200.59237768720573,0.785660057257979,0.7860180238063033,-714
818,2019-03-30,2019,223610,223610,373253802.36666715,3390080.3500000047,176964,0,169,0.8733732838424055,34624252,4452243284,224220,224220,596288,820508,327298872.29999155,3384788.8666666644,177531,0,169,0.24079107089754087,3853701965,-610,-610,45954930.0666756,5291.48333334038,-567,0,0,0.6325822129448646,-3819077713,1669.2178452066864,1459.722024351046,209.49582085564043,0.791395733643397,0.7917714744447417,-567
819,2019-03-31,2019,218068,218068,372922975.4333336,3334729.766666666,173279,0,133,0.8805922923124906,33575061,4450727038,218942,218942,611037,829979,327137637.36666155,3331628.6166666523,173951,0,133,0.23457340486928055,3865589156,-874,-874,45785338.06667203,3101.1500000138767,-672,0,0,0.64601888744321,-3832014095,1710.1224179307994,1494.1748836068984,215.94753432390098,0.7946099381844195,0.7945072210905171,-672
820,2019-04-01,2019,236429,236429,373505674.8500001,3476825.233333332,185574,0,164,0.8721688117785887,34018212,4457051834,237451,237451,292155,529606,327852646.48333853,3472790.4999998054,186451,0,166,0.39421947636545057,3844606298,-1022,-1022,45653028.36666155,4034.733333526645,-877,0,-2,0.47794933541313817,-3810588086,1579.7794468952627,1380.7170594494803,199.0623874457824,0.7849037131654746,0.7852188451512101,-877
821,2019-04-02,2019,232938,232938,372919750.14999974,3502347.8333333354,182874,0,172,0.8665868170929608,34927035,4450913504,233244,233244,303435,536679,327312270.86668056,3494921.6499998905,183312,0,174,0.3808701290715689,3831389069,-306,-306,45607479.283319175,7426.183333444875,-438,0,-2,0.4857166880213919,-3796462034,1600.9399503301297,1403.3041401565768,197.63581017355295,0.785075857095021,0.7859237536656891,-438
822,2019-04-03,2019,226448,226448,372388483.2500002,3437413.933333332,176995,0,204,0.8592877835087965,34210126,4448135247,227792,227792,314023,541815,327161646.9000059,3434894.94999988,177842,0,204,0.36390649945091813,3839091833,-1344,-1344,45226836.3499943,2518.983333452139,-847,0,0,0.4953812840578784,-3804881707,1644.4768037253593,1436.2297486303553,208.24705509500404,0.7816143220518618,0.7807210086394606,-847
823,2019-04-04,2019,225624,225624,372448628.20000046,3390749.316666666,175345,0,84,0.8540802396908133,34411590,4450966355,226751,226751,326510,553261,327401329.4000114,3385464.5166665465,176235,0,86,0.3526436889641582,3847232461,-1127,-1127,45047298.799989045,5284.800000119489,-890,0,-2,0.501436550726655,-3812820871,1650.749158777437,1443.8804212550833,206.86873752235374,0.7771557990284721,0.777218182058734,-890
824,2019-04-05,2019,230451,230451,372488334.2499997,3448392.4500000007,179261,0,56,0.8564944391649423,35709930,4454071221,231364,231364,340452,571816,327559847.21667445,3443059.4999998705,180011,0,51,0.348825496313494,3853314422,-913,-913,44928487.033325255,5332.950000130106,-750,0,5,0.5076689428514483,-3817604492,1616.3450549140584,1415.7770751572175,200.56797975684094,0.77787034987915,0.7780423920748258,-750
825,2019-04-06,2019,234631,234631,372874049.64999986,3497267.0333333337,183151,0,81,0.8621239307678858,35361951,4458904951,235672,235672,347962,583634,328113236.30001575,3491647.133333223,184082,0,81,0.3516244769838609,3864108729,-1041,-1041,44760813.34998411,5619.900000110734,-931,0,0,0.510499453784025,-3828746778,1589.193455468373,1392.2453083099213,196.94814715845177,0.7805916524244452,0.7810940629349266,-931
826,2019-04-07,2019,238998,238998,373421614.4500002,3515908.266666662,185246,0,59,0.85371007288764,34812118,4464485918,239876,239876,358913,598789,328801897.06667423,3512037.783333199,186083,0,55,0.3440443962731429,3875783541,-878,-878,44619717.383325994,3870.4833334628493,-837,0,4,0.5096656766144971,-3840971423,1562.446608130613,1370.7161077668222,191.73050036379072,0.7750943522539938,0.7757466357618102,-837
827,2019-04-08,2019,241071,241071,374124239.9999999,3560333.366666666,187334,0,61,0.8510272907151826,35270088,4472095419,242069,242069,370264,612333,329656482.3333459,3555893.166666489,188174,0,55,0.3387535866922158,3886279095,-998,-998,44467757.66665399,4440.200000177138,-840,0,6,0.5122737040229668,-3851009007,1551.925532312057,1361.8285791792666,190.0969531327903,0.7770905666795259,0.7773568693223832,-840
828,2019-04-09,2019,226433,226433,374236851.2666666,3447511.8999999994,178001,0,65,0.8601484765913083,34862412,4477343860,227082,227082,386028,613110,329958643.2166709,3442904.1333331955,178581,0,62,0.32067328864314587,3889960863,-649,-649,44278208.04999572,4607.766666803975,-580,0,3,0.5394751879481625,-3855098451,1652.748721549715,1453.0374191555072,199.71130239420768,0.7861089152199547,0.7864163606098238,-580
829,2019-04-10,2019,232734,232734,374322013.7000003,3489148.683333333,183546,0,59,0.8567721089312268,34430714,4479106374,233408,233408,398650,632058,330285646.4500181,3484605.749999607,184037,0,56,0.31733796581959317,3899413132,-674,-674,44036367.24998218,4542.933333726134,-491,0,3,0.5394341431116336,-3864982418,1608.3684107178165,1415.0570950867927,193.31131563102372,0.7886514217948387,0.7884776871401151,-491
830,2019-04-11,2019,236643,236643,374756854.66666687,3540621.783333329,185515,0,59,0.8590704140836616,34819804,4483216265,237592,237592,405515,643107,330850466.7000123,3535545.866666522,186270,0,55,0.3196513177433828,3907146952,-949,-949,43906387.96665454,5075.916666807141,-755,0,4,0.5394190963402787,-3872327148,1583.6380314087755,1392.5151802249752,191.12285118380032,0.7839445916422628,0.7839910434694771,-755
831,2019-04-12,2019,237947,237947,375026673.0333335,3546074.5833333316,186779,0,56,0.8578927240099695,35851348,4488151627,238822,238822,415721,654543,331193498.8833425,3543921.1999994596,187485,0,52,0.31489604197127513,3912890806,-875,-875,43833174.149990976,2153.3833338720724,-706,0,4,0.5429966820386944,-3877039458,1576.0933024300937,1386.7796889873734,189.31361344272023,0.7849605164175215,0.7850407416402174,-706
832,2019-04-13,2019,235850,235850,375194011.0833333,3532020.016666669,185041,0,67,0.856921772312911,35802589,4490665863,236620,236620,428022,664642,331581065.8333441,3525965.3166665677,185729,0,68,0.3064085628052288,3921327857,-770,-770,43612945.24998921,6054.700000101235,-688,0,-1,0.5505132095076821,-3885525268,1590.8162437283584,1401.323074268211,189.49316946014733,0.7845707017171931,0.7849251965176232,-688
833,2019-04-14,2019,230319,230319,374709806.6666671,3456883.366666667,180743,0,73,0.8589912252137257,34984251,4486469962,231025,231025,441939,672964,331345477.75000954,3451326.3333332296,181352,0,73,0.2961644307867862,3932905378,-706,-706,43364328.91665757,5557.033333437517,-609,0,0,0.5628267944269395,-3897921127,1626.916609861397,1434.2407867114362,192.67582314996093,0.7847507153122408,0.784988637593334,-609
834,2019-04-15,2019,242374,242374,375455464.9333331,3591688.5500000017,187324,0,47,0.8477146888692684,35450838,4494691339,243373,243373,451277,694650,332223321.05001354,3585343.8333332087,188237,0,43,0.2992902900741372,3943795549,-999,-999,43232143.88331956,6344.716666792985,-913,0,4,0.5484243987951312,-3908344711,1549.074838610301,1365.0787928406749,183.9960457696261,0.772871677655194,0.7734506292809802,-913
835,2019-04-16,2019,240667,240667,375711767.46666694,3532212.0833333354,189278,0,52,0.8579115541391219,34029045,4492961135,241643,241643,457361,699004,332578344.30000997,3526918.2333334973,189959,0,48,0.29812275752356476,3943703490,-976,-976,43133423.16665697,5293.849999838043,-681,0,4,0.5597887966155571,-3909674445,1561.1270654749796,1376.3210368188193,184.80602865616038,0.7864725949133035,0.7861142263587193,-681
836,2019-04-17,2019,236522,236522,375594106.0499999,3468452.5666666673,185779,0,56,0.8553749756893654,28656198,4489339915,237498,237498,472189,709687,332602654.2500119,3463429.316666688,186515,0,60,0.28790015880238246,3943651126,-976,-976,42991451.79998797,5023.249999979511,-736,0,-4,0.567474816886983,-3914994928,1587.9880351510637,1400.4440216339167,187.54401351714705,0.7854618175053484,0.7853329291194031,-736
837,2019-04-18,2019,244168,244168,376532581.2499997,3630323.133333334,191426,0,52,0.8616813013990362,35260101,4498864341,247490,247490,477017,724507,333658062.8166609,3627390.6999999406,192650,0,50,0.2932559657808668,3948136545,-3322,-3322,42874518.43333882,2932.4333333931863,-1224,0,2,0.5684253356181694,-3912876444,1542.104539702171,1348.167856546369,193.93668315580203,0.7839929884341929,0.7784152895066467,-1224
838,2019-04-19,2019,245875,245875,376930957.45000005,3655585.966666668,193731,0,58,0.8717925775292324,36127808,4502583514,256341,256341,489718,746059,333978027.41665375,3651537.766666646,200061,0,47,0.29753544960921313,3953610853,-10466,-10466,42952930.033346295,4048.2000000220723,-6330,0,11,0.5742571279200193,-3917483045,1533.0186373157094,1302.8662110885646,230.15242622714482,0.7879247585155058,0.7804486991936522,-6330
839,2019-04-20,2019,245767,245767,377227293.39999956,3664370.416666664,192917,0,61,0.8678504437129467,36301894,4506334175,246845,246845,500263,747108,328159671.4166621,3658793.516666583,193806,0,48,0.2891817515004539,3837372517,-1078,-1078,49067621.98333746,5576.900000081398,-889,0,13,0.5786686922124928,-3801070623,1534.8980676819897,1329.415914507736,205.48215317425365,0.7849589245098,0.7851323705159108,-889
840,2019-04-21,2019,241842,241842,376558844.4166666,3634063.766666665,190661,0,57,0.8703409664160899,36497528,4494175852,242803,242802,512636,755439,327452293.6333302,3627524.416666611,191519,0,54,0.28292290972533285,3840913718,-961,-960,49106550.7833364,6539.35000005411,-858,0,3,0.5874180566907571,-3804416190,1557.044865725005,1348.6391942131047,208.4056715119002,0.7883700928705518,0.7887834993801559,-858
841,2019-04-22,2019,240221,240221,376305971.4833332,3598875.133333327,189949,0,62,0.8750483929381696,36001313,4490195411,241173,241173,525058,766231,327474779.65000844,3593680.416666152,190776,0,62,0.27873970121282826,3849061952,-952,-952,48831191.83332473,5194.716667174827,-827,0,0,0.5963086917253413,-3813060639,1566.4990632931058,1357.8417967600371,208.65726653306865,0.7907260397717102,0.7910338221940267,-827
842,2019-04-23,2019,238023,238023,376295414.41666627,3573238.3333333307,187084,0,73,0.8679371321258871,35218157,4492366947,239082,239082,536448,775530,327649995.2666605,3568663.3166666236,187882,0,73,0.2699237940505166,3853924074,-1059,-1059,48645419.15000576,4575.016666707117,-798,0,0,0.5980133380753705,-3818705917,1580.9203917968696,1370.450285954863,210.47010584200666,0.7859912697512426,0.7858475334822362,-798
843,2019-04-24,2019,238987,238987,376275259.56666654,3564957.7000000044,187252,0,79,0.8605405314933453,34762729,4494332275,239925,239925,547468,787393,327827274.5833272,3558852.199999947,188035,0,79,0.2647458130819025,3854741502,-938,-938,48447984.98333937,6105.500000057276,-783,0,0,0.5957947184114428,-3819978773,1574.4591110255644,1366.3739692959348,208.08514172962964,0.7835237899969454,0.7837240804418047,-783
844,2019-04-25,2019,241242,241242,376548040.8833337,3590833.0166666633,189648,0,105,0.8598834365491901,34983391,4498654977,242096,242096,554752,796848,328261865.76666194,3585118.049999967,190371,0,106,0.2627125875951248,3857651247,-854,-854,48286175.11667174,5714.9666666961275,-723,0,-1,0.5971708489540652,-3822667856,1560.872654360906,1355.9161066959468,204.9565476649591,0.7861317681000821,0.7863450862467781,-723
845,2019-04-26,2019,239537,239537,376700157.60000044,3620926.2000000067,190677,0,96,0.8708425003235408,35143037,4500864967,240328,240328,566487,806815,328654419.18333304,3615653.8499994534,191345,0,96,0.2612284104782475,3862212442,-791,-791,48045738.4166674,5272.350000553299,-668,0,0,0.6096140898452933,-3827069405,1572.6178319007104,1367.52446316423,205.09336873648044,0.7960231613487687,0.7961827169534968,-668
846,2019-04-27,2019,238031,238031,376696782.95,3616954.6166666667,189353,0,136,0.8798853930790524,36143876,4502731233,239029,239029,576015,815044,328813587.1499935,3611430.883333304,190206,0,136,0.26236006890425534,3869521919,-998,-998,47883195.80000651,5523.733333362732,-853,0,0,0.6175253241747971,-3833378043,1582.5534613138625,1375.6221510778755,206.93131023598698,0.7954972251513458,0.7957444494182714,-853
847,2019-04-28,2019,236467,236467,375653721.8166665,3606833.7666666615,188174,0,249,0.8896125040703335,34123206,4488125274,237429,237429,588344,825773,327923814.4333265,3600960.983333258,188979,0,249,0.25934609148034216,3877020167,-962,-962,47729907.38334,5872.783333403524,-805,0,0,0.6302664125899914,-3842896961,1588.6094965329896,1381.1447398309663,207.46475670202335,0.7957727716763862,0.7959389965000063,-805
848,2019-04-29,2019,240730,240730,375274575.43333316,3634884.350000001,192340,0,354,0.8834087982386906,35784051,4485267210,242039,242039,596740,838779,327899653.5166698,3629438.0333328433,193274,0,354,0.25634285073897983,3882205745,-1309,-1309,47374921.91666335,5446.316667157691,-934,0,0,0.6270659474997107,-3846421694,1558.9024028302795,1354.738920242894,204.1634825873855,0.7989864163170357,0.7985242047769161,-934
849,2019-04-30,2019,239599,239599,373438540.533334,3501476.733333336,191360,0,427,0.8792649385014129,33807721,4468018290,240632,240632,604438,845070,326348040.0500004,3497569.1499996656,192104,0,427,0.25187735927201593,3874721392,-1033,-1033,47090500.48333359,3907.5833336706273,-744,0,0,0.6273875792293969,-3840913671,1558.5980765083912,1356.2121415688705,202.38593493952067,0.7986677740725128,0.7983310615379501,-744
850,2019-05-01,2019,220368,220368,370761125.23333305,3351744.1500000013,173540,0,513,0.8629928120235246,32464542,4450272678,224784,224784,282573,507357,323817149.7833357,3351731.333333132,174941,0,518,0.38026084197123666,3817622955,-4416,-4416,46943975.449997365,12.816666869446635,-1401,0,-5,0.48273197005228796,-3785158413,1682.4635393221024,1440.5702798390264,241.893259483076,0.7875009075727873,0.7782626877357819,-1401
851,2019-05-02,2019,227427,227427,371098791.6333335,3511812.1500000022,178605,0,582,0.8608080834729384,35098622,4454745251,228221,228221,296453,524674,324114227.63333285,3504136.7333330894,179208,0,584,0.3758791173185619,3821289349,-794,-794,46984564.000000656,7675.416666912846,-603,0,-2,0.4849289661543765,-3786190727,1631.7270668536871,1420.1770548430375,211.55001201064965,0.7853289187299661,0.7852388693415593,-603
852,2019-05-03,2019,227970,227970,371005242.45000076,3526976.983333334,178888,0,574,0.8634688774838799,35364174,4456020179,233631,233631,297519,531150,324141882.3666717,3524113.749999768,180099,0,574,0.37510119551915494,3814396773,-5661,-5661,46863360.08332908,2863.2333335657604,-1211,0,0,0.48836768196472496,-3779032599,1627.4301111988452,1387.4095576643153,240.02055353452988,0.7846997411940168,0.7708694479756539,-1211
853,2019-05-04,2019,221924,221924,370936456.1833331,3473569.4000000013,174682,0,436,0.872559975487103,31754210,4453620074,222866,222866,315197,538063,323533455.8166671,3467217.5333330184,175468,0,439,0.36558730111529963,3810380387,-942,-942,47403000.36666602,6351.866666982882,-786,0,-3,0.5069726743718033,-3778626177,1671.4571483180418,1451.6949907866929,219.76215753134898,0.7871253221823687,0.7873251191298808,-786
854,2019-05-05,2019,220695,220695,370944550.5666666,3427842.6333333347,174112,0,360,0.8635718978680994,34513239,4457724919,221315,221315,322381,543696,323519184.50000477,3422144.399999896,174639,0,360,0.3531753038462588,3816104509,-620,-620,47425366.066661835,5698.233333438635,-527,0,0,0.5103965940218407,-3781591270,1680.801787836909,1461.8041456747385,218.99764216217045,0.788925893201024,0.789096988455369,-527
855,2019-05-06,2019,221079,221079,371158036.01666725,3444260.8833333296,175046,0,66,0.8743752233364549,34336906,4461822757,222171,222171,336529,558700,323881539.7666733,3438532.2499998165,175977,0,54,0.3514193663862516,3823279778,-1092,-1092,47276496.24999392,5728.633333513048,-931,0,12,0.5229558569502033,-3788942872,1678.8479955883067,1457.8029525305883,221.04504305771843,0.79178031382447,0.7920790742266093,-931
856,2019-05-07,2019,227347,227347,371853590.3000004,3516426.150000001,177806,0,65,0.8768710385446037,34167366,4467950949,228532,228532,338450,566982,324711910.8333378,3509842.1166665126,178851,0,57,0.3589867050453144,3821998243,-1185,-1185,47141679.466662645,6584.033333488274,-1045,0,8,0.5178843334992893,-3787830877,1635.6212762869113,1420.8597081955165,214.7615680913948,0.7820908127224023,0.7826081249015455,-1045
857,2019-05-08,2019,228216,228216,372122677.4833331,3516579.916666663,178109,0,68,0.8633619027587893,34049238,4471125958,229890,229890,347209,577099,325196647.0500047,3509805.3166664606,179300,0,68,0.345876530716568,3828783127,-1674,-1674,46926030.43332839,6774.60000020219,-1191,0,0,0.5174853720422213,-3794733889,1630.5722538443104,1414.5750013049924,215.99725253931797,0.7804404599151681,0.7799382313280264,-1191
858,2019-05-09,2019,227205,227205,372584843.1499996,3529860.6999999965,178861,0,53,0.8677361853832442,35014935,4476804472,228467,228467,356981,585448,325445397.8000078,3524072.1666665226,179751,0,52,0.34053921099739154,3826793142,-1262,-1262,47139445.3499918,5788.533333473839,-890,0,1,0.5271969743858527,-3791778207,1639.8619887326406,1424.4744221266433,215.38756660599734,0.7872229924517506,0.7867700805805653,-890
859,2019-05-10,2019,233666,233666,373281070.9499999,3544603.5333333327,182988,0,60,0.8699596860476063,35899489,4483888443,234881,234881,363219,598100,326301833.4833425,3538205.483333203,183990,0,54,0.3450660424678124,3831171940,-1215,-1215,46979237.4666574,6398.050000129733,-1002,0,6,0.524893643579794,-3795272451,1597.4984420069668,1389.2219186879422,208.2765233190246,0.7831177835029487,0.7833328366279094,-1002
860,2019-05-11,2019,230845,230845,373606624.90000015,3518756.150000005,181597,0,66,0.87483376291451,35635472,4486980757,232182,232182,372924,605106,326724469.85001236,3513090.3166664867,182719,0,60,0.33961487739338164,3838592922,-1337,-1337,46882155.04998779,5665.833333518356,-1122,0,6,0.5352188855211284,-3802957450,1618.4306565011161,1407.1912114204044,211.23944508071168,0.786662045961576,0.7869645364412401,-1122
861,2019-05-12,2019,224592,224592,374187467.9666663,3491538.3666666686,178340,0,59,0.8694655196979417,34730245,4493283489,225291,225291,383187,608478,327449334.46667886,3485339.133333112,178932,0,57,0.32343486535257304,3851315656,-699,-699,46738133.49998742,6199.233333556447,-592,0,2,0.5460306543453687,-3816585411,1666.0765653570309,1453.4505793248682,212.6259860321627,0.7940621215359407,0.7942261341997683,-592
862,2019-05-13,2019,224170,224170,374311972.9333335,3473934.266666666,178137,0,109,0.8707275728241965,34406514,4496045831,224859,224859,395863,620722,327727998.4166782,3468793.5499998513,178771,0,109,0.31775899678116865,3862578959,-689,-689,46583974.516655326,5140.716666814871,-634,0,0,0.5529685760430278,-3828172445,1669.7683585374202,1457.4822373873324,212.28612115008787,0.7946513806486148,0.7950360003379896,-634
863,2019-05-14,2019,230597,230597,374726772.6333336,3477443.8833333324,179718,0,184,0.858055395343391,34672923,4500120353,231497,231497,400113,631610,328337193.4833441,3471782.799999904,180439,0,186,0.3168315891135375,3861572588,-900,-900,46389579.149989545,5661.0833334284835,-721,0,-2,0.5412238062298536,-3826899665,1625.0288279263548,1418.3215915685478,206.707236357807,0.7793596620944765,0.779444226059085,-721
864,2019-05-15,2019,229185,229185,372515484.7666664,3475140.5833333377,179227,0,114,0.8598948447760545,35083526,4494530727,236183,236183,412969,649152,326455635.68334115,3493005.6499998346,181119,0,114,0.30891840431825063,3868213979,-6998,-6998,46059849.08332527,-17865.066666496918,-1892,0,0,0.5509764404578039,-3833130453,1625.3920839787352,1382.2147897322886,243.17729424644654,0.7820188930340118,0.7668587493596067,-1892
865,2019-05-16,2019,228001,228001,373109566.5166662,3543949.750000003,181884,0,112,0.87474616339402,35613844,4500259602,239270,239270,419486,658756,326782851.28334236,3602211.8999998523,185889,0,113,0.31247836831847936,3861803747,-11269,-11269,46326715.23332381,-58262.1499998495,-4005,0,-1,0.5622677950755406,-3826189903,1636.4382898174401,1365.749368008285,270.6889218091551,0.7977333432748102,0.7769005725749154,-4005
866,2019-05-17,2019,223615,223615,373522897.0166667,3491418.333333335,179680,0,55,0.8763231446906513,35091500,4506547225,235056,235056,430025,665081,324912029.3833388,3558091.899999844,183424,0,52,0.30230002059899924,3828860847,-11441,-11441,48610867.6333279,-66673.56666650902,-3744,0,3,0.574023124091652,-3793769347,1670.3839054476073,1382.2749871662022,288.10891828140507,0.8035239138698209,0.7803417058062759,-3744
867,2019-05-18,2019,222203,222203,373573128.13333297,3470168.333333335,178858,0,64,0.8724814696471246,35550133,4509367411,230066,230066,441825,671891,323221198.9833468,3484143.6833331613,181403,0,64,0.29426945739710175,3811735977,-7863,-7863,50351929.14998615,-13975.349999826401,-2545,0,0,0.5782120122500228,-3776185844,1681.2245025194663,1404.9064137393045,276.3180887801618,0.8049306264991922,0.7884824354750376,-2545
868,2019-05-19,2019,221823,221823,373914384.2500002,3437489.5666666687,177707,0,116,0.8699864306226148,35021798,4515425057,222468,222468,451391,673859,321957580.9666786,3431849.3666665745,178271,0,116,0.28864792189463734,3801043946,-645,-645,51956803.28332156,5640.20000009425,-564,0,0,0.5813385087279774,-3766022148,1685.6429867506984,1447.2085017471215,238.4344850035768,0.801120713361554,0.8013332254526494,-564
869,2019-05-20,2019,225369,225369,374590325.6166662,3483146.383333327,178325,0,104,0.8601537922251958,35589937,4526681602,226026,226026,458408,684434,322779844.53333914,3477843.3166665453,178873,0,105,0.2857894260074766,3809734407,-657,-657,51810481.083327055,5303.066666781437,-548,0,-1,0.5743643662177192,-3774144470,1662.1200148053467,1428.0651099136344,234.05490489171234,0.7912578926116725,0.7913824073336696,-548
870,2019-05-21,2019,234670,234670,375434723.4333332,3601193.6833333354,183638,0,110,0.8539864490561212,35875725,4534420211,235657,235657,460786,696443,323821533.0833436,3595127.0833332054,184356,0,110,0.289888763330229,3817296571,-987,-987,51613190.34998959,6066.600000130013,-718,0,0,0.5640976857258921,-3781420846,1599.8411532506636,1374.1222755247823,225.71887772588138,0.7825371798696041,0.7823064878191609,-718
871,2019-05-22,2019,239622,239622,376176185.1666665,3638824.333333331,187353,0,175,0.8571792239443785,35372846,4539812169,240579,240579,466481,707060,324778741.5833302,3632660.783333254,188074,0,175,0.292747433032559,3824494081,-957,-957,51397443.58333629,6163.5500000771135,-721,0,0,0.5644317909118195,-3789121235,1569.8733220099427,1349.9879107624947,219.88541124744802,0.7818689435861482,0.7817556810860465,-721
872,2019-05-23,2019,238960,238960,376819878.05000067,3629904.1666666646,186468,0,131,0.8518413123535321,36071571,4545171643,239890,239890,476079,715969,325766643.80000484,3622891.5333327143,187142,0,133,0.2863741307235333,3834924923,-930,-930,51053234.24999583,7012.6333339503035,-674,0,-2,0.5654671816299988,-3798853352,1576.9161284315394,1357.9834249031007,218.93270352843865,0.7803314362236358,0.7801158864479553,-674
873,2019-05-24,2019,237138,237138,377405288.7833331,3607404.1500000013,186496,0,76,0.856497060783173,36210281,4550810269,237969,237969,488085,726054,326501013.86666286,3600224.2666665763,187181,0,76,0.28210160676754215,3843499998,-831,-831,50904274.91667026,7179.883333425038,-685,0,0,0.5743954540156309,-3807289717,1591.500682232848,1372.0317094523357,219.46897278051233,0.786445023572772,0.7865772432543735,-685
874,2019-05-25,2019,232053,232053,377303266.3,3571396.1666666665,182746,0,93,0.8538997556592673,35382398,4551642881,232826,232826,499968,732794,326687061.84999424,3564733.6833332623,183368,0,93,0.2724558334265836,3852465066,-773,-773,50616204.45000577,6662.483333404176,-622,0,0,0.5814439222326837,-3817082668,1625.9357401110954,1403.1382313401177,222.79750877097763,0.7875183686485415,0.787575270803089,-622
875,2019-05-26,2019,219501,219501,376989901.80000025,3448219.3333333293,175981,0,58,0.8697181334025806,36043495,4552153103,220221,220221,512740,732961,326610635.15000683,3443083.616666127,176464,0,58,0.26308903202214773,3866915012,-720,-720,50379266.64999342,5135.716667202301,-483,0,0,0.6066291013804329,-3830871517,1717.4860333210338,1483.1039508039962,234.3820825170376,0.8017321105598608,0.8013041444730521,-483
876,2019-05-27,2019,221382,221382,377402740.266667,3485495.3666666667,179105,0,177,0.8766882583046495,34714980,4559594684,221983,221983,524844,746827,327200157.8166596,3480639.9499999173,179635,0,178,0.2621919132543433,3879873411,-601,-601,50202582.45000738,4855.416666749399,-530,0,-1,0.6144963450503061,-3845158431,1704.7580212784553,1473.9874576731536,230.77056360530173,0.809031447904527,0.809228634625174,-530
877,2019-05-28,2019,232229,232229,378023814.83333355,3559851.2166666607,182521,0,69,0.8679665330342037,35728325,4565393747,233112,233112,526868,759980,328056359.0833398,3553641.4999994976,183301,0,58,0.271259769993958,3881558187,-883,-883,49967455.74999374,6209.716667163186,-780,0,11,0.5967067630402456,-3845829862,1627.8062379519076,1407.2907404309508,220.51549752095684,0.7859526587979968,0.7863215964858093,-780
878,2019-05-29,2019,232395,232395,378318588.4166666,3543034.0166666675,183596,0,103,0.8597861399771943,35161313,4567221353,233167,233167,533239,766406,328535295.3500063,3535886.1999995755,184259,0,103,0.2635300349945212,3888563484,-772,-772,49783293.066660345,7147.816667092033,-663,0,0,0.5962561049826731,-3853402171,1627.9119103968098,1409.0128335056258,218.899076891184,0.7900169969233417,0.7902447601933378,-663
879,2019-05-30,2019,227765,227765,377235863.16666687,3514664.9333333364,183318,0,251,0.870888854740633,34994332,4555125731,233990,233990,544637,778627,327675205.4833266,3512512.766666595,185602,0,251,0.2587837308492984,3895411690,-6225,-6225,49560657.68334025,2152.166666741483,-2284,0,0,0.6121051238913346,-3860417358,1656.250359654323,1400.3812363063662,255.8691233479567,0.8048558821592431,0.7932048378135818,-2284
880,2019-05-31,2019,235012,235012,377415005.6833332,3554996.8833333324,187690,0,305,0.8793721171684851,35341640,4555375855,245048,245048,548521,793569,325720485.08333915,3552384.966666147,192480,0,305,0.2700332296246475,3858227248,-10036,-10036,51694520.59999406,2611.916667185258,-4790,0,0,0.6093388875438376,-3822885608,1605.939295369314,1329.2109508477488,276.7283445215653,0.7986400694432625,0.7854787633443244,-4790
881,2019-06-01,2019,236196,236196,377486071.6666669,3560196.716666665,186700,0,71,0.862444749276025,36243308,4557749912,236913,236913,269322,506235,323044984.4166678,3553019.066666379,187491,0,75,0.4082945667525938,3766822702,-717,-717,54441087.249999106,7177.650000285823,-791,0,-4,0.4541501825234312,-3730579394,1598.1899425336032,1363.559553155242,234.63038937836131,0.7904452234584837,0.7913917767281661,-791
882,2019-06-02,2019,232943,232943,377548146.4,3531151.066666668,183747,0,80,0.8686974925196295,36671319,4561352817,233890,233890,279173,513063,323247577.0666734,3524629.199999838,184602,0,79,0.40568702089217223,3772354888,-947,-947,54300569.33332658,6521.866666829679,-855,0,1,0.46301047162745723,-3735683569,1620.774809288109,1382.0495834224353,238.7252258656738,0.7888067037859047,0.7892684595322588,-855
883,2019-06-03,2019,227461,227461,377623296.4500002,3501567.4166666614,179630,0,67,0.8646713062898687,35365334,4564887097,228505,228505,295213,523718,323564338.2500026,3496539.216666424,180556,0,54,0.3862593991422874,3782496463,-1044,-1044,54058958.199997604,5028.200000237208,-926,0,13,0.47841190714758125,-3747131129,1660.1672218534177,1416.0055064440717,244.16171540934602,0.7897177977763221,0.7901621408721909,-926
884,2019-06-04,2019,228632,228632,377824360.86666673,3497591.400000002,180896,0,71,0.8635930228489453,34669994,4568739633,229704,229704,301856,531560,323974847.133339,3493004.6333331275,181680,0,62,0.3776845511325125,3785936058,-1072,-1072,53849513.73332775,4586.7666668742895,-784,0,9,0.48590847171643287,-3751266064,1652.5436547231652,1410.4014171862004,242.14223753696479,0.7912103292627454,0.7909309372061436,-784
885,2019-06-05,2019,228406,228406,378138853.61666656,3501519.566666667,181336,0,141,0.8661681391907399,34492537,4574293807,229893,229893,311121,541014,324373535.20000803,3497194.4833330815,182433,0,141,0.37348756224422486,3792856311,-1487,-1487,53765318.41665852,4325.083333585411,-1097,0,0,0.492680576946515,-3758363774,1655.5556930057292,1410.9761288947816,244.57956411094756,0.7939195993100007,0.7935561326356174,-1097
886,2019-06-06,2019,223358,223358,378377436.26666707,3461276.849999999,180046,0,197,0.8908299680333811,34421726,4576106009,225122,225122,321237,546359,324718282.7500062,3458964.0166664757,181148,0,198,0.3814451670055731,3796366081,-1764,-1764,53659153.51666087,2312.8333335234784,-1102,0,-1,0.5093848010278079,-3761944355,1694.0402236170949,1442.4102608807943,251.6299627363005,0.8060870888886899,0.8046659144819254,-1102
887,2019-06-07,2019,223967,223967,378564319.1666665,3484438.516666668,180746,0,185,0.8778837953805695,33764219,4577728187,224738,224738,331929,556667,324896562.76667315,3481051.8499997896,181297,0,185,0.35709679215760975,3801797650,-771,-771,53667756.39999336,3386.6666668783873,-551,0,0,0.5207870032229598,-3768033431,1690.268294733896,1445.6681236224988,244.60017111139723,0.8070206771533306,0.8067038062098978,-551
888,2019-06-08,2019,226958,226958,378804097.566666,3516237.0333333346,181302,0,218,0.8700728769199582,35015772,4581326347,227679,227679,338839,566518,325292246.1666779,3511125.6666665487,181860,0,218,0.3537504545310078,3808598502,-721,-721,53511851.399988115,5111.366666785907,-558,0,0,0.5163224223889504,-3773582730,1669.049328803858,1428.731882021082,240.3174467827762,0.7988350267450365,0.7987561435178475,-558
889,2019-06-09,2019,232378,232378,378896579.3500002,3512292.4499999965,183086,0,193,0.8523956656826376,35394488,4582991594,233367,233367,348180,581547,325583208.1666746,3506010.9333331496,183736,0,193,0.3441321165787168,3820898174,-989,-989,53313371.18332559,6281.5166668468155,-650,0,0,0.5082635491039208,-3785503686,1630.5182906729563,1395.1553054488193,235.362985224137,0.7878800919192006,0.787326400047993,-650
890,2019-06-10,2019,231271,231271,376069306.7333335,3515885.166666666,180406,0,193,0.8467036506955044,34295091,4546716885,233155,233155,359521,592676,322482588.4000058,3506899.1999999527,181473,0,194,0.33536535982560595,3786576575,-1884,-1884,53586718.33332771,8985.966666713357,-1067,0,-1,0.5113382908698985,-3752281484,1626.0979834624036,1383.1253389376416,242.97264452476202,0.7800632158809362,0.7783362998863417,-1067
891,2019-06-11,2019,230005,230005,372923800.9000001,3501599.449999995,174728,0,190,0.8209778048303296,33791589,4501037812,231997,231997,368040,600037,319373070.18334246,3493937.0333332606,175891,0,190,0.3184453625359708,3744983075,-1992,-1992,53550730.71665764,7662.416666734498,-1163,0,0,0.5025324422943588,-3711191486,1621.3725827699402,1376.6258623315925,244.74672043834767,0.7596704419469142,0.7581606658706793,-1163
892,2019-06-12,2019,226317,226317,368803098.2666668,3504832.9333333354,174083,0,75,0.8339497253851896,33864480,4451139203,227157,227157,378174,605331,316482870.76667076,3500270.766666567,174740,0,79,0.31435198263429737,3706731839,-840,-840,52320227.499996066,4562.166666768491,-657,0,-4,0.5195977427508922,-3672867359,1629.5863689721357,1393.23406615984,236.35230281229565,0.769199839163651,0.7692477009293132,-657
893,2019-06-13,2019,227314,227314,369007279.4833337,3517799.7000000053,175491,0,57,0.8379422296910884,34929650,4450473302,228026,228026,382797,610823,316925549.8000121,3511759.3333331784,176093,0,58,0.3144413357060892,3715041039,-712,-712,52081729.683321595,6040.366666826885,-602,0,-1,0.5235008939849992,-3680111389,1623.3372316853943,1389.8658477542565,233.47138393113778,0.7720202011314745,0.772249655741012,-602
894,2019-06-14,2019,230384,230384,369585455.59999967,3530682.050000004,178516,0,51,0.8454753802347391,36338896,4459041138,234073,234073,391376,625449,317705725.08334786,3525794.999999859,180226,0,44,0.316750046766403,3721036979,-3689,-3689,51879730.51665181,4887.0500001451,-1710,0,7,0.5287253334683362,-3684698083,1604.214943746092,1357.2933447400933,246.92159900599881,0.7748628376970623,0.769956381128964,-1710
895,2019-06-15,2019,226933,226933,369855421.6666667,3539288.01666667,177095,0,65,0.8487086496895556,36440034,4465691659,227646,227646,400446,628092,317359903.9166813,3534120.233333177,177621,0,66,0.3096568655547314,3713265516,-713,-713,52495517.7499854,5167.783333492931,-526,0,-1,0.5390517841348242,-3676825482,1629.8000804936553,1394.093917383487,235.7061631101683,0.7803845187786703,0.7802509158957328,-526
896,2019-06-16,2019,227084,227084,370320197.36666685,3513642.2999999984,176725,0,46,0.8424944073558683,36918958,4470838531,227749,227749,408461,636210,318014555.9333449,3508746.433332982,177264,0,40,0.30345011867150123,3727377830,-665,-665,52305641.43332195,4895.866667016409,-539,0,6,0.5390442886843672,-3690458872,1630.76305405342,1396.337880444458,234.42517360896204,0.7782362473798242,0.7783305305402,-539
897,2019-06-17,2019,233633,233633,371317888.4500003,3577260.1166666644,180225,0,49,0.8400868028061119,37129155,4484546205,234614,234614,418739,653353,319120083.9166762,3572587.7666665083,180949,0,41,0.30377452923610654,3741378803,-981,-981,52197804.53332406,4672.35000015609,-724,0,8,0.5363122735700054,-3704249648,1589.3212365119666,1360.1919915975868,229.1292449143798,0.7714021563734575,0.7712625845004987,-724
898,2019-06-18,2019,226147,226147,371563413.4500006,3535984.3833333263,176721,0,49,0.8455871623324651,35997899,4488321029,231773,231773,425846,657619,319588639.6666769,3532224.1166665293,179190,0,41,0.2963053074804745,3745736743,-5626,-5626,51974773.783323705,3760.2666667969897,-2469,0,8,0.5492818548519907,-3709738844,1643.0172120346526,1378.8864089720412,264.13080306261145,0.7814430436839754,0.7731271545865999,-2469
899,2019-06-19,2019,228109,228109,372222518.3500003,3560352.0999999996,178015,0,121,0.8443331915882322,36292423,4494472134,228944,228944,434721,663665,319111445.66667306,3555094.5166665493,178667,0,121,0.2932247444117133,3731534350,-835,-835,53111072.68332726,5257.5833334503695,-652,0,0,0.5511084471765189,-3695241927,1631.7748021779075,1393.840614589913,237.93418758799453,0.780394460542986,0.7803960793905933,-652
900,2019-06-20,2019,229655,229655,372858907.83333397,3550756.38333333,178748,0,171,0.8439746576386318,36253821,4503095601,230555,230555,441549,672104,319814101.81667495,3545271.0666665253,179369,0,171,0.29193398640686746,3743045480,-900,-900,53044806.01665902,5485.31666680472,-621,0,0,0.5520406712317643,-3706791659,1623.561027773547,1387.1488443827934,236.41218339075363,0.7783327164660033,0.7779878987660211,-621
901,2019-06-21,2019,227675,227675,373401668.83333284,3530384.7166666677,178138,0,51,0.8429647523882734,35743297,4510447021,228667,228667,451870,680537,320640055.4500144,3529093.3999998663,178742,0,52,0.2843974684697511,3752794884,-992,-992,52761613.383318424,1291.31666680146,-604,0,-1,0.5585672839185223,-3717051587,1640.0644288276396,1402.2139418893605,237.85048693827912,0.7824223125068629,0.7816694144760722,-604
902,2019-06-22,2019,228056,228056,373564795.3499997,3547187.6999999983,178489,0,41,0.8432753358824154,35444054,4511781307,228810,228810,461367,690177,321027527.6333462,3542436.14999987,179122,0,37,0.2817813401489783,3764107317,-754,-754,52537267.716653526,4751.550000128336,-633,0,4,0.5614939957334371,-3728663263,1638.0397593135008,1403.0310197690058,235.00873954449503,0.7826542603571053,0.7828416590183995,-633
903,2019-06-23,2019,232556,232556,374190533.7166668,3554913.633333334,181097,0,37,0.8402234300555562,36197854,4520688435,233310,233310,468296,701606,321778296.7500144,3548616.266666534,181740,0,36,0.2808556369244311,3776969295,-754,-754,52412236.96665239,6297.366666799877,-643,0,1,0.5593677931311252,-3740771441,1609.0340980953697,1379.1877619905465,229.8463361048232,0.7787242642632313,0.778963610646779,-643
904,2019-06-24,2019,234139,234139,374890218.15000015,3586973.1500000013,180356,0,36,0.8359991287226816,36300414,4529046908,235226,235226,479363,714589,322628833.76666725,3579915.999999549,181302,0,32,0.27742240644621946,3788363916,-1087,-1087,52261384.38333291,7057.15000045253,-946,0,4,0.5585767222764622,-3752063502,1601.1438425465221,1371.5696129112737,229.57422963524846,0.7702945686109534,0.7707566340455562,-946
905,2019-06-25,2019,234391,234391,375121606.3166664,3620773.8833333342,180647,0,42,0.8334620356583663,36215404,4529081429,235608,235608,484000,719608,323033503.55000764,3613445.566666159,181497,0,42,0.2743771608987122,3793789618,-1217,-1217,52088102.76665878,7328.316667175386,-850,0,0,0.5590848747596541,-3757574214,1600.4095989891525,1371.0633915232404,229.34620746591213,0.7707079196726837,0.7703346236121015,-850
906,2019-06-26,2019,226404,226404,375345528.63333374,3570968.933333336,178580,0,36,0.8480503878023351,35387700,4532735185,227247,227247,493992,721239,323501160.00001055,3565221.7499994403,179171,0,34,0.2679527868016127,3801057126,-843,-843,51844368.63332319,5747.183333895635,-591,0,2,0.5800976010007224,-3765669426,1657.8573198058946,1423.5662516997388,234.29106810615576,0.7887669829154962,0.7884416515949606,-591
907,2019-06-27,2019,229748,229748,375540736.5333334,3571931.633333333,178947,0,40,0.8410736981388298,35223192,4535316933,235879,235879,501346,737225,323948112.9000001,3579006.8833332406,180789,0,35,0.26630133270033113,3811012046,-6131,-6131,51592623.633333325,-7075.249999907799,-1842,0,5,0.5747723654384986,-3775788854,1634.5767385715367,1373.3656361948292,261.21110237670746,0.7788838205338022,0.7664480517553491,-1842
908,2019-06-28,2019,234731,234731,376292969.15,3590100.433333331,182628,0,43,0.844191862174149,35992700,4543254642,239495,239495,510903,750398,324434789.38333106,3584492.4999999213,183951,0,43,0.26764330395337144,3815070526,-4764,-4764,51858179.766668916,5607.9333334094845,-1323,0,0,0.5765485582207776,-3779077826,1603.0816941520293,1354.6620571758535,248.41963697617575,0.7780310227451849,0.7680786655253763,-1323
909,2019-06-29,2019,232611,232611,376214407.86666656,3585286.283333331,181714,0,35,0.8433436079979014,36430455,4543898214,239666,239666,520209,759875,323821906.2666641,3595869.51666615,185682,0,35,0.26448034216154676,3809707664,-7055,-7055,52392501.60000247,-10583.233332819305,-3968,0,0,0.5788632658363546,-3773277209,1617.3543291876417,1351.138276879758,266.21605230788373,0.7811926349140841,0.7747531982008294,-3968
910,2019-06-30,2019,228425,228425,376269029.36666614,3544138.4333333345,180049,0,37,0.8500120389624604,34903944,4546742295,229127,229127,528436,757563,320922554.48332846,3540217.2499999683,180572,0,33,0.2587269969626296,3749104645,-702,-702,55346474.88333768,3921.183333366178,-523,0,4,0.5912850419998308,-3714200701,1647.2322616467818,1400.631765280078,246.60049636670374,0.7882193280070044,0.7880869561422268,-523
911,2019-07-01,2019,227395,227395,376539170.38333386,3553451.9833333343,178221,0,36,0.8419886101277521,34416541,4552245160,228018,228018,268307,496325,321324396.7666633,3549562.4666663557,178755,0,36,0.3877902583992326,3725077559,-623,-623,55214773.61667055,3889.5166669785976,-534,0,0,0.45419835172851947,-3690661018,1655.8814854474983,1409.2062765512517,246.67520889624666,0.7837507421007498,0.7839512670052364,-534
912,2019-07-02,2019,225518,225518,376756260.2499995,3538507.533333338,177154,0,38,0.8394540568823771,34820217,4555398039,225978,225978,276676,502654,321743157.08333385,3533985.899999682,177543,0,38,0.37842929728998387,3729382635,-460,-460,55013103.16666567,4521.633333656006,-389,0,0,0.4610247595923932,-3694562418,1670.6261152103136,1423.78088611871,246.84522909160364,0.7855426174407364,0.7856649762366248,-389
913,2019-07-03,2019,229282,229282,377058083.6666667,3563252.0500000096,178394,0,32,0.831534965675456,35397920,4560704744,230082,230082,286277,516359,322270274.4499999,3558111.199999717,178985,0,28,0.37166196386622685,3737864883,-800,-800,54787809.21666676,5140.850000292528,-591,0,4,0.4598730018092292,-3702466963,1644.516724673837,1400.6757349553634,243.84098971847357,0.7780549716070166,0.7779183073860624,-591
914,2019-07-04,2019,227498,227498,377219790.63333327,3564117.783333335,178849,0,34,0.8444425885062724,35416517,4561901134,228344,228344,296472,524816,322745620.5833361,3559402.933333042,179498,0,32,0.3696209719215879,3748321970,-846,-846,54474170.04999715,4714.850000292994,-649,0,2,0.4748216165846845,-3712905453,1658.1235467271504,1413.4184414012898,244.7051053258606,0.7861563618141698,0.7860859054759486,-649
915,2019-07-05,2019,230426,230426,378003267.0333331,3580981.8333333307,182072,0,33,0.8469052971452871,36122892,4572013639,231212,231212,304332,535544,323710719.8000051,3575809.483333086,182638,0,33,0.3667467098875172,3759451165,-786,-786,54292547.233328044,5172.350000244565,-566,0,0,0.4801585872577699,-3723328273,1640.454059148417,1400.0602036226712,240.39385552574572,0.7901538888840669,0.7899157483175614,-566
916,2019-07-06,2019,225998,225998,378274930.0166663,3536964.2166666677,178421,0,26,0.8430472836042792,35164378,4578231602,233153,233153,315587,548740,324151168.10000956,3534080.7833331926,181480,0,26,0.35354448372635444,3769595003,-7155,-7155,54123761.91665673,2883.4333334751427,-3059,0,0,0.4895027998779247,-3734430625,1673.7976885488645,1390.293790343721,283.5038982051435,0.7894804378799812,0.778372999704057,-3059
917,2019-07-07,2019,223939,223939,378264632.7166668,3504624.2833333327,176884,0,38,0.8458687410410869,35542053,4580927083,224598,224598,326538,551136,322702396.166679,3500090.6333331326,177343,0,38,0.34575313534227786,3751584936,-659,-659,55562236.54998779,4533.650000200141,-459,0,0,0.500115605698809,-3716042883,1689.1413854516936,1436.7999544371678,252.34143101452582,0.7898758143958846,0.7896018664458276,-459
918,2019-07-08,2019,226944,226944,378779565.7499996,3550107.7833333355,178177,0,35,0.8439659122955445,36536755,4588309267,227651,227651,334754,562405,323393324.7500056,3544939.6833331934,178746,0,35,0.34283656795370027,3763701154,-707,-707,55386240.99999398,5168.10000014212,-569,0,0,0.5011293443418443,-3727164399,1669.0441948233906,1420.5662384527438,248.47795637064678,0.7851143894529047,0.7851755538082416,-569
919,2019-07-09,2019,226924,226924,379162912.0833335,3573839.583333332,179331,0,32,0.8480063809909917,37409133,4593910898,227785,227785,339424,567209,324060519.3666716,3569166.533333189,179982,0,32,0.34185987881010005,3767989072,-861,-861,55102392.71666187,4673.050000143237,-651,0,0,0.5061465021808916,-3730579939,1670.8806123783006,1422.6596104513976,248.221001926903,0.790268988736317,0.7901398248348223,-651
920,2019-07-10,2019,229501,229501,379563205.2333331,3572827.883333334,180550,0,35,0.8417174652833747,37514957,4600706492,230304,230304,348682,578986,324713966.0333463,3568096.633333172,181168,0,31,0.335643694320767,3779807322,-803,-803,54849239.199986815,4731.2500001615845,-618,0,4,0.5060737709626076,-3742292365,1653.8629689340487,1409.9362843604379,243.92668457361083,0.7867068117350251,0.7866472141169932,-618
921,2019-07-11,2019,232791,232791,379754991.80000085,3603708.633333327,182787,0,35,0.8408830238282411,38151279,4605874817,233673,233673,356550,590223,325121045.28334755,3598719.1166664883,183393,0,35,0.3337196280050094,3793546682,-882,-882,54633946.5166533,4989.516666838434,-606,0,0,0.5071633958232317,-3755395403,1631.3130310020613,1391.3504995585606,239.96253144350067,0.7851978813613928,0.7848275153740484,-606
922,2019-07-12,2019,233363,233363,380211367.7166666,3604374.5499999993,183715,0,29,0.8439212728667354,38674608,4615789122,234125,234125,364923,599048,325711077.10000646,3599215.2166664884,184255,0,28,0.3306730011618482,3801130559,-762,-762,54500290.61666012,5159.3333335109055,-540,0,1,0.5132482717048872,-3762455951,1629.2701401536087,1391.1845257875343,238.08561436607442,0.7872499067975643,0.7869941270688735,-540
923,2019-07-13,2019,230106,230106,380289032.5333335,3581508.899999994,181462,0,44,0.8444977532093905,39054705,4623445275,230977,230977,376833,607810,326018702.66667426,3577070.8999998486,182135,0,44,0.32150013984633297,3814558836,-871,-871,54270329.866659224,4438.000000145286,-673,0,0,0.5229976133630575,-3775504131,1652.668911429226,1411.4769118426261,241.19199958659988,0.7886017748342068,0.7885417162747806,-673
924,2019-07-14,2019,230631,230631,380373035.1499995,3564728.916666666,182318,0,42,0.8488754764103696,38682896,4630712122,237979,237979,386338,624317,326277438.0333423,3579621.9833331387,184404,0,42,0.3176367134004031,3831819287,-7348,-7348,54095597.1166572,-14893.066666472703,-2086,0,0,0.5312387630099665,-3793136391,1649.2710656850097,1371.0345788214183,278.2364868635914,0.7905181870607161,0.774875094020901,-2086
925,2019-07-15,2019,232748,232748,380753939.2000005,3599282.8666666686,182478,0,33,0.843431522505027,38658917,4637386784,244898,244898,396422,641320,326608691.2666637,3632006.3499997975,187115,0,33,0.314212873448517,3836945921,-12150,-12150,54145247.933336854,-32723.48333312897,-4637,0,0,0.52921864905651,-3798287004,1635.9063845876249,1333.6519337302211,302.25445085740375,0.7840153298846821,0.7640527893245351,-4637
926,2019-07-16,2019,232935,232935,381215029.2666668,3595785.149999996,182625,0,34,0.8437504024727916,38608040,4646952368,233667,233667,404886,638553,323782647.18334246,3590908.3999998355,183195,0,34,0.30962034474820926,3791703519,-732,-732,57432382.08332437,4876.750000160653,-570,0,0,0.5341300577245824,-3753095479,1636.5725600131661,1385.6584249523573,250.9141350608088,0.7840170004507695,0.7840003081308016,-570
927,2019-07-17,2019,231579,231579,381323466.7833332,3570598.083333334,181021,0,32,0.836155264510167,38416219,4654005187,232332,232332,411676,644008,324109252.4666761,3565952.883333217,181600,0,31,0.30221674264916115,3804382996,-753,-753,57214214.31665707,4645.200000117067,-579,0,1,0.5339385218610058,-3765966777,1646.6236868771916,1395.0263091897634,251.5973776874282,0.7816814132542242,0.7816400668009572,-579
928,2019-07-18,2019,230992,230992,381539574.9,3571716.266666664,181907,0,31,0.8450725566253366,38799507,4660436671,231906,231906,420949,652855,324574351.5666736,3566234.0333328512,182553,0,31,0.3009565676911396,3817138982,-914,-914,56965223.3333264,5482.233333812561,-646,0,0,0.5441159889341971,-3778339475,1651.7436746727158,1399.5944545060222,252.14922016669357,0.7875034633234052,0.7871853250886135,-646
929,2019-07-19,2019,234849,234849,381642564.76666725,3592237.4833333334,184654,0,37,0.8450110496531817,39278686,4665192587,235740,235740,428849,664589,324900225.7333417,3586204.983333154,185345,0,37,0.3005932990163805,3827790962,-891,-891,56742339.03332555,6032.50000017928,-691,0,0,0.5444177506368013,-3788512276,1625.0550982404322,1378.2142433755057,246.84085486492654,0.7862669204467552,0.7862263510647324,-691
930,2019-07-20,2019,232410,232410,381531587.9333336,3579118.6666666633,182874,0,36,0.8488016866744115,38724567,4665864056,233236,233236,440509,673745,325022097.9333415,3573418.299999822,183585,0,38,0.29521703315052505,3840155387,-826,-826,56509489.99999207,5700.366666841321,-711,0,-2,0.5535846535238864,-3801430820,1641.6315474090338,1393.5331506857497,248.09839672328417,0.7868594294565638,0.7871211991287794,-711
931,2019-07-21,2019,234053,234053,382118026.5999994,3595843.400000001,184475,0,31,0.8482395013095316,39016247,4675487717,235083,235083,447726,682809,325816815.7166756,3591401.149999809,185309,0,28,0.29344223640872313,3855265546,-1030,-1030,56301210.88332385,4442.250000191852,-834,0,3,0.5547972649008085,-3816249299,1632.6132397362967,1385.9650239135776,246.64821582271907,0.7881761823176802,0.7882705257292105,-834
932,2019-07-22,2019,235347,235347,383126639.833333,3645931.700000001,185695,0,41,0.8508415233676223,42290093,4692261545,236191,236191,455776,691967,327018741.76667774,3640947.549999825,186407,0,41,0.29149511465141864,3871992165,-844,-844,56107898.06665528,4984.150000175927,-712,0,0,0.5593464087162037,-3829702072,1627.9223437449086,1384.5520860942108,243.3702576506978,0.7890264163129337,0.7892214351943978,-712
933,2019-07-23,2019,237014,237014,383693585.3833341,3652533.316666666,186050,0,30,0.8470681056815205,42198944,4702949042,238021,238020,462060,700081,327840560.51666,3646827.116666597,186827,0,28,0.2890251270924367,3888305817,-1007,-1006,55853024.866674125,5706.200000069104,-777,0,2,0.5580429785890837,-3846106873,1618.8646467437961,1377.3656017001092,241.49904504368692,0.7849747272313028,0.7849181374752647,-777
934,2019-07-24,2019,240844,240844,384524764.66666675,3668836.6166666667,188132,0,33,0.8407973626081608,42339690,4716507194,241840,241840,470585,712425,328919108.649994,3662938.0499999067,188957,0,33,0.2865213882163059,3906993515,-996,-996,55605656.01667273,5898.566666760016,-825,0,0,0.5542759743918549,-3864653825,1596.5719082338226,1360.0690896873718,236.50281854645073,0.7811363372141303,0.7813306318226927,-825
935,2019-07-25,2019,240413,240413,385310468.49999976,3673928.016666673,188074,0,32,0.8445841115081115,42336297,4732787241,241235,241235,481429,722664,329951251.3333297,3667823.23333323,188774,0,32,0.28290187417666174,3925089887,-822,-822,55359217.166670084,6104.783333443105,-700,0,0,0.5616822373314498,-3882753590,1602.7023018721939,1367.7586226431888,234.94367922900506,0.7822954665513097,0.782531556366199,-700
936,2019-07-26,2019,238151,238151,386000225.6833333,3642900.6166666658,187808,0,34,0.8475966928545343,42316821,4745369373,238786,238785,491679,730465,330805046.5666616,3636967.8999998774,188355,0,34,0.2776601206081053,3941400676,-635,-634,55195179.11667168,5932.716666788328,-547,0,0,0.569936572246429,-3899083855,1620.8213515094762,1385.3677851065252,235.45356640295108,0.7886089077937947,0.788802526111246,-547
937,2019-07-27,2019,231346,231346,385875158.61666685,3584137.6666666665,181177,0,165,0.8298263207490075,40299115,4753255354,231863,231857,504786,736649,330915547.9666623,3579576.6166666104,181676,0,165,0.2617284486913097,3959244028,-517,-511,54959610.650004566,4561.050000056159,-499,0,0,0.5680978720576979,-3918944913,1667.9569070425546,1427.2398416552542,240.7170653873004,0.7831429979338307,0.7835489060350294,-499
938,2019-07-28,2019,227874,227874,385952151.91666657,3550435.9833333306,179677,0,195,0.8376427323871966,40586666,4762272401,228526,228525,515582,744108,331182653.8999981,3545587.14999992,180239,0,195,0.25778516021867304,3979231382,-652,-651,54769498.01666844,4848.833333410788,-562,0,0,0.5798575721685235,-3938644716,1693.7085929797456,1449.2184833169156,244.49010966283004,0.7884927635447659,0.7887023795979451,-562
939,2019-07-29,2019,232883,232883,386583249.8499993,3592425.4666666635,183820,0,90,0.8416715689852846,41323517,4776819830,236896,236896,524591,761487,332015389.5666798,3589211.0333329067,184859,0,93,0.2594463201604297,3995812188,-4013,-4013,54567860.28331953,3214.433333756868,-1039,0,-3,0.5822252488248549,-3954488671,1659.989135531573,1401.5238314141218,258.4653041174513,0.7893233941507108,0.7803382074834526,-1039
940,2019-07-30,2019,230820,230820,387260110.3166662,3601339.716666661,182428,0,35,0.8490425439736591,40790570,4789612268,234513,234513,531264,765777,332837472.8166622,3600904.816666601,183658,0,33,0.2586079237166958,4005287885,-3693,-3693,54422637.50000399,434.9000000599772,-1230,0,2,0.5904346202569632,-3964497315,1677.7580379372073,1419.2708839879333,258.487153949274,0.7903474568928169,0.7831463500957303,-1230
941,2019-07-31,2019,233652,233652,387581031.68333346,3624725.249999998,183723,0,38,0.843724855768408,41310825,4799928408,234632,234631,540744,775376,333270933.5499947,3619470.5499999146,184564,0,36,0.2563852892016281,4016289771,-980,-979,54310098.13333875,5254.70000008354,-841,0,2,0.58733956656678,-3974978946,1658.7961227951546,1420.404522633389,238.3916001617656,0.7863104103538596,0.7866105220089331,-841
942,2019-08-01,2019,244103,244103,387866177.51666677,3703836.299999996,191713,0,41,0.8442092067692726,41287125,4807391935,245022,245022,274412,519434,333720549.5166826,3697948.916666476,192517,0,41,0.3993481366256333,4001042742,-919,-919,54145627.999984145,5887.3833335200325,-804,0,0,0.4448610701436393,-3959755617,1588.944738559816,1362.00238964943,226.94234891038604,0.7853774840948288,0.7857131196382365,-804
943,2019-08-02,2019,243517,243517,388173358.0499996,3697472.9499999993,190742,0,34,0.8411527737283231,41238245,4816247612,244517,244517,285937,530454,334225619.48334193,3692597.4833331797,191484,0,34,0.3887311623628104,4013179051,-1000,-1000,53947738.56665766,4875.466666819528,-742,0,0,0.4524216113655127,-3971940806,1594.0298133189863,1366.8809100526423,227.14890326634395,0.7832800174115154,0.7831111947226573,-742
944,2019-08-03,2019,242494,242494,388443540.3666666,3694883.9166666674,189988,0,53,0.8427260055918903,41666084,4825551770,251426,251426,299266,550692,334766521.79999936,3726266.483333115,193551,0,53,0.3786998903198205,4028842066,-8932,-8932,53677018.56666726,-31382.566666447558,-3563,0,0,0.4640261152720698,-3987175982,1601.8686663037709,1331.4713744799637,270.3972918238071,0.7834750550529085,0.7698129867237279,-3563
945,2019-08-04,2019,239024,239024,388839293.01666653,3656103.7499999986,187709,0,31,0.8468354642211665,40976440,4834590151,239942,239942,317942,557884,334478169.366682,3650831.9333331385,188476,0,31,0.3654343913788531,4033721813,-918,-918,54361123.64998454,5271.816666860133,-767,0,0,0.4814010728423134,-3992745373,1626.7792900155068,1393.9959213755074,232.78336863999948,0.7853144454113394,0.7855064974035392,-767
946,2019-08-05,2019,238995,238995,389351029.81666684,3661000.600000003,186936,0,33,0.8446327329023627,40400065,4843053945,239748,239748,324477,564225,335063697.3166752,3656191.9166664626,187574,0,33,0.3598493508795263,4046206275,-753,-753,54287332.499991655,4808.683333540335,-638,0,0,0.48478338202283644,-4005806210,1629.1178887284957,1397.5661833119575,231.5517054165382,0.7821753593171406,0.7823798321570983,-638
947,2019-08-06,2019,240058,240058,389469933.46666604,3666631.483333334,187047,0,110,0.8401053078839278,40386234,4849410858,240709,240709,331796,572505,335355986.3000112,3659458.6333331624,187593,0,110,0.3541401385140733,4053815396,-651,-651,54113947.166654825,7172.8500001714565,-546,0,0,0.4859651693698545,-4013429162,1622.3993096112858,1393.2008620367797,229.1984475745062,0.7791741995684376,0.7793352138889696,-546
948,2019-08-07,2019,244871,244871,389837689.9833332,3686083.316666668,191773,0,131,0.8457841067337497,41809924,4857945827,249821,249821,342559,592380,335963966.01668024,3686945.3666665563,193300,0,134,0.3535838482055392,4068663888,-4950,-4950,53873723.96665293,-862.0499998885207,-1527,0,-3,0.49220025852821053,-4026853964,1592.0124881400131,1344.818754294796,247.19373384521714,0.7831592961191811,0.7737540078696347,-1527
949,2019-08-08,2019,242402,242402,389805241.38333285,3696295.8000000026,189603,0,139,0.8448898936477416,42005660,4866925585,253496,253496,354125,607621,335875989.6833382,3706443.1499997946,193260,0,140,0.34397264084025747,4082564804,-11094,-11094,53929251.69999462,-10147.349999791943,-3657,0,-1,0.5009172528074841,-4040559144,1608.094163345735,1324.9755013228541,283.1186620228809,0.7821841403948813,0.7623788935525609,-3657
950,2019-08-09,2019,238647,238647,389826990.7999998,3608526.0666666697,185760,0,150,0.8421350362669554,41898693,4874197604,239388,239387,372612,612000,332658333.0833514,3602331.93333317,186419,0,150,0.33128104575163564,4032967161,-741,-740,57168657.7166484,6194.133333499543,-659,0,0,0.5108539905153198,-3991068468,1633.4879164623892,1389.6257235495302,243.86219291285897,0.7783881632704371,0.7787315989105552,-659
951,2019-08-10,2019,221350,221350,388276692.4166668,3500426.616666669,175505,0,160,0.8594849785407724,40963350,4867424651,222087,222087,391610,613697,331420855.0833413,3494234.2499998105,176192,0,160,0.31317572026586044,4039675274,-737,-737,56855837.333325505,6192.36666685855,-687,0,0,0.5463092582749121,-3998711924,1754.1300764249686,1492.3019135894551,261.82816283551347,0.7928845719448837,0.7933467514982867,-687
952,2019-08-11,2019,228641,228641,387773871.2666663,3514611.883333334,180212,0,160,0.8538144952130196,40539268,4872295363,229444,229444,398980,628424,331123884.55001056,3509697.8166664755,180901,0,160,0.3129336244319089,4055164315,-803,-803,56649986.71665573,4914.066666858271,-689,0,0,0.5408808707811106,-4014625047,1695.994468475323,1443.157740232957,252.836728242366,0.78818759540065,0.7884320357037011,-689
953,2019-08-12,2019,239208,239208,388264986.85,3631808.400000002,185337,0,128,0.8420704993144038,41844999,4884256325,240753,240753,402973,643726,331803521.6333456,3627546.7999998797,186547,0,128,0.3161127560483863,4064244933,-1545,-1545,56461465.21665442,4261.600000122096,-1210,0,0,0.5259577432660175,-4022399934,1623.1270979649512,1378.1906004633197,244.9364975016315,0.7747943212601586,0.7748480808131155,-1210
954,2019-08-13,2019,240739,240739,388717011.8166659,3654472.4166666707,185723,0,115,0.8354815796360374,41275429,4890793416,245814,245814,405935,651749,332529751.91668344,3652443.3499998813,188247,0,115,0.3141408732502885,4067594459,-5075,-5075,56187259.89998245,2029.066666789353,-2524,0,0,0.5213407063857489,-4026319030,1614.6823398646081,1352.7697849458673,261.91255491874085,0.7714703475548208,0.7658107349459348,-2524
955,2019-08-14,2019,237967,237967,389130784.6666668,3625037.2166666673,184796,0,143,0.8409401303542092,40775456,4899850590,259951,259950,419765,679716,333043867.4333279,3641028.2166666123,192439,0,143,0.3066972088342799,4072224364,-21984,-21983,56086917.23333889,-15990.999999945052,-7643,0,0,0.5342429215199294,-4031448908,1635.230030494425,1281.1843332691976,354.0456972252273,0.7765614560002017,0.7402895161011114,-7643
956,2019-08-15,2019,238121,238121,389339680.5833335,3632345.5499999975,186312,0,117,0.8470189525493341,41247772,4909013784,245145,245145,430452,675597,329162867.81668174,3627479.966666504,188946,0,117,0.30408068715521136,3995912771,-7024,-7024,60176812.76665175,4865.583333493676,-2634,0,0,0.5429382653941228,-3954664999,1635.0497460674762,1342.7272341539976,292.3225119134786,0.782425741534766,0.7707520039160497,-2634
957,2019-08-16,2019,253241,253241,390149735.316666,3795860.033333332,196879,0,120,0.8477576695716733,42858621,4920396130,254462,254462,435470,689932,329730057.38332653,3789885.8499999037,197871,0,120,0.31398166775856207,3999627424,-1221,-1221,60419677.93333948,5974.183333428111,-992,0,0,0.5337760018131112,-3956768803,1540.6262624008987,1295.7929175410338,244.83334485986484,0.7774373028064177,0.7776053005949808,-992
958,2019-08-17,2019,248593,248593,390802536.7500005,3793965.833333332,192257,0,134,0.8446818695618943,42300223,4932969770,249785,249785,443733,693518,330570751.3166792,3787874.083332869,193299,0,134,0.30603243174653744,4016716239,-1192,-1192,60231785.4333213,6091.750000462867,-1042,0,0,0.5386494378153568,-3974416016,1572.0576876661871,1323.4211474535268,248.6365402126603,0.7733805859376571,0.7738615209079809,-1042
959,2019-08-18,2019,245843,245843,391752097.55,3758555.8666666634,190682,0,156,0.8454867537412096,42221036,4948214376,246838,246838,454453,701291,331616361.6833439,3752793.633332817,191624,0,156,0.2992067486963331,4034549044,-995,-995,60135735.866656125,5762.233333846554,-942,0,0,0.5462800050448765,-3992328008,1593.5051945753999,1343.4574971574227,250.04769741797713,0.7756250940640979,0.7763148299694537,-942
960,2019-08-19,2019,248174,248174,392325318.9166669,3786972.9333333354,192085,0,109,0.8495370183822636,41817937,4958123145,249294,249294,465124,714418,332501840.31666136,3780536.8999999613,193066,0,110,0.2982959555890206,4052707585,-1120,-1120,59823478.60000557,6436.033333374187,-981,0,-1,0.5512410627932429,-4010889648,1580.8477879095592,1333.7739388700143,247.07384903954494,0.7739932466737047,0.774451049764535,-981
961,2019-08-20,2019,248258,248258,392861667.86666673,3780748.5833333335,192399,0,95,0.8460472572887887,40690727,4965498372,249342,249342,472490,721832,333385192.8833286,3775028.5666666143,193202,0,95,0.29328015383080636,4061891899,-1084,-1084,59476474.98333812,5720.016666719224,-803,0,0,0.5527671034579824,-4021201172,1582.4733457397817,1337.0599132249224,245.41343251485932,0.7749961733358038,0.7748473983524636,-803
962,2019-08-21,2019,250182,250182,393451823.10000014,3813225.849999998,193257,0,119,0.8410836910728986,41113686,4972620534,251131,251131,480668,731799,334319595.88332826,3807480.5166665595,193998,0,119,0.2899020086116566,4075043534,-949,-949,59132227.216671884,5745.333333438728,-741,0,0,0.551181682461242,-4033929848,1572.6623941770397,1331.2557823738537,241.40661180318602,0.7724656450104324,0.7724972225651154,-741
963,2019-08-22,2019,253129,253129,394167035.98333377,3830795.683333332,195563,0,112,0.841495838090459,42411708,4982389569,254236,254236,488984,743220,335365983.4000046,3825300.883332708,196409,0,112,0.28884986948682,4091002819,-1107,-1107,58801052.58332914,5494.8000006242655,-846,0,0,0.552645968603639,-4048591111,1557.178497854192,1319.112884878635,238.0656129755571,0.7725823591923485,0.7725459808996366,-846
964,2019-08-23,2019,257886,257886,394956455.75000066,3805538.83333333,198909,0,136,0.8337947775373621,42253031,4994281044,259017,259017,499797,758814,336380841.4499959,3799032.899999939,199838,0,138,0.28591591615336737,4108108564,-1131,-1131,58575614.30000478,6505.933333391324,-929,0,-2,0.5478788613839947,-4065855533,1531.5156920112013,1298.682485898593,232.8332061126082,0.7713059258742235,0.771524648961265,-929
965,2019-08-24,2019,250980,250980,394803815.9666669,3769215.1666666674,195254,0,122,0.841525221133158,42515890,5004413732,251955,251955,514970,766925,336455844.23332787,3762249.383333222,196044,0,122,0.2778459432147827,4125813517,-975,-975,58347971.73333901,6965.7833334454335,-790,0,0,0.5636792779183752,-4083297627,1573.0489121311136,1335.3806998604032,237.66821227071046,0.777966371822456,0.7780913258319938,-790
966,2019-08-25,2019,252483,252483,395074846.666667,3730105.1833333294,196436,0,195,0.8459341817072838,42773847,5014439658,253449,253449,528148,781597,336948969.2999973,3723085.549999897,197295,0,196,0.2758454804713926,4144905825,-966,-966,58125877.366669655,7019.633333432488,-859,0,-1,0.5700887012358913,-4102131978,1564.7582081433877,1329.4547198844632,235.30348825892452,0.7780167377605621,0.7784406330267628,-859
967,2019-08-26,2019,252951,252951,395268660.033333,3788079.516666663,195263,0,250,0.8464287549762605,43235196,5025218641,254023,254023,539918,793941,337404003.4999946,3781211.149999935,196157,0,250,0.272749486422793,4162376555,-1072,-1072,57864656.53333843,6868.366666727699,-894,0,0,0.5736792685534675,-4119141359,1562.6293631309345,1328.24194462704,234.38741850389442,0.7719400200038743,0.7722017297646276,-894
968,2019-08-27,2019,251948,251948,395576147.18333334,3824817.6833333294,195760,0,188,0.8534816708209627,44351760,5033293293,252938,252938,545708,798646,337991131.91666263,3817995.099999908,196549,0,188,0.2724824265068648,4173227937,-990,-990,57585015.266670704,6822.5833334214985,-789,0,0,0.5809992443140979,-4128876177,1570.0705986288176,1336.2607908525513,233.80980777626633,0.776985727213552,0.7770639445239544,-789
969,2019-08-28,2019,251398,251398,396367291.6166669,3802608.7499999967,196206,0,158,0.8534753657547004,44369764,5047898209,253386,253386,552766,806152,339023311.7333254,3797249.8666665815,197407,0,159,0.26857093947542865,4188175352,-1988,-1988,57343979.88334149,5358.883333415259,-1201,0,-1,0.5849044262792717,-4143805588,1576.6525255438266,1337.9717574503936,238.68076809343302,0.7804596695279994,0.7790761920548097,-1201
970,2019-08-29,2019,244820,244820,396597717.6999998,3745877.950000002,192231,0,150,0.8576750265501191,43734620,5056309201,245909,245909,565115,811024,338866947.38332856,3740273.533333242,193108,0,150,0.2612401112667392,4189248176,-1089,-1089,57730770.31667125,5604.416666760109,-877,0,0,0.5964349152833799,-4145513556,1619.9563667184045,1378.0176706965933,241.9386960218112,0.7851932031696757,0.7852823605480076,-877
971,2019-08-30,2019,247003,247003,396788446.38333327,3771723.0833333326,194958,0,90,0.8587507034327524,43911001,5063362812,248003,248003,575101,823104,339255075.61667377,3765466.9999994966,195725,0,90,0.26006434180856847,4207575569,-1000,-1000,57533370.7666595,6256.083333835937,-767,0,0,0.598686361624184,-4163664568,1606.4114459473499,1367.947466831747,238.4639791156028,0.7892940571572005,0.7892041628528688,-767
972,2019-08-31,2019,250427,250427,396611104.3333332,3807406.250000002,196200,0,149,0.8549557356035894,43858849,5063588373,251560,251560,582525,834085,339585273.28332675,3801207.883333259,197223,0,149,0.25946875917921813,4220624833,-1133,-1133,57025831.05000645,6198.366666743066,-1023,0,0,0.5954869764243713,-4176765984,1583.7393904544365,1349.9176072639798,233.8217831904567,0.7834618471650421,0.7839998409922087,-1023
973,2019-09-01,2019,257319,257319,396560423.7333333,3819051.950000004,196908,0,157,0.8391840478161352,43667313,5069205929,261557,261557,298409,559966,339755255.6833354,3816540.3499996555,198622,0,159,0.3915594875403169,4205333185,-4238,-4238,56805168.049997866,2511.600000348408,-1714,0,-2,0.4476245602758183,-4161665872,1541.1237558568675,1298.9721387052743,242.1516171515932,0.7652291513646485,0.7593832319532645,-1714
974,2019-09-02,2019,244710,244710,396654391.04999995,3813163.400000002,189946,0,65,0.8531404519635479,43075231,5076633329,257528,257528,317808,575336,340131988.78333884,3877233.7166664824,195709,0,68,0.3763870155874102,4215356595,-12818,-12818,56522402.26666111,-64070.31666648062,-5763,0,-3,0.4767534363761377,-4172281364,1620.916149932573,1320.7573109849757,300.15883894759736,0.7762085734134282,0.7599523158646827,-5763
975,2019-09-03,2019,244190,244190,396809042.3666674,3790680.716666672,189137,0,74,0.8475531348540081,42303298,5084271248,258376,258375,327987,586363,338044165.86667883,3848978.1999998093,194380,0,74,0.36509636522086486,4180158093,-14186,-14185,58764876.499988556,-58297.48333313735,-5243,0,0,0.4824567696331432,-4137854795,1625.0011972917293,1308.3470377036433,316.65415958808603,0.7745485073098817,0.7523144564510635,-5243
976,2019-09-04,2019,248088,248088,396909087.7833343,3838991.416666669,192936,0,84,0.858227725645738,42971766,5089848769,261414,261414,337427,598841,336045781.1000119,3884009.5499998117,198302,0,84,0.36979765914491236,4149887974,-13326,-13326,60863306.68332243,-45018.13333314285,-5366,0,0,0.48843006650082565,-4106916208,1599.8721735163906,1285.4926710123095,314.3795025040811,0.7776917867853342,0.7585745216400039,-5366
977,2019-09-05,2019,249677,249677,397324741.33333313,3889863.9666666705,193065,0,107,0.854764355547368,42473007,5095614325,251121,251121,347279,598400,334863814.6500132,3883498.083333139,194271,0,107,0.3645137032085528,4136834761,-1444,-1444,62460926.683319926,6365.883333531674,-1206,0,0,0.49025065233881515,-4094361754,1591.3549959881493,1333.4759524293595,257.8790435587898,0.773259050693496,0.7736151098474441,-1206
978,2019-09-06,2019,251420,251420,397560042.7166669,3860208.28333333,195525,0,88,0.8568809163948778,42259032,5099303700,252669,252669,349243,601912,335370118.71668446,3853768.83333321,196470,0,89,0.36370765161685015,4147248297,-1249,-1249,62189923.99998242,6439.450000119861,-945,0,-1,0.4931732647780277,-4104989265,1581.258621894308,1327.310112109853,253.94850978445493,0.7776827619123379,0.7775785711741449,-945
979,2019-09-07,2019,258366,258366,397070771.683333,3873537.96666667,199660,0,116,0.8491171438966434,41405709,5098413756,267936,267936,361384,629320,335261132.96668565,3883746.0833331365,204095,0,116,0.36026822602173647,4160411431,-9570,-9570,61809638.71664733,-10208.116666466463,-4435,0,0,0.4888489178749069,-4119005722,1536.8538108084383,1251.273188249006,285.5806225594324,0.7727797001153403,0.7617304132330108,-4435
980,2019-09-08,2019,253285,253285,397506680.93333316,3873997.3666666737,194599,0,162,0.8374874153621409,42159285,5106204802,254536,254536,373505,628041,334257199.8500125,3868606.2833332056,195605,0,162,0.34151273563349743,4132463871,-1251,-1251,63249481.08332068,5391.083333468065,-1006,0,0,0.49597467972864345,-4090304586,1569.404745379052,1313.2020612016079,256.2026841774441,0.7683005310223661,0.7684767577081435,-1006
981,2019-09-09,2019,247106,247106,397861869.3000001,3790948.61666667,190279,0,150,0.8423267747444412,42145511,5116073653,248042,248042,380577,628619,334815754.78334713,3785449.4499998204,191096,0,150,0.3336806555322041,4136367400,-936,-936,63046114.51665294,5499.166666849516,-817,0,0,0.5086461192122371,-4094221889,1610.0858307770757,1349.834926275982,260.2509045010936,0.77002986572564,0.7704179130953629,-817
982,2019-09-10,2019,241204,241204,397899663.7499999,3744060.4000000004,186407,0,120,0.8436344339231522,41484794,5122945040,242249,242249,391109,633358,335150080.0500152,3738414.983333125,187235,0,120,0.3241815845067184,4144511061,-1045,-1045,62749583.69998467,5645.416666875593,-828,0,0,0.5194528494164338,-4103026267,1649.639573763287,1383.4941735570228,266.1454002062642,0.7728188587253942,0.772903087319246,-828
983,2019-09-11,2019,244358,244358,398136426.33333313,3726237.916666666,189414,0,60,0.8492171322404021,40987395,5130134332,246292,246291,399757,646049,335615956.6500164,3721479.816666007,190769,0,60,0.32498928099880214,4158227335,-1934,-1933,62520469.68331671,4758.100000659004,-1355,0,0,0.5242278512415999,-4117239940,1629.3161113339163,1362.680555318775,266.6355560151412,0.775149575622652,0.7745643382651487,-1355
984,2019-09-12,2019,239095,239095,398281168.0166667,3674000.416666668,186055,0,99,0.847512495033355,41386089,5134345225,240344,240344,408674,649018,336102726.11667776,3668055.116666543,186998,0,99,0.3151638321279186,4173419378,-1249,-1249,62178441.89998895,5945.300000125077,-943,0,0,0.5323486629054364,-4132033289,1665.7862691259404,1398.4236182999275,267.3626508260129,0.7781634914991948,0.778043138168625,-943
985,2019-09-13,2019,235627,235627,398338648.7833328,3642928.5666666673,183953,0,110,0.8441604739694518,42132345,5143617290,236777,236777,420348,657125,336427701.3833431,3637547.4833331387,184879,0,110,0.3052509035571621,4189320059,-1150,-1150,61910947.399989724,5381.083333528601,-926,0,0,0.5389095704122897,-4147187714,1690.54755517548,1420.8630964297338,269.68445874574627,0.7806957606725885,0.7808148595513923,-926
986,2019-09-14,2019,245730,245730,398570347.4666667,3752534.966666661,190494,0,185,0.8420298701827217,42346021,5152091147,246756,246756,428273,675029,336888667.5333456,3746893.4833331234,191378,0,187,0.3090874614275886,4206259924,-1026,-1026,61681679.93332112,5641.483333537821,-884,0,-2,0.5329424087551331,-4163913903,1621.984891818934,1365.2704190915138,256.71447272742034,0.7752167012574778,0.7755758725218435,-884
987,2019-09-15,2019,248010,248010,399283747.666667,3780419.0999999945,192708,0,213,0.8471190677795245,43060122,5163467931,248941,248941,430057,678998,337812040.6666779,3774541.3666664846,193529,0,217,0.311641565954535,4222690256,-931,-931,61471706.99998909,5877.733333509881,-821,0,-4,0.5354775018249895,-4179630134,1609.9501942126003,1356.996399414632,252.95379479796838,0.7770170557638805,0.7774091049686472,-821
988,2019-09-16,2019,248501,248501,399769306.5666666,3796316.416666669,193397,0,208,0.8498678073730082,43767386,5174244423,249449,249449,442645,692094,338503604.4999906,3790477.3499998944,194218,0,208,0.3077139810488179,4241225895,-948,-948,61265702.06667602,5839.066666774452,-821,0,0,0.5421538263241903,-4197458509,1608.7231301550762,1357.0052575876855,251.7178725673907,0.7782544134631249,0.778588007969565,-821
989,2019-09-17,2019,248407,248407,400107049.11666656,3796396.1500000036,192911,0,224,0.8471057578892704,43503813,5181044683,249481,249481,445998,695479,339106869.78332907,3791067.416666517,193797,0,226,0.3050084905511105,4248637384,-1074,-1074,61000179.333337486,5328.733333486598,-886,0,-2,0.5420972673381599,-4205133571,1610.691522850268,1359.2492806399248,251.44224221034324,0.7765924470727475,0.776800638124747,-886
990,2019-09-18,2019,245436,245436,400421702.4833326,3771786.9999999967,192569,0,281,0.8555713098322985,43295487,5189791836,246475,246475,458249,704724,339679694.3666849,3766803.9499994153,193403,0,281,0.30010614084379406,4264876446,-1039,-1039,60742008.11664766,4983.050000581425,-834,0,0,0.5554651689885044,-4221580959,1631.4709434774547,1378.1507023701588,253.32024110729594,0.784599651232908,0.7846759306217669,-834
991,2019-09-19,2019,247764,247764,401077300.96666676,3848127.9833333357,193007,0,271,0.8481296717844398,43833182,5200589001,249060,249060,462801,711861,340592828.53332835,3842358.6333332937,193987,0,278,0.2977828536750889,4280466589,-1296,-1296,60484472.4333384,5769.350000042003,-980,0,-7,0.5503468181093509,-4236633407,1618.7876405235093,1367.5131636285569,251.2744768949524,0.7789953342697082,0.7788765759254798,-980
992,2019-09-20,2019,254415,254415,401782875.26666665,3900634.5999999987,197469,0,282,0.8450916809150409,44344626,5210691190,255765,255765,468970,724735,341528868.8833245,3894429.966666547,198536,0,282,0.2991659020193603,4298207547,-1350,-1350,60254006.38334215,6204.63333345158,-1067,0,0,0.5459257788956806,-4253862921,1579.242085830893,1335.3229287952788,243.91915703561426,0.7761688579682802,0.7762438175669071,-1067
993,2019-09-21,2019,247313,247313,401604665.2666665,3836686.7666666643,192395,0,282,0.8478365472094075,43404269,5214123667,248285,248285,479343,727628,341641014.06665856,3830386.2333332133,193301,0,282,0.29042037964454465,4313013494,-972,-972,59963651.200007915,6300.5333334510215,-906,0,0,0.5574161675648628,-4269609225,1623.8720377281682,1376.003439864102,247.86859786406626,0.777941313234646,0.7785448174476911,-906
994,2019-09-22,2019,252843,252843,401704969.6500006,3834185.7000000016,197518,0,273,0.8562863120592623,44360936,5220929161,260013,260013,490989,751002,342067412.43333125,3842667.4999999227,199735,0,273,0.29225221770381454,4332825090,-7170,-7170,59637557.21666932,-8481.799999921117,-2217,0,0,0.5640340943554478,-4288464154,1588.7525842123396,1315.5781150685975,273.17446914374204,0.781188326352717,0.7681731298050483,-2217
995,2019-09-23,2019,255004,255004,401682803.8166664,3831821.100000002,195959,0,239,0.838473121990243,44146520,5228802006,279565,279565,500631,780196,341358156.0833369,3861965.266666582,206304,0,237,0.2884608482996579,4329642369,-24561,-24561,60324647.733329535,-30144.1666665799,-10345,0,2,0.5500122736905851,-4285495849,1575.2019725834357,1221.0332340719935,354.16873851144214,0.768454612476667,0.7379464525244577,-10345
996,2019-09-24,2019,248487,248487,402090128.5999997,3840876.61666667,191819,0,213,0.8402652855078946,43448922,5238620614,249645,249645,507557,757202,336508255.2166629,3835234.8333332483,192757,0,212,0.2781424243464766,4221515047,-1158,-1158,65581873.38333684,5641.783333421685,-938,0,1,0.562122861161418,-4178066125,1618.153579865344,1347.9471057568262,270.2064741085178,0.771947828256609,0.7721244166716738,-938
997,2019-09-25,2019,249587,249587,402449703.26666737,3846794.1666666684,191499,0,251,0.8361733583880562,43400148,5246039115,253181,253180,511467,764648,337168124.0499909,3843857.8166666017,192724,0,251,0.27556601207352793,4235565454,-3594,-3593,65281579.21667647,2936.3500000666827,-1225,0,0,0.5606073463145282,-4192165306,1612.4626012839906,1331.7328542933521,280.72974699063843,0.7672635193339397,0.7612103593871578,-1225
998,2019-09-26,2019,248641,248641,403046045.46666694,3824806.5333333276,191266,0,178,0.8364227943098699,43797999,5254287604,264673,264673,520467,785140,338114752.2999904,3887470.8166665626,196073,0,180,0.2717922918205672,4250228514,-16032,-16032,64931293.16667652,-62664.283333234955,-4807,0,-2,0.5646305024893027,-4206430515,1620.9959156642185,1277.4810891174786,343.51482654673987,0.7692456191858945,0.7408122475658643,-4807
999,2019-09-27,2019,250392,250392,403682374.6666661,3825899.4499999974,193063,0,79,0.8393518962267165,43825035,5265186141,261731,261729,537858,799589,336734236.2666593,3839470.916666588,197880,0,79,0.26971106405915934,4219062323,-11339,-11337,66948138.40000677,-13571.466666590422,-4817,0,0,0.5696408321675571,-4175237288,1612.2015666102195,1286.5759478951868,325.6256187150327,0.771043004568836,0.7560434186244656,-4817
1000,2019-09-28,2019,252839,252839,404184676.33333355,3884049.1499999966,194698,0,61,0.8446204897187545,44109209,5277071347,253812,253812,545470,799282,335980808.5833273,3878355.766666563,195569,0,61,0.2691378011765534,4202330281,-973,-973,68203867.75000626,5693.3833334334195,-871,0,0,0.5754826885422011,-4158221072,1598.5851721187537,1323.738864133009,274.8463079857447,0.7700473423799334,0.7705270042393583,-871
1001,2019-09-29,2019,256641,256641,404829571.2666668,3872987.016666671,197660,0,60,0.8456170292353912,43618693,5288726995,257644,257644,545186,802830,336856103.1000122,3868367.31666601,198462,0,60,0.2723328724636475,4220487362,-1003,-1003,67973468.16665465,4619.70000066096,-802,0,0,0.5732841567717437,-4176868669,1577.4158114512757,1307.4478858425275,269.96792560874815,0.7701809141953156,0.7702954464299576,-802
1002,2019-09-30,2019,262296,262296,405240894.0499999,3987700.5166666624,201095,0,66,0.8399403727086951,44309122,5299765120,263225,263225,552919,816144,337553775.099994,3982108.666666569,201883,0,66,0.2717241075104397,4237712391,-929,-929,67687118.95000589,5591.850000093225,-788,0,0,0.5682162651982554,-4193403269,1544.9755011513705,1282.3773391584918,262.59816199287866,0.7666720041479855,0.7669598252445626,-788
1003,2019-10-01,2019,252246,252246,405283661.5999998,3931835.4333333373,193375,0,32,0.8335910182916685,44540658,5306773313,253188,253188,295676,548864,337909987.1666813,3926877.499999805,194286,0,30,0.38596446478545443,4199692355,-942,-942,67373674.4333185,4957.933333532419,-911,0,2,0.44762655350621405,-4155151697,1606.7000531227443,1334.6208634164386,272.07918970630567,0.7666127510446151,0.7673586425896962,-911
1004,2019-10-02,2019,258223,258223,405484923.31666625,3901122.6166666676,198958,0,49,0.8424462576919952,43614406,5310092485,259166,259166,307618,566784,338423732.400012,3895557.7666664794,199703,0,49,0.3862035625564579,4218995676,-943,-943,67061190.91665423,5564.85000018822,-745,0,0,0.45624269513553734,-4175381270,1570.2897236755296,1305.8184036486732,264.47132002685635,0.7704890733977996,0.77056018150529,-745
1005,2019-10-03,2019,251697,251697,405341876.8000002,3803547.38333333,193130,0,38,0.838337365959865,43221979,5314380188,252606,252606,321066,573672,338622688.3833436,3798131.516666471,193867,0,38,0.3699221854997309,4234825259,-909,-909,66719188.41665661,5415.866666859016,-737,0,0,0.4684151804601341,-4191603280,1610.4358685244567,1340.5172022174595,269.91866630699724,0.7673114896085372,0.7674679144596723,-737
1006,2019-10-04,2019,243099,243099,405099400.4333329,3702806.950000008,186673,0,35,0.8351412387545812,42272456,5319464902,243918,243918,336393,580311,338742229.7166805,3697425.8166664597,187312,0,35,0.3517320884835978,4247889789,-819,-819,66357170.71665239,5381.133333548438,-639,0,0,0.4834091502709834,-4205617333,1666.3968195399113,1388.754539298783,277.64228024112845,0.7678888025043296,0.7679302060528538,-639
1007,2019-10-05,2019,239983,239983,404612270.65000015,3633768.2333333367,184942,0,35,0.8388594192088596,42193359,5322024002,240737,240737,352510,593247,338575622.3833473,3628978.0166665325,185557,0,35,0.34114963918906277,4264001234,-754,-754,66036648.26665288,4790.216666804161,-615,0,0,0.4977097800197969,-4221807875,1686.0038863169482,1406.4129003158937,279.5909860010545,0.7706462541096661,0.7707872076166107,-615
1008,2019-10-06,2019,233259,233259,403779646.50000024,3601200.249999998,180037,0,57,0.839946154274862,42470357,5321186712,234023,234023,362311,596334,338098506.7833483,3596346.566666503,180680,0,57,0.33034004433756536,4282066072,-764,-764,65681139.71665192,4853.683333495166,-643,0,0,0.5096061099372966,-4239595715,1731.035657788125,1444.7234108756334,286.3122469124917,0.7718330268071114,0.7720608658123347,-643
1009,2019-10-07,2019,232412,232412,403848204.3833332,3587558.066666666,179606,0,36,0.843798943255943,42348824,5330149676,233262,233261,373195,606457,338482287.0166762,3581770.5833331374,180350,0,36,0.32557131008463314,4297631039,-850,-849,65365917.36665702,5787.4833335285075,-744,0,0,0.5182276331713098,-4255282215,1737.6392113287318,1451.0882102737971,286.55100105493466,0.7727914221296662,0.7731649389956358,-744
1010,2019-10-08,2019,235450,235450,404009911.30000037,3619448.966666658,181788,0,49,0.8423699299214273,42456226,5333984722,236441,236434,379750,616191,338865130.25001013,3614786.96666654,182571,0,50,0.3239401419365116,4303236171,-991,-984,65144781.04999024,4662.000000117812,-783,0,-1,0.5184297879849158,-4260779945,1715.9053357400737,1433.2335038531266,282.6718318869471,0.7720874920365258,0.7721630343299174,-783
1011,2019-10-09,2019,237658,237658,404213033.40000033,3678049.5833333335,183666,0,71,0.8448568952023489,42562662,5338558714,238754,238754,384931,623685,339328946.800015,3674680.7999998243,184559,0,71,0.32416364029919165,4315498361,-1096,-1096,64884086.59998536,3368.783333509229,-893,0,0,0.5206932549031572,-4272935699,1700.8181226804918,1421.2492640961616,279.5688585843302,0.772816400037028,0.7730090385920236,-893
1012,2019-10-10,2019,244543,244543,404769625.1666662,3724041.283333335,186301,0,40,0.8321603971489674,42784760,5345842066,245676,245676,390448,636124,340120094.7333425,3719064.8666664786,187227,0,40,0.32225163647339766,4328849387,-1133,-1133,64649530.43332368,4976.416666856501,-926,0,0,0.5099087606755697,-4286064627,1655.2083893902757,1384.4254006632416,270.7829887270341,0.7618332972115334,0.7620890929516925,-926
1013,2019-10-11,2019,243171,243171,405004816.38333327,3623393.6000000006,187133,0,50,0.8411899445246348,42020661,5350585781,244254,244254,399328,643582,340650240.6833466,3617552.4333331743,188082,0,52,0.3201736530853883,4338698515,-1083,-1083,64354575.69998664,5841.166666826233,-949,0,-2,0.5210162914392464,-4296677854,1665.5144584812056,1394.6557300324523,270.85872844875325,0.7695531128300661,0.7700262841140779,-949
1014,2019-10-12,2019,231854,231854,404730599.5833335,3538857.9666666663,180658,0,44,0.8499055440061418,40847236,5348928262,239954,239953,414138,654092,340669274.23335063,3541503.583333196,183971,0,44,0.3072335390128587,4354968338,-8100,-8099,64061325.34998286,-2645.6166665297933,-3313,0,0,0.5426720049932832,-4314121102,1745.6269876013935,1419.733340418126,325.8936471832674,0.7791886273258171,0.7666927827833668,-3313
1015,2019-10-13,2019,229573,229573,404469277.11666656,3523421.216666663,177488,0,39,0.8387397472699316,41094441,5351738083,232478,232478,431111,663589,340174072.2500085,3519826.699999961,179296,0,42,0.29349491929492366,4363001883,-2905,-2905,64295204.86665803,3594.516666701995,-1808,0,-3,0.545244827975008,-4321907442,1761.8329556030828,1463.25274757185,298.5802080312328,0.7731222748319707,0.7712385688108122,-1808
1016,2019-10-14,2019,227049,227049,404245528.5999995,3568613.549999999,176893,0,39,0.8439808147140048,41558673,5357819093,228025,228023,438463,666488,339930725.20000947,3563494.549999776,177752,0,39,0.28964962609979344,4362921089,-976,-974,64314803.39999002,5119.000000223052,-859,0,0,0.5543311886142113,-4321362416,1780.4329840695157,1490.7738482521916,289.6591358173241,0.7790961422424234,0.7795285604648613,-859
1017,2019-10-15,2019,232692,232692,404513298.4000001,3629504.6833333327,180383,0,45,0.8400675571141251,42169323,5363985157,233634,233634,439119,672753,340437116.65001166,3624322.4333331813,181127,0,45,0.2923896288831134,4370980935,-942,-942,64076181.74998844,5182.25000015134,-744,0,0,0.5476779282310117,-4328811612,1738.4065563061906,1457.1385870635766,281.2679692426141,0.7752006944802572,0.7752595940659321,-744
1018,2019-10-16,2019,237554,237554,404891777.0666665,3695605.3333333316,185197,0,45,0.8466032986184193,42283971,5370754683,238440,238439,443007,681447,341117782.266678,3690547.316666543,185903,0,45,0.296752351980418,4382619641,-886,-885,63773994.79998851,5058.016666788608,-706,0,0,0.5498509466380013,-4340335670,1704.419951112869,1430.6291431631485,273.7908079497206,0.7795995857783914,0.7796636470390874,-706
1019,2019-10-17,2019,236230,236230,405246338.1333337,3696721.516666663,183669,0,59,0.843817466028871,42460027,5378826365,237195,237195,450201,687396,341826481.26667845,3691473.349999874,184393,0,58,0.2915859271802548,4394684307,-965,-965,63419856.86665523,5248.16666678898,-724,0,1,0.5522315388486162,-4352224280,1715.4736406609393,1441.1200964045552,274.3535442563841,0.7775007408034542,0.7773899112544531,-724
1020,2019-10-18,2019,236239,236239,405504446.7333328,3676899.566666668,183023,0,30,0.8426720397563484,41575376,5382213085,237094,237094,458405,695499,342287360.5333431,3672246.249999836,183737,0,30,0.28763233304433417,4407193760,-855,-855,63217086.199989736,4653.316666831728,-714,0,0,0.5550397067120143,-4365618384,1716.500860286967,1443.6778684122883,272.8229918746788,0.7747366014925563,0.7749542375597864,-714
1021,2019-10-19,2019,236077,236077,405556687.2833332,3686180.233333335,182951,0,45,0.8439322763335693,41674671,5384061815,236873,236873,466394,703267,342606315.8833306,3681363.049999899,183625,0,45,0.28473396306097826,4420355577,-796,-796,62950371.4000026,4817.1833334355615,-674,0,0,0.5591983132725911,-4378680906,1717.9000380525556,1446.3713292917748,271.5287087607808,0.774963253514743,0.7752044344437736,-674
1022,2019-10-20,2019,238171,238171,405869114.2166663,3674791.5833333335,183827,0,34,0.8394262945530744,41726544,5389155250,238971,238971,473466,712437,343161549.83332956,3669904.6333332937,184496,0,34,0.28213020940798705,4437124353,-800,-800,62707564.38333672,4886.9500000397675,-669,0,0,0.5572960851450873,-4395397809,1704.108032534046,1435.996626508361,268.111406025685,0.7718278043926423,0.7720434697097137,-669
1023,2019-10-21,2019,243005,243005,406409809.0000003,3744962.4666666705,187151,0,38,0.8418221847287091,42216179,5397706420,251256,251256,480634,731890,343978300.28333443,3767619.9166666027,189609,0,38,0.2835754006749635,4452535935,-8251,-8251,62431508.716665864,-22657.4499999322,-2458,0,0,0.5582467840537455,-4410319756,1672.4339375733023,1369.0351684470597,303.39876912624254,0.7701528775128084,0.754644665202025,-2458
1024,2019-10-22,2019,243426,243426,406562560.29999983,3767424.2500000023,187434,0,43,0.8424572560038779,42990681,5399816569,244673,244673,489339,734012,343904557.73333085,3763086.0833332133,188251,0,43,0.2810076674495784,4456013721,-1247,-1247,62658002.56666899,4338.16666678898,-817,0,0,0.5614495885542995,-4413023040,1670.1690053650796,1405.5680754857742,264.60092987930534,0.7699834857410466,0.769398339824991,-817
1025,2019-10-23,2019,241452,241452,406836617.33333343,3736541.833333328,185734,0,36,0.8345261169921969,41578978,5405169026,242575,242575,492520,735095,344294680.09999293,3734027.1499999254,186449,0,36,0.2755888694658446,4466243035,-1123,-1123,62541937.2333405,2514.6833334024996,-715,0,0,0.5589372475263523,-4424664057,1684.9585728564412,1419.3329077604574,265.6256650959838,0.7692377781091065,0.7686241368648872,-715
1026,2019-10-24,2019,239737,239737,407045669.3,3656858.433333332,185150,0,40,0.83740515648398,42171369,5412152242,240803,240802,503125,743928,344803463.1999954,3653969.766666593,185877,0,39,0.27124264713789803,4480893637,-1066,-1065,62242206.10000461,2888.6666667391546,-727,0,1,0.5661625093460819,-4438722268,1697.884220207978,1431.896176942033,265.98804326594495,0.7723046505128537,0.7719048350726527,-727
1027,2019-10-25,2019,233837,233837,406390236.7666674,3585009.9666666654,181274,0,89,0.8398243220705015,41172731,5411600127,234923,234923,517976,752899,344425160.1666619,3581883.616666643,182034,0,89,0.26238977605229985,4491197948,-1086,-1086,61965076.60000551,3126.350000022445,-760,0,0,0.5774345460182017,-4450025217,1737.9210166340974,1466.119367480672,271.8016491534254,0.7752152140166013,0.7748666584370197,-760
1028,2019-10-26,2019,230687,230687,406153703.1666667,3592854.800000004,178265,0,78,0.8364103742300174,40989851,5412148540,231635,231634,527117,758752,344432650.48332727,3589072.1833332726,179069,0,78,0.2558345809961594,4503704343,-948,-947,61721052.68333942,3782.6166667314246,-804,0,0,0.580575793233858,-4462714492,1760.6267503876104,1486.9693157452157,273.6574346423947,0.7727570257535101,0.7730653830379692,-804
1029,2019-10-27,2019,228975,228975,406091283.11666703,3534664.0833333316,177068,0,113,0.8395545365214544,40715209,5415299976,230013,230012,535305,765318,344631927.66666126,3532630.4999999637,177853,0,113,0.2528413025696526,4516291794,-1038,-1037,61459355.45000577,2033.5833333679475,-785,0,0,0.5867132339518017,-4475576585,1773.517995923865,1498.3215122109336,275.19648371293147,0.7733071295993013,0.7732302087273328,-785
1030,2019-10-28,2019,230218,230218,406176699.85,3555685.5999999996,178596,0,76,0.8392610482238568,41146603,5421336462,231346,231346,545957,777303,344974664.98332745,3552474.4166665897,179440,0,76,0.25022931855402275,4528626358,-1128,-1128,61202034.866672575,3211.18333340995,-844,0,0,0.5890317296698341,-4487479755,1764.3133892658263,1491.1633007846578,273.1500884811685,0.775769053679556,0.7756347635143896,-844
1031,2019-10-29,2019,233350,233350,406176443.0666674,3605783.9333333336,180360,0,38,0.8351874866080994,41091801,5421821879,234325,234325,548905,783230,345208166.4666623,3602767.899999959,181098,0,38,0.25018832271490943,4530195505,-975,-975,60968276.60000509,3016.033333374653,-738,0,0,0.58499916389319,-4489103704,1740.631853724737,1473.2024601159171,267.42939360881996,0.7729162202699807,0.7728496745972474,-738
1032,2019-10-30,2019,234332,234332,406575116.6666673,3647206.8833333296,180585,0,43,0.8321398699281357,41249725,5428721009,235328,235328,554723,790051,345846881.36666465,3642949.5166665968,181413,0,43,0.24840548268402696,4536286769,-996,-996,60728235.300002635,4257.366666732822,-828,0,0,0.5837343872441088,-4495037044,1735.0388195665435,1469.637617991334,265.40120157520937,0.7706373862724681,0.770894241229263,-828
1033,2019-10-31,2019,238496,238496,407284786.6666662,3718682.083333335,183284,0,35,0.8328273849456584,41076692,5438193282,239486,239486,558422,797908,346720281.94999754,3713593.299999932,184138,0,35,0.2505928001724549,4546877870,-990,-990,60564504.716668665,5088.783333403058,-854,0,0,0.5822345847732036,-4505801178,1707.7216668902884,1447.7684789507425,259.95318793954584,0.7684992620421307,0.7688883692574932,-854
1034,2019-11-01,2019,234397,234397,407128058.78333294,3630495.1666666595,179671,0,79,0.8317811234785442,41003326,5439430756,235388,235388,280620,516008,346892409.3666775,3625376.449999835,180689,0,83,0.3808526224399653,4481290710,-991,-991,60235649.41665542,5118.71666682465,-1018,0,-4,0.45092850103857884,-4440287384,1736.9166788966281,1473.704731620463,263.2119472761651,0.7665243155842438,0.767621968834435,-1018
1035,2019-11-02,2019,233049,233049,407104049.4000001,3628051.6499999985,178463,0,113,0.8337731550017375,41497596,5439377820,234022,234022,290307,524329,347088887.4666753,3622186.849999827,179437,0,113,0.37352692679597194,4494017487,-973,-973,60015161.933324814,5864.800000171643,-974,0,0,0.4602462282057656,-4452519891,1746.8603143544924,1483.1464027598913,263.7139115946011,0.7657745795948492,0.766752698464247,-974
1036,2019-11-03,2019,228632,228632,407064595.33333296,3540906.8500000006,176803,0,147,0.8444793379754371,41688049,5445604019,229641,229641,302440,532081,347245121.7333394,3535790.483333152,177779,0,147,0.36547818847129543,4512205293,-1009,-1009,59819473.59999353,5116.366666848771,-976,0,0,0.47900114950414163,-4470517244,1780.4357890992203,1512.1216234615745,268.31416563764583,0.7733081983274432,0.7741605375346737,-976
1037,2019-11-04,2019,227296,227296,407025203.3666673,3563756.2833333355,176685,0,206,0.8426853090243559,40973661,5452376505,229788,229788,314660,544448,347454555.1166837,3559488.8333331523,177902,0,206,0.354691357117659,4526330090,-2492,-2492,59570648.24998355,4267.450000183191,-1217,0,0,0.4879939519066969,-4485356429,1790.727524314846,1512.0657088998717,278.6618154149744,0.777334400957342,0.7742005674795899,-1217
1038,2019-11-05,2019,228168,228168,407080769.7166668,3590573.5666666636,177061,0,237,0.8417131236632658,40891655,5454753839,235883,235883,320476,556359,347738220.3833431,3608698.633333159,180360,0,237,0.3519993385565779,4530555286,-7715,-7715,59342549.33332372,-18125.06666649552,-3299,0,0,0.4897137851066879,-4489663631,1784.1273522872043,1474.197887865353,309.9294644218512,0.7760115353599102,0.764616356413985,-3299
1039,2019-11-06,2019,233233,233233,407231813.8000001,3591850.8166666673,179935,0,201,0.8384319543117835,41218947,5456105522,234329,234327,329875,564204,346875055.9833373,3586950.799999873,180776,0,201,0.348790508397669,4518018775,-1096,-1094,60356757.81666279,4900.016666794196,-841,0,0,0.4896414459141145,-4476799828,1746.0299948978063,1480.3034049995829,265.72658989822344,0.7714817371469732,0.7714623456763781,-841
1040,2019-11-07,2019,230550,230550,406873404.79999924,3555456.383333328,178954,0,57,0.8422901756668836,41903135,5456855906,231640,231639,336369,568009,346806751.7666797,3550496.799999865,179807,0,57,0.34403504169827875,4522264345,-1090,-1089,60066653.03331953,4959.583333463408,-853,0,0,0.4982551339686048,-4480361210,1764.7946423769215,1497.1863622562682,267.60828012065326,0.7762047278247669,0.7762346744949059,-853
1041,2019-11-08,2019,231413,231413,406788649.4166667,3607235.083333332,179278,0,51,0.8399268839693527,42073134,5457514312,232438,232434,344313,576751,347046795.90000534,3601736.099999875,180190,0,50,0.33953300471087633,4533535312,-1025,-1021,59741853.516661346,5498.983333457261,-912,0,1,0.5003938792584763,-4491462178,1757.8470069385328,1493.0982382095792,264.74876872895356,0.7747101502508502,0.7752174773487984,-912
1042,2019-11-09,2019,234140,234140,406695674.01666623,3562786.833333328,179836,0,154,0.8319723242504468,41315854,5456213468,235026,235026,352175,587201,347260969.23334587,3556962.3999998122,180651,0,155,0.3337749765412598,4542288463,-886,-886,59434704.78332037,5824.433333515655,-815,0,-1,0.49819734770918694,-4500972609,1736.97648422596,1477.5427792386624,259.43370498729746,0.7680703852396003,0.7686426182635113,-815
1043,2019-11-10,2019,229255,229255,405980386.3833339,3553773.5833333363,174981,0,326,0.8326492333864032,40895875,5454971399,230121,230121,363658,593779,346778075.300013,3548743.2833331656,175791,0,326,0.32353282955443147,4557389121,-866,-866,59202311.083320916,5030.300000170711,-810,0,0,0.5091164038319718,-4516493246,1770.8681877530869,1506.9379817574797,263.93020599560714,0.7632592527971037,0.7639068142412035,-810
1044,2019-11-11,2019,235857,235857,406259022.15000004,3637481.6333333366,180582,0,128,0.8346837278520464,41516396,5462594893,236778,236773,368387,605165,347349745.33334655,3631600.366666537,181407,0,128,0.32720167227120045,4570981759,-921,-916,58909276.81665349,5881.266666799784,-825,0,0,0.5074820555808459,-4529465363,1722.4802407814907,1467.0158562561885,255.4643845253022,0.7656418931810377,0.7661480374021236,-825
1045,2019-11-12,2019,234949,234949,406701403.03333336,3600025.7666666717,180603,0,76,0.8345002532464493,41556032,5470336749,235971,235971,372555,608526,348030935.900015,3594406.3833331745,181456,0,76,0.3242835967567481,4577055094,-1022,-1022,58670467.133318365,5619.383333497215,-853,0,0,0.5102166564897012,-4535499062,1731.0199363833572,1474.8885918185497,256.1313445648075,0.7686902263895569,0.7689758487271741,-853
1046,2019-11-13,2019,229598,229598,406539105.5666666,3531672.4333333387,177395,0,38,0.836993353600642,40664348,5472275726,230448,230448,384447,614895,348132658.6000134,3526692.6333331745,178151,0,40,0.3141902275998365,4582800494,-850,-850,58406446.96665323,4979.800000164192,-756,0,-2,0.5228031260008055,-4542136146,1770.6561275214358,1510.677717315895,259.97841020554074,0.7726330368731434,0.7730637714365063,-756
1047,2019-11-14,2019,229689,229689,406235104.08333325,3521271.8666666616,178271,0,47,0.8420995345880725,40046473,5469982388,234524,234524,393931,628455,348167294.46668583,3516722.599999847,180286,0,47,0.3116134011186103,4596682448,-4835,-4835,58067809.61664742,4549.266666814685,-2015,0,0,0.5304861334694622,-4556635975,1768.631079778889,1484.5699990904377,284.0610806884513,0.7761407816656436,0.7687315583906125,-2015
1048,2019-11-15,2019,234639,234639,406424819.50000036,3568508.58333333,180771,0,44,0.8370262403095812,40014944,5474692356,235469,235469,403657,639126,347655645.98334396,3562955.9166665124,181552,0,44,0.3091315327494095,4586106332,-830,-830,58769173.5166564,5552.666666817851,-781,0,0,0.5278947075601716,-4546091388,1732.1281607064484,1476.4391320443199,255.68902866212852,0.7704217968879854,0.7710229372019247,-781
1049,2019-11-16,2019,229932,229932,406432364.3999996,3567232.7499999925,176118,0,48,0.8375171789920491,40213904,5475451094,230651,230650,405249,635900,347835733.7333452,3562029.399999842,176785,0,48,0.30441736122031016,4592702943,-719,-718,58596630.66665441,5203.350000150502,-667,0,0,0.533099817771739,-4552489039,1767.6198371692483,1508.067347640777,259.55248952847137,0.7659568916027347,0.7664610168609718,-667
1050,2019-11-17,2019,234386,234386,406501658.1833336,3535741.133333336,179181,0,78,0.8401440359065813,40497446,5479534961,235079,235079,414375,649454,348168867.38334584,3530734.8333331477,179872,0,75,0.3048499200867274,4608438956,-693,-693,58332790.79998773,5006.300000188407,-691,0,3,0.5352941158198539,-4567941510,1734.3256772304385,1481.0717562323553,253.25392099808323,0.7644697208877663,0.7651555434556043,-691
1051,2019-11-18,2019,222961,222961,405725381.0999998,3505232.033333331,172598,0,57,0.8391916075008632,40381666,5475581369,223674,223674,428213,651887,347966021.4333415,3499304.4166665482,173230,0,57,0.28861443777831913,4618130566,-713,-713,57759359.66665828,5927.616666782647,-632,0,0,0.5505771697225441,-4577748900,1819.7145738492372,1555.68381409257,264.0307597566673,0.774117446548948,0.774475352521974,-632
1052,2019-11-19,2019,230118,230118,405760820.7833336,3542908.666666664,177953,0,36,0.836783737039258,40013941,5475552906,232296,232296,432228,664524,348223472.71668196,3539217.4833331797,178910,0,37,0.2917622237872503,4622105057,-2178,-2178,57537348.06665164,3691.183333484456,-957,0,-1,0.5450215132520078,-4582091116,1763.2728460326164,1499.0506625886023,264.22218344401404,0.7733119529980271,0.7701811481902401,-957
1053,2019-11-20,2019,229572,229572,405434460.8000005,3541532.749999997,177223,0,49,0.834857909501159,39775340,5463176240,230395,230395,437060,667455,348275762.2166805,3536821.949999828,177889,0,34,0.2886321924324555,4622638434,-823,-823,57158698.58331996,4710.800000169314,-666,0,15,0.5462257170687035,-4582863094,1766.0449044308561,1511.6463561131125,254.3985483177437,0.7719713205443173,0.7721044293495952,-666
1054,2019-11-21,2019,231018,231018,405118667.533333,3554727.283333333,177512,0,38,0.8336233540243612,39590546,5457704447,231765,231765,443356,675121,348358356.4833441,3548799.2333331485,178112,0,38,0.2865264152648188,4626124228,-747,-747,56760311.049988925,5928.050000184681,-600,0,0,0.5470969387595424,-4586533682,1753.623819500355,1503.0671433708458,250.55667612950924,0.768390341878122,0.7685025780424136,-600
1055,2019-11-22,2019,237701,237701,405228280.06666625,3622855.8333333367,183108,0,75,0.844678819188812,40648249,5458617876,238729,238729,447383,686112,348747448.7500129,3617505.4333331836,183917,0,75,0.2944286064082799,4631404169,-1028,-1028,56480831.31665337,5350.400000153109,-809,0,0,0.5502502127805322,-4590755920,1704.78155357641,1460.8507921116113,243.9307614647987,0.7703291109418976,0.7704007472908612,-809
1056,2019-11-23,2019,234654,234654,405247740.9166668,3633004.7999999984,180646,0,50,0.8451166398186262,41319442,5460673530,239576,239576,452381,691957,348933852.5166644,3631567.266666193,182104,0,50,0.2895078740441916,4636140817,-4922,-4922,56313888.40000242,1437.5333338053897,-1458,0,0,0.5556087657744346,-4594821375,1727.001205675875,1456.464138797978,270.53706687789713,0.769839849310048,0.7601095268307343,-1458
1057,2019-11-24,2019,225035,225035,405161944.7499995,3492618.116666666,174083,0,84,0.8486724287333083,40497779,5463061497,232765,232765,464040,696805,348968238.81666243,3490880.099999573,176518,0,84,0.278083538436141,4650792863,-7730,-7730,56193705.93333709,1738.0166670931503,-2435,0,0,0.5705888902971673,-4610295084,1800.4396860488348,1499.2298619494445,301.2098240993903,0.7735818872619815,0.7583528451442442,-2435
1058,2019-11-25,2019,225238,225238,405334270.66666657,3506513.7000000067,173840,0,40,0.8352187463927045,40882039,5472593053,226225,226225,480277,706502,346990798.7000152,3501836.016666529,174704,0,40,0.2684366073981431,4619040999,-987,-987,58343471.96665138,4677.683333477937,-864,0,0,0.5667821389945614,-4578158960,1799.5820894638853,1533.830472759488,265.7516167043973,0.7718058231737096,0.7722577080340369,-864
1059,2019-11-26,2019,226172,226172,405772686.40000105,3522965.9000000046,174750,0,90,0.8366906602055072,40459357,5479580171,227294,227294,476285,703579,347579552.15001047,3518305.4166661487,175623,0,91,0.27086226280204556,4622959597,-1122,-1122,58193134.24999058,4660.483333855867,-873,0,-1,0.5658283974034617,-4582500240,1794.088951771223,1529.206895694609,264.88205607661394,0.7726420600251136,0.7726688781930011,-873
1060,2019-11-27,2019,218428,218428,405785189.333333,3477442.6166666653,168387,0,83,0.83586353397916,40283953,5482566970,219371,219371,485621,704992,347890150.18334156,3471771.816666509,169111,0,84,0.2606909014570342,4635429490,-943,-943,57895039.14999145,5670.800000156276,-724,0,-1,0.5751726325221258,-4595145537,1857.752620237941,1585.8529622572792,271.8996579806619,0.7709039134176937,0.7708904093977782,-724
1061,2019-11-28,2019,220643,220643,405736873.40000033,3455310.48333333,167896,0,57,0.822210539196802,40126352,5486489933,222209,222209,495108,717317,348063247.74999666,3450897.633333262,168755,0,57,0.2546781966689806,4647505919,-1566,-1566,57673625.65000367,4412.85000006808,-859,0,0,0.5675323425278214,-4607379567,1838.8839591557419,1566.3778143549391,272.50614480080276,0.760939617390989,0.7594426868398669,-859
1062,2019-11-29,2019,230200,230200,406030062.2500006,3499850.9166666716,175066,0,67,0.82254561251086,39977372,5492617946,231193,231193,499747,730940,348545273.75001365,3496125.083332834,175878,0,66,0.2609625961091049,4655883342,-993,-993,57484788.49998695,3725.8333338377997,-812,0,1,0.5615830164017551,-4615905970,1763.8143451346682,1507.5944070539058,256.2199380807624,0.7604952215464813,0.7607410258961128,-812
1063,2019-11-30,2019,223077,223077,405998122.0500002,3482447.100000006,170364,0,44,0.8305472998112756,39868154,5495607140,225926,225926,505919,731845,348752713.3999952,3477644.283333285,171477,0,44,0.25550492249041606,4665205496,-2849,-2849,57245408.65000498,4802.816666721366,-1113,0,0,0.5750423773208595,-4625337342,1819.9909540203616,1543.6590449970133,276.3319090233483,0.7637004263101979,0.7589963085258005,-1113
1064,2019-12-01,2019,219616,219616,405780072.0166669,3415784.6999999927,167299,0,45,0.8393923939967943,39995597,5499434019,220625,220625,273045,493670,348827706.18334204,3410537.699999867,168335,0,45,0.3768610610326746,4612181578,-1009,-1009,56952365.83332485,5247.000000125729,-1036,0,0,0.46253133296411975,-4572185981,1847.6799141076556,1581.088753238944,266.59116086871154,0.7617796517557919,0.7629915014164306,-1036
1065,2019-12-02,2019,221749,221749,406282232.93333405,3447798.333333334,170679,0,40,0.8338526893018696,40360805,5512692400,228307,228307,283825,512132,349473921.9666772,3452644.166666502,173701,0,40,0.3681726586114482,4627994692,-6558,-6558,56808310.96665686,-4845.833333168179,-3022,0,0,0.4656800306904214,-4587633887,1832.1716577451716,1530.719259447486,301.4523982976857,0.769694564575263,0.7608220510102625,-3022
1066,2019-12-03,2019,221243,221243,406740480.89999974,3488352.349999995,169866,0,39,0.8284284700532899,40172430,5521894410,225011,225011,289800,514811,349318647.68334484,3485455.349999834,171794,0,37,0.3609266313268369,4621137603,-3768,-3768,57421833.2166549,2897.000000161119,-1928,0,2,0.467501838726453,-4580965173,1838.4332200340789,1552.4514254118458,285.9817946222331,0.7677802235550956,0.7634915626347156,-1928
1067,2019-12-04,2019,222523,222523,407019185.7333333,3486415.466666669,170855,0,45,0.829927692867704,40797321,5528346873,223757,223757,293102,516859,349108715.0666772,3481514.3833331224,171846,0,45,0.36014851245697904,4612120267,-1234,-1234,57910470.66665608,4901.083333546761,-991,0,0,0.4697791804107249,-4571322946,1829.1106345561282,1560.2136025540083,268.8970320021199,0.7678082715045186,0.7680027887395702,-991
1068,2019-12-05,2019,219985,219985,407320549.0000001,3479664.300000003,169607,0,48,0.8360797327090477,40312818,5533593480,221119,221119,302641,523760,349657528.15000856,3475119.0999998683,170472,0,51,0.3537555368871177,4626097151,-1134,-1134,57663020.84999156,4545.200000134762,-865,0,-3,0.48232419582193,-4585784333,1851.583285223993,1581.3092866285058,270.2739985954872,0.7709934768279656,0.7709513881665528,-865
1069,2019-12-06,2019,216222,216222,407525031.18333346,3458025.4666666663,166702,0,43,0.8326118526329434,39440245,5537157550,217327,217327,311564,528891,350085057.733341,3453503.766666504,167589,0,43,0.34355661185385933,4636239054,-1105,-1105,57439973.44999248,4521.700000162236,-887,0,0,0.489055240779084,-4596798809,1884.752852084124,1610.8677602568525,273.8850918272715,0.7709761263886191,0.7711375024732315,-887
1070,2019-12-07,2019,224851,224851,407794263.6833335,3471640.3166666646,172157,0,67,0.8283040769220509,39851209,5540745050,225901,225901,318662,544563,350560074.3833449,3467908.416666471,173065,0,67,0.3445239577422663,4650461175,-1050,-1050,57234189.29998863,3731.900000193622,-908,0,0,0.4837801191797846,-4610609966,1813.6199691499417,1551.830555789239,261.7894133607026,0.765649252171438,0.7661099331122926,-908
1071,2019-12-08,2019,224561,224561,407771128.2499997,3452435.650000003,171088,0,38,0.8292357087829132,39809630,5542302814,233899,233899,326075,559974,350857556.43334603,3494499.649999803,174661,0,38,0.33989256644058435,4666918764,-9338,-9338,56913571.81665367,-42063.999999799766,-3573,0,0,0.48934314234232884,-4627109134,1815.8590683600435,1500.0387194188347,315.82034894120875,0.7618776189988467,0.7467368394050423,-3573
1072,2019-12-09,2019,226417,226417,407849631.3666675,3528233.6666666674,172431,0,34,0.827300953550308,39922206,5544956938,234168,234168,335372,569540,350643887.28333974,3544157.599999849,175452,0,34,0.33539523123924964,4662143160,-7751,-7751,57205744.08332777,-15923.933333181776,-3021,0,0,0.49190572231105834,-4622220954,1801.320710753466,1497.4030921532392,303.9176186002269,0.7615638401710119,0.7492569437327047,-3021
1073,2019-12-10,2019,229399,229399,408320657.69999975,3549078.516666669,175028,0,38,0.8296287254957527,40619494,5552115327,231679,231679,338894,570573,350306106.58334583,3545524.8833331373,176265,0,38,0.33654939858703264,4642166533,-2280,-2280,58014551.11665392,3553.633333531674,-1237,0,0,0.4930793269087201,-4601547039,1779.9583158601379,1512.0321936098906,267.9261222502473,0.7629850173714794,0.7608156112552281,-1237
1074,2019-12-11,2019,226040,226040,408211471.3166665,3478897.266666669,173206,0,44,0.8342461511236955,39856731,5554361312,227036,227036,346868,573904,350095246.5000123,3474494.1333331633,174054,0,46,0.33073649948423184,4637585968,-996,-996,58116224.816654205,4403.133333505597,-848,0,-2,0.5035096516394637,-4597729237,1805.9258154161498,1542.0252581089003,263.9005573072495,0.766262608387896,0.7666361281911239,-848
1075,2019-12-12,2019,223255,223255,407975360.6833329,3456555.699999999,172027,0,37,0.8368726344314803,39966863,5554929629,234799,234799,356324,591123,350091748.1333365,3513237.3666665,176367,0,37,0.3244383994532436,4645281167,-11544,-11544,57883612.549996436,-56681.6666665012,-4340,0,0,0.5124342349782367,-4605314304,1827.3962987764346,1491.027424023682,336.3688747527526,0.7705404134285906,0.7511403370542464,-4340
1076,2019-12-13,2019,222450,222450,407864532.7666663,3442016.06666667,171262,0,49,0.8371768936839746,39580863,5556991741,223707,223707,373591,597298,348581820.5833412,3436915.9999998375,172204,0,49,0.3140023907664149,4636550304,-1257,-1257,59282712.18332511,5100.066666832659,-942,0,0,0.5231745029175597,-4596969441,1833.5110486251576,1558.2070323384658,275.3040162866919,0.7698898628905372,0.7697747500078227,-942
1077,2019-12-14,2019,221167,221167,407916345.0166664,3443429.76666667,168975,0,39,0.8299068124991527,39054161,5560708179,222043,222043,373694,595737,348585406.68334556,3439299.183333193,169769,0,39,0.31019057067128364,4632469332,-876,-876,59330938.333320856,4130.583333476912,-794,0,0,0.519716241827869,-4593415171,1844.3815985959316,1569.9004547918446,274.48114380408697,0.7640154272563267,0.7645771314565197,-794
1078,2019-12-15,2019,219545,219545,408186243.66666603,3446627.0833333316,168083,0,39,0.8373590835591798,39410290,5563227260,220515,220515,380772,601287,349024091.76667,3442617.1333331903,168890,0,39,0.30767337394621447,4646617145,-970,-970,59162151.89999604,4009.9500001412816,-807,0,0,0.5296857096129652,-4607206855,1859.2372573580178,1582.768028327642,276.4692290303758,0.7655970302215946,0.7658889417953427,-807
1079,2019-12-16,2019,227358,227358,408627753.41666615,3505926.200000005,174535,0,105,0.8416330192911615,39666348,5571453696,228487,228487,387516,616003,349638740.5500103,3501689.7666665157,175383,0,105,0.31283613878504124,4658958285,-1129,-1129,58989012.86665583,4236.433333489113,-848,0,0,0.5287968805061203,-4619291937,1797.2877726610286,1530.2347203561267,267.05305230490194,0.7676659717274079,0.7675841513959218,-848
1080,2019-12-17,2019,226425,226425,408666003.7666664,3503259.4333333303,174691,0,53,0.8425968863862211,40813316,5572623908,227425,227424,390615,618040,349838640.0666816,3498933.616666535,175479,0,53,0.31078570966280084,4665668708,-1000,-999,58827363.69998479,4325.8166667954065,-788,0,0,0.5318111767234203,-4624855392,1804.862553899377,1538.266146346391,266.59640755298597,0.7715181627470464,0.7715906342750357,-788
1081,2019-12-18,2019,224128,224128,408539451.3166668,3467679.0333333355,173518,0,138,0.8431967447173048,41620729,5576569771,231934,231934,401910,633844,350101307.9666835,3472996.049999587,175597,0,137,0.3021295460712765,4678470411,-7806,-7806,58438143.349983275,-5317.016666251235,-2079,0,1,0.5410671986460283,-4636849682,1822.7952389557163,1509.486784890027,313.3084540656894,0.7741915334094803,0.7570990023023791,-2079
1082,2019-12-19,2019,218787,218787,408888243.5499999,3453790.283333333,169707,0,85,0.843020837618322,42377524,5583725982,243655,243654,412077,655732,350048697.85002136,3503995.0166665614,181054,0,87,0.2996590070333631,4683745946,-24868,-24867,58839545.69997853,-50204.733333228156,-11347,0,-2,0.5433618305849589,-4641368422,1868.8872901497798,1436.6630461639102,432.22424398586963,0.775672229154383,0.7430752498409636,-11347
1083,2019-12-20,2019,219080,219080,409210838.3499996,3452051.0999999996,169093,0,306,0.8394924228592286,42566158,5589688716,220021,220021,426764,646785,340077904.20001066,3447542.633333186,169940,0,308,0.2866362083227048,4458075568,-941,-941,69132934.14998895,4508.466666813474,-847,0,-2,0.5528562145365239,-4415509410,1867.8603174639384,1545.6611150754277,322.1992023885107,0.7718322074128172,0.7723808181946269,-847
1084,2019-12-21,2019,219636,219636,409233951.75000006,3463598.4333333382,169010,0,327,0.8384827623886791,42686070,5594117473,220695,220695,426976,647671,340364967.1666799,3458725.099999848,170076,0,327,0.2869744052149893,4466769276,-1059,-1059,68868984.58332014,4873.333333490416,-1066,0,0,0.5515083571736898,-4424083206,1863.2371366715843,1542.2414063149592,320.995730356625,0.7695004461927917,0.7706382111058248,-1066
1085,2019-12-22,2019,217931,217931,409115947.9500003,3394891.85,167484,0,237,0.8384763984931014,42629258,5599040534,218896,218896,434982,653878,340535585.43335235,3390525.0499998573,168407,0,237,0.28162134220757223,4483159106,-965,-965,68580362.51664793,4366.800000142772,-923,0,0,0.5568550562855292,-4440529848,1877.2728430099448,1555.695789020139,321.5770539898058,0.7685184760314044,0.769347087201228,-923
1086,2019-12-23,2019,217277,217277,409659700.1999996,3399756.86666667,167509,0,87,0.8318597918785691,41972088,5612169922,218211,218211,445046,663257,341294233.6500038,3394574.9833328337,168327,0,87,0.27447580651240433,4501944897,-934,-934,68365466.54999578,5181.8833338362165,-818,0,0,0.5573839853661647,-4459972809,1885.4259778991775,1564.0560450664898,321.3699328326877,0.7709467638084104,0.7713955758417311,-818
1087,2019-12-24,2019,214356,214356,409555499.6166668,3407146.5833333293,165950,0,162,0.8417165836272369,42144874,5616614191,217305,217305,450290,667595,341447123.1166638,3403777.816666309,167369,0,162,0.2731086961406154,4512587186,-2949,-2949,68108376.50000298,3368.766667020507,-1419,0,0,0.5686078874866215,-4470442312,1910.632310813165,1571.2805647208477,339.3517460923174,0.7741794024893168,0.7702031706587515,-1419
1088,2019-12-25,2019,212450,212450,409342919.03333366,3384129.9666666733,164191,0,131,0.8453847964226877,41830618,5617350758,213503,213503,458659,672162,341373142.05001235,3379239.5499998126,165236,0,131,0.269506458264522,4525759853,-1053,-1053,67969776.98332131,4890.416666860692,-1045,0,0,0.5758783381581657,-4483929235,1926.7729773280003,1598.9149663002972,327.858011027703,0.7728453753824429,0.7739282352004422,-1045
1089,2019-12-26,2019,211460,211460,409798341.95,3354941.716666661,163992,0,293,0.8496453229925277,42109243,5630339608,212521,212521,465129,677650,342098704.58334386,3350300.533333163,164952,0,293,0.2675894635874026,4545036930,-1061,-1061,67699637.36665612,4641.183333498426,-960,0,0,0.582055859405125,-4502927687,1937.9473278634257,1609.7171789298181,328.23014893360755,0.7755225574576752,0.7761680022209569,-960
1090,2019-12-27,2019,216139,216139,410043417.55000097,3388968.9999999967,167941,0,287,0.8525162048496576,42727362,5639040917,217277,217277,471070,688347,342602776.5666759,3383691.31666651,168964,0,287,0.27018930858999624,4557693438,-1138,-1138,67440640.98332506,5277.683333486784,-1023,0,0,0.5823268962596614,-4514966076,1897.1283181193628,1576.8018546218693,320.3264634974935,0.7770046127723363,0.7776432848391684,-1023
1091,2019-12-28,2019,214563,214563,410242579.68333346,3395149.866666673,166726,0,453,0.8500114185577196,42608742,5646887812,215696,215696,476685,692381,343151015.63334477,3390075.5999998236,167739,0,453,0.2655849886117545,4568291828,-1133,-1133,67091564.04998869,5074.2666668496095,-1013,0,0,0.584426429945965,-4525683086,1911.9912551713644,1590.9011554843148,321.0900996870496,0.7770491650470958,0.7776639344262295,-1013
1092,2019-12-29,2019,219331,219331,410491424.55,3399341.3999999985,167395,0,361,0.8403691224678681,43113106,5654678934,220441,220441,482614,703055,343705568.8833432,3394989.0999998217,168358,0,361,0.2643889880592562,4588055249,-1110,-1110,66785855.66665679,4352.300000176765,-963,0,0,0.575980134408612,-4544942143,1871.5613595433388,1559.1726080145854,312.38875152875335,0.763207207371507,0.7637326994524613,-963
1093,2019-12-30,2019,219617,219617,410898500.2500002,3391745.9833333353,166872,0,424,0.832048520833998,43083984,5668614489,220656,220656,491643,712299,344342644.15000725,3386619.4999996815,167775,0,424,0.25873404286682294,4606429022,-1039,-1039,66555856.09999293,5126.48333365377,-903,0,0,0.573314477967175,-4563345038,1870.977657694988,1560.5405887445038,310.4370689504842,0.7598318891524791,0.7603464215792909,-903
1094,2019-12-31,2019,211585,211585,410973190.31666726,3334846.3166666646,164088,0,321,0.8437696434057232,42466601,5678278671,220788,220788,506292,727080,344749800.8333343,3370356.749999491,167826,0,322,0.2515624140397199,4623595933,-9203,-9203,66223389.48333293,-35510.43333282648,-3738,0,-1,0.5922072293660033,-4581129332,1942.3550361162997,1561.451713106393,380.90332300990667,0.775518113287804,0.7601228327626501,-3738
1095,2020-01-01,2020,208093,208093,410514950.4833331,3296424.883333329,159956,0,304,0.8287160067854273,41012553,5681684088,208893,208893,265640,474533,344090174.83334637,3291594.966666535,160822,0,307,0.36631593587801525,4574359359,-800,-800,66424775.649986744,4829.916666794103,-866,0,-3,0.4624000709074121,-4533346806,1972.747523863528,1647.2077802192814,325.5397436442465,0.7686755441076826,0.769877401349016,-866
1096,2020-01-02,2020,213898,213898,411312077.71666604,3386058.799999997,165128,0,73,0.8353187033071835,42341678,5697263647,214890,214890,264077,478967,345022796.61668396,3381804.9166664667,166006,0,73,0.37598832487415723,4588916598,-992,-992,66289281.09998208,4253.883333530277,-878,0,0,0.45933037843302627,-4546574920,1922.9355941461165,1605.5786524113917,317.35694173472484,0.7719941280423379,0.7725161710642654,-878
1097,2020-01-03,2020,215627,215627,412040869.2000003,3411316.1666666633,166085,0,189,0.8440686926961842,43020675,5709656645,216611,216611,266702,483313,346014799.13334435,3407188.7333331453,167017,0,188,0.37969390436425005,4598029637,-984,-984,66026070.066655934,4127.433333517984,-932,0,1,0.4643747883319342,-4555008962,1910.8964517430577,1597.4017899984042,313.4946617446535,0.7702421310874797,0.7710457917649611,-932
1098,2020-01-04,2020,211527,211527,412079523.0666668,3370108.833333337,163089,0,304,0.8475797415932712,41673752,5713881342,212438,212438,276318,488756,346343524.4166765,3365328.166666532,164015,0,304,0.3698900883058266,4611076213,-911,-911,65735998.64999026,4780.6666668052785,-926,0,0,0.4776896532874446,-4569402461,1948.1178434273959,1630.3275516464876,317.7902917809083,0.7710079564310939,0.7720605541381486,-926
1099,2020-01-05,2020,209508,209508,412366279.7166663,3336189.266666669,161570,0,261,0.8435525135078368,42499238,5725246105,210337,210337,287125,497462,346963254.5500062,3332342.8166664904,162400,0,261,0.35783838765574194,4629225600,-829,-829,65403025.16666007,3846.4500001785345,-830,0,0,0.48571412585209484,-4586726362,1968.2603037433714,1649.558824885808,318.7014788575634,0.7711877350745556,0.7720943058044947,-830
1100,2020-01-06,2020,214961,214961,412951539.0166657,3381719.9333333345,165640,0,192,0.8422178906871473,42826713,5738648346,215820,215820,295263,511083,347773650.1000069,3377459.066666461,166480,0,192,0.3570594208768433,4646240440,-859,-859,65177888.91665882,4260.866666873451,-840,0,0,0.48515846981030397,-4603413727,1921.0533027696451,1611.4060332684962,309.6472695011489,0.7705583803573671,0.771383560374386,-840
1101,2020-01-07,2020,216478,216478,413401332.0666667,3436054.0166666615,167190,0,74,0.8414758081652651,43425233,5748630381,217386,217386,299364,516750,348524006.6333436,3431442.949999801,167965,0,74,0.35495500725689594,4656908193,-908,-908,64877325.433323145,4611.066666860599,-775,0,0,0.4865208009083692,-4613482960,1909.6690290314339,1603.2495498023957,306.4194792290382,0.772318665176138,0.7726578528516096,-775
1102,2020-01-08,2020,217762,217762,413776072.21666676,3407415.5,167716,0,54,0.8317107668004511,42824927,5757878411,218688,218688,307979,526667,349086780.66667867,3403222.883333146,168585,0,54,0.3467902868415788,4672203132,-926,-926,64689291.54998809,4192.616666853894,-869,0,0,0.4849204799588723,-4629378205,1900.1298308091714,1596.2777137596881,303.85211704948324,0.7701802885719271,0.7708927787532923,-869
1103,2020-01-09,2020,217857,217857,413923280.16666675,3405598.5166666694,166874,0,75,0.8315500534754455,42519894,5762382290,218913,218913,316040,534953,349551056.9166833,3401070.633333179,167824,0,74,0.3416281430331204,4688056289,-1056,-1056,64372223.24998343,4527.88333349023,-950,0,1,0.48992191044232514,-4645536395,1899.9769581269675,1596.757876036066,303.21908209090157,0.7659795186750942,0.7666241840365807,-950
1104,2020-01-10,2020,215156,215156,413809881.5833337,3377868.6833333336,165202,0,146,0.8342133149900536,42281825,5761603172,216092,216092,324607,540699,349754329.98334336,3373499.633333155,166079,0,146,0.33473337291172506,4700559612,-936,-936,64055551.59999031,4369.050000178628,-877,0,0,0.4994799420783285,-4658277787,1923.3016117762631,1618.543629488104,304.75798228815916,0.7678242763390284,0.7685569109453381,-877
1105,2020-01-11,2020,206627,206627,413349003.51666623,3312167.5333333313,159331,0,144,0.8382689580742118,40958308,5762565401,207620,207619,335942,543562,349617347.11667204,3307293.699999868,160250,0,144,0.3215309385129883,4710974948,-993,-992,63731656.399994195,4873.833333463408,-919,0,0,0.5167380195612234,-4670016640,2000.4597826840936,1683.937149859464,316.5226328246297,0.7711044539193813,0.7718427897119738,-919
1106,2020-01-12,2020,201046,201046,413402918.2000005,3250716.5500000035,155216,0,122,0.8361171075276316,41179184,5770186247,202005,202005,347061,549066,349902979.5500124,3246196.5999998217,156118,0,122,0.3085257510026062,4726399883,-959,-959,63499938.649988115,4519.950000181794,-902,0,0,0.5275913565250254,-4685220699,2056.260349372783,1732.1500930670647,324.11025630571817,0.7720422191936174,0.7728422563797925,-902
1107,2020-01-13,2020,207577,207577,413888059.4833332,3312343.0666666687,160696,0,153,0.8384262225583762,41375238,5782655843,208642,208642,354777,563419,350610463.31667763,3307645.3166664974,161571,0,153,0.3116206588702207,4745312709,-1065,-1065,63277596.16665554,4697.750000171363,-875,0,0,0.5268055636881555,-4703937471,1993.901344962752,1680.4404832999953,313.46086166275677,0.7741512788025648,0.7743934586516616,-875
1108,2020-01-14,2020,205690,205690,414274586.0999994,3302222.4500000034,159105,0,128,0.8325441197919202,41331944,5790790109,206608,206608,357076,563684,351174077.75000536,3298634.399999827,159782,0,128,0.3059178546845374,4753444277,-918,-918,63100508.34999406,3588.0500001762994,-677,0,0,0.5266262651073828,-4712112333,2014.0725659973718,1699.7119073317847,314.36065866558715,0.7735184014779523,0.7733582436304499,-677
1109,2020-01-15,2020,207438,207438,414409854.68333286,3297956.966666665,160123,0,186,0.8356810227634279,41033866,5799007966,208449,208449,365506,573955,351521381.566674,3294119.133333141,160839,0,185,0.3041754144488696,4769590954,-1011,-1011,62888473.11665887,3837.833333523944,-716,0,1,0.5315056083145584,-4728557088,1997.75284510713,1686.3663609164544,311.3864841906757,0.7719077507496216,0.7715988083416088,-716
1110,2020-01-16,2020,206204,206204,414610426.90000015,3303642.633333332,160581,0,177,0.8435966324610572,41791388,5807968595,207107,207107,371634,578741,351883043.6333437,3298957.8666664716,161279,0,177,0.3026362396996316,4783544747,-903,-903,62727383.26665646,4684.76666686032,-698,0,0,0.5409603927614256,-4741753359,2010.6808156000861,1699.0398375397438,311.6409780603424,0.7787482299082462,0.7787230755116921,-698
1111,2020-01-17,2020,200588,200588,414408275.0499995,3233945.833333333,155991,0,159,0.8399555307396256,42013713,5814547392,201680,201680,382185,583865,351884141.70001173,3229912.5833331924,156860,0,159,0.2910638589399961,4796712731,-1092,-1092,62524133.349987745,4033.2500001406297,-869,0,0,0.5488916717996295,-4754699018,2065.967431002849,1744.764685144842,321.2027458580071,0.7776686541567791,0.7777667592225307,-869
1112,2020-01-18,2020,196389,196389,413461870.6833338,3156183.8333333326,152041,0,145,0.8359022144824813,41406750,5809898541,197279,197279,394373,591652,351172774.7500131,3151424.999999804,152809,0,147,0.27951735141603906,4809244371,-890,-890,62289095.9333207,4758.833333528601,-768,0,-2,0.5563848630664422,-4767837621,2105.3209226755766,1780.0818878340478,325.2390348415288,0.7741828717494361,0.7745832044971842,-768
1113,2020-01-19,2020,213094,213094,412928565.5333329,3170849.616666668,149374,0,138,0.7675579791078108,41402714,5813698056,214093,214093,403101,617194,350848350.200006,3165122.59999976,150289,0,138,0.2673891839518869,4825832551,-999,-999,62080215.333326876,5727.016666908283,-915,0,0,0.5001687951559239,-4784429837,1937.776594053952,1638.766097910749,299.010496143203,0.7009770336095807,0.7019799806626092,-915
1114,2020-01-20,2020,213928,213928,413013908.5166667,3169855.366666666,150509,0,196,0.7697870311506687,41107904,5822296655,214917,214917,429295,644212,351120695.8500116,3164763.7666664766,151412,0,196,0.2577784952779492,4841374398,-989,-989,61893212.66665512,5091.600000189617,-903,0,0,0.5120085358727196,-4800266494,1930.621089883824,1633.7502191544252,296.8708707293988,0.7035497924535358,0.7045138355737331,-903
1115,2020-01-21,2020,211364,211364,412705459.18333405,3160376.850000003,149290,0,205,0.772359531424462,41913644,5825815584,212800,212800,452475,665275,351020916.91667116,3156557.74999984,150353,0,205,0.24780729773402407,4849068228,-1436,-1436,61684542.266662896,3819.1000001630746,-1063,0,0,0.5245522336904379,-4807154584,1952.5816088990275,1649.5343840069133,303.0472248921142,0.7063170644007494,0.706546052631579,-1063
1116,2020-01-22,2020,208142,208142,412310723.34999985,3128044.816666668,148204,0,41,0.7797224971413735,41008945,5825268311,209755,209755,477101,686856,350864890.4666704,3123563.566666527,149238,0,41,0.23859877470677676,4860935698,-1613,-1613,61445832.88332945,4481.25000014063,-1034,0,0,0.5411237224345968,-4819926753,1980.9107405040781,1672.7367188704459,308.17402163363226,0.7120331312277195,0.7114872112702916,-1034
1117,2020-01-23,2020,197171,197171,411509471.64999974,2999982.183333331,139883,0,100,0.7715029086427514,40245530,5824120253,198588,198588,505388,703976,350354528.23334086,2996124.3999998393,140816,0,100,0.2181750514222104,4875748189,-1417,-1417,61154943.41665888,3857.783333491534,-933,0,0,0.553327857220541,-4835502659,2087.0689485269118,1764.2280914926423,322.84085703426945,0.7094501726927388,0.7090861482063368,-933
1118,2020-01-24,2020,190671,190671,411032903.45000017,2919055.5000000023,133148,0,99,0.7540895049588033,39957837,5829658122,192155,192155,534966,727121,350101853.4500056,2914388.433333036,134153,0,99,0.1997810543224576,4891533330,-1484,-1484,60931049.999994576,4667.066666966304,-1005,0,0,0.5543084506363457,-4851575493,2155.717982545852,1821.976287111996,333.74169543385597,0.6983128005832036,0.6981499310452499,-1005
1119,2020-01-25,2020,186970,186970,410545150.43333364,2902463.0666666655,131246,0,162,0.7617371770872328,40438185,5834049781,188427,188427,563206,751633,349804219.1333319,2897106.3333332352,132338,0,162,0.1913593469153163,4906702607,-1457,-1457,60740931.30000174,5356.733333430253,-1092,0,0,0.5703778301719165,-4866264422,2195.7808762546592,1856.4442417134057,339.3366345412535,0.7019628817457346,0.7023303454388171,-1092
1120,2020-01-26,2020,185886,185886,410773256.38333327,2906298.933333333,130801,0,131,0.7655175752880792,40299110,5844155643,187186,187186,585098,772284,350198703.2499966,2901480.2833332545,131894,0,134,0.18635501965598367,4923681945,-1300,-1300,60574553.13333666,4818.650000078604,-1093,0,-3,0.5791625556320955,-4883382835,2209.8127690268943,1870.8594833480954,338.9532856787989,0.7036624597871813,0.704614661352879,-1093
1121,2020-01-27,2020,190857,190857,411179674.7000004,2934788.1333333324,134994,0,213,0.7651016205850456,40143407,5854368521,192356,192356,606676,799032,350800658.41667265,2930261.1999997073,136064,0,215,0.18469598213838587,4940409076,-1499,-1499,60379016.28332776,4526.933333625086,-1070,0,-2,0.5804056384466597,-4900265669,2154.3861356932175,1823.7053089930787,330.6808267001388,0.7073044216350461,0.7073551123957662,-1070
1122,2020-01-28,2020,193304,193304,411392265.0166672,2957893.566666663,136068,0,163,0.7577287588461685,40119437,5863244354,194802,194802,625536,820338,351248959.7999976,2953356.8833332723,137014,0,162,0.18028300529781496,4945960724,-1498,-1498,60143305.21666956,4536.683333390858,-946,0,1,0.5774457535483536,-4905841287,2128.2139273717416,1803.1075646040474,325.10636276769424,0.703906799652361,0.703350068274453,-946
1123,2020-01-29,2020,194621,194621,411689965.2499999,2977062.1499999976,138064,0,50,0.7609250800273344,39476710,5871907347,201913,201913,647440,849353,351814333.86666375,2978915.283333265,141573,0,50,0.17894091149380872,4956462050,-7292,-7292,59875631.38333613,-1853.133333267644,-3509,0,0,0.5819841685335256,-4916985340,2115.3419479398412,1742.4055601504795,372.9363877893618,0.7093992940124653,0.701158419715422,-3509
1124,2020-01-30,2020,198789,198789,411900154.8333336,3025487.683333336,140945,0,53,0.7664709817947675,41123130,5877624657,200038,200038,670558,870596,349813320.36667114,3021406.699999611,142015,0,53,0.17674443714420085,4901515136,-1249,-1249,62086834.46666247,4080.9833337250166,-1070,0,0,0.5897265446505666,-4860392006,2072.047018865901,1748.734342308317,323.3126765575839,0.7090181046234952,0.7099401113788381,-1070
1125,2020-01-31,2020,202022,202022,412551953.9833333,3046261.783333333,142457,0,39,0.7663719792893842,41223656,5889221655,203342,203342,689477,892819,350651164.5166638,3040847.8666665666,143630,0,39,0.17542973435825224,4912569550,-1320,-1320,61900789.4666695,5413.916666766629,-1173,0,0,0.5909422449311319,-4871345894,2042.113997402923,1724.440423113099,317.6735742898238,0.7051558741127204,0.7063469425893323,-1173
1126,2020-02-01,2020,199429,199429,412865187.98333377,3029519.8833333324,140272,0,38,0.765921706471977,41557234,5897711753,200755,200755,279942,480697,351087785.4166746,3024400.4999997886,141575,0,39,0.3222861802757225,4871720771,-1326,-1326,61777402.56665915,5119.383333543781,-1303,0,-1,0.4436355261962545,-4830163537,2070.236465024313,1748.8370671548635,321.39939786944956,0.7033681159710975,0.7052128215984658,-1303
1127,2020-02-02,2020,198761,198761,413042283.55000013,3025328.6833333327,139921,0,38,0.766795296864073,41935157,5906073612,199945,199945,305259,505204,351411852.78334284,3020024.1833331594,141075,0,38,0.3049837293449727,4886462056,-1184,-1184,61630430.76665729,5304.500000173226,-1154,0,0,0.4618115675191003,-4844526899,2078.0851552870035,1757.5425881284496,320.542567158554,0.703966069802426,0.705569031483658,-1154
1128,2020-02-03,2020,202193,202193,413517709.4333333,3052609.266666667,142583,0,37,0.7656496515705284,42140799,5919412600,203437,203437,328650,532087,352158348.7833427,3047975.366666535,143765,0,37,0.2945646106745704,4900903468,-1244,-1244,61359360.64999056,4633.900000132155,-1182,0,0,0.47108504089595804,-4858762669,2045.1633312396239,1731.0437569534683,314.1195742861555,0.7051826720015035,0.7066806923027767,-1182
1129,2020-02-04,2020,203690,203690,413971231.9333329,3040058.216666669,141588,0,41,0.753743433649172,41474410,5927884664,204983,204983,350530,555513,352825168.23334014,3035375.8499998692,142659,0,41,0.2795416128875527,4907551405,-1293,-1293,61146063.699992776,4682.366666799877,-1071,0,0,0.47420182076161926,-4866076995,2032.3591336508073,1721.2411186944291,311.11801495637815,0.6951151259266533,0.6959552743398233,-1071
1130,2020-02-05,2020,197606,197606,413992062.8833338,3006437.383333334,139984,0,38,0.7622086373895526,41112661,5934947722,198971,198971,379423,578394,353064297.7833394,3002329.5333331134,141195,0,38,0.26386857401702213,4919921023,-1365,-1365,60927765.09999442,4107.850000220351,-1211,0,0,0.49834006337253045,-4878808362,2095.0379182987044,1774.4510395150016,320.5868787837028,0.7083995425240124,0.7096260259032723,-1211
1131,2020-02-06,2020,198283,198283,414309277.71666694,3010517.866666665,140143,0,60,0.7636509433486477,41211943,5942211052,199498,199498,403424,602922,353648660.6666692,3005442.8333331756,141217,0,60,0.25396817498781527,4934869107,-1215,-1215,60660617.04999775,5075.033333489206,-1074,0,0,0.5096827683608325,-4893657164,2089.484613994477,1772.6927621663835,316.7918518280935,0.7067827297347731,0.7078617329497038,-1074
1132,2020-02-07,2020,201894,201894,414780128.08333325,3024460.2333333306,140516,0,43,0.7549803362160336,41621406,5952231025,203019,203019,426646,629665,354318889.86667407,3018749.1499998467,141626,0,43,0.24487147927866032,4950775815,-1125,-1125,60461238.21665919,5711.083333483897,-1110,0,0,0.5101088569373733,-4909154409,2054.4450458326314,1745.2499020617483,309.1951437708831,0.6959889843185038,0.697599732044784,-1110
1133,2020-02-08,2020,195645,195645,414622373.18333346,2932947.6499999925,135233,0,67,0.746331365483402,40626858,5944768467,196721,196721,455861,652582,354432932.26666737,2928583.933333168,136195,0,67,0.2261631488456698,4962244572,-1076,-1076,60189440.91666609,4363.71666682465,-962,0,0,0.5201682166377322,-4921617714,2119.25872464583,1801.7035917195794,317.55513292625074,0.6912162334841166,0.6923256795156593,-962
1134,2020-02-09,2020,194545,194545,414729687.7666663,2958015.0166666643,134960,0,37,0.7497802564959263,40111898,5950181359,230091,230091,483079,713170,354875690.0333346,2981217.883333266,150567,0,37,0.22713798953965836,4972758884,-35546,-35546,59853997.73333168,-23202.866666601505,-15607,0,0,0.5226422669562679,-4932646986,2131.793095513461,1542.3275575026169,589.4655380108443,0.6937212470122593,0.6543802234767984,-15607
1135,2020-02-10,2020,199458,199458,415406514.01666653,3026135.3500000024,141059,0,55,0.7660108895105733,41751839,5965514310,217664,217664,507759,725423,348693570.2166601,3030695.899999637,150572,0,55,0.22453520221994636,4806945423,-18206,-18206,66712943.80000645,-4560.549999634735,-9513,0,0,0.5414756872906269,-4765193584,2082.676623733651,1601.980898157987,480.695725575664,0.7072115432822951,0.6917634519259042,-9513
1136,2020-02-11,2020,199982,199982,416138577.0666668,3028258.2499999986,140667,0,81,0.7611985078657084,41267247,5979616361,211387,211387,526151,737538,348232168.83332586,3071620.8333329326,144697,0,82,0.21274700422215662,4781563858,-11405,-11405,67906408.23334092,-43362.58333293395,-4030,0,-1,0.5484515036435518,-4740296611,2080.880164548143,1647.367949936968,433.51221461117507,0.7033983058475263,0.6845122926196975,-4030
1137,2020-02-12,2020,202654,202654,416853248.916667,3043946.049999999,142453,0,53,0.7611396764929377,41370367,5992523452,209495,209495,550835,760330,348692582.5000021,3047761.2333332403,144540,0,53,0.20633277655754592,4793120020,-6841,-6841,68160666.4166649,-3815.1833332413808,-2087,0,0,0.5548068999353918,-4751749653,2056.97024937414,1664.4434592711143,392.52679010302586,0.7029370256693674,0.6899448674192702,-2087
1138,2020-02-13,2020,205639,205639,417450779.81666726,3074936.083333334,144015,0,84,0.7581003603402077,42146497,6004049148,206765,206765,573556,780321,349014394.2166632,3070713.433333224,144962,0,83,0.20163240512558114,4801943475,-1126,-1126,68436385.60000408,4222.650000109803,-947,0,1,0.5564679552146266,-4759796978,2030.0175541442395,1687.976176899684,342.0413772445554,0.7003292177067579,0.7010954465214132,-947
1139,2020-02-14,2020,205692,205692,418122227.05000037,3084761.5833333367,145493,0,80,0.7674630029364283,42291888,6017748415,206893,206893,593099,799992,349941457.24999726,3080531.5833332343,146473,0,80,0.19914199141991284,4816461547,-1201,-1201,68180769.80000311,4230.0000001024455,-980,0,0,0.5683210115165155,-4774169659,2032.758819254032,1691.412745960459,341.346073293573,0.7073342667677888,0.7079649867322723,-980
1140,2020-02-15,2020,199251,199251,418140847.5166666,2998996.8333333363,140911,0,126,0.7727941139567678,41115528,6023000425,200195,200195,619613,819808,350295380.54999673,2994735.499999956,141796,0,127,0.18947485264842004,4832378194,-944,-944,67845466.96666986,4261.333333380055,-885,0,-1,0.5833192613083478,-4791262666,2098.5633573566333,1749.7708761457416,348.79248121089176,0.7072034770214453,0.7082894178176278,-885
1141,2020-02-16,2020,193153,193153,418206607.63333327,2958021.5166666694,136123,0,38,0.7655589092584627,40308154,6029052157,193953,193953,648168,842121,350629922.5666713,2953718.7166662985,136849,0,38,0.17700900464422284,4852775084,-800,-800,67576685.06666195,4302.800000370946,-726,0,0,0.5885499046142398,-4812466930,2165.157194728186,1807.8087091546474,357.3484855735385,0.70474183678224,0.7055781555325259,-726
1142,2020-02-17,2020,201125,201125,418798305.8666666,3032031.816666669,142935,0,43,0.7694319453076438,41079132,6040854197,201944,201944,670503,872447,351451095.0666707,3027696.96666635,143640,0,43,0.17877418341745688,4871718090,-819,-819,67347210.7999959,4334.850000319071,-705,0,0,0.5906577618901869,-4830638958,2082.278711580692,1740.3393765928708,341.939334987821,0.7106774394033561,0.7112862971913005,-705
1143,2020-02-18,2020,212175,212175,419340748.83333343,3111365.716666664,149048,0,75,0.7623989631200657,41429939,6047086631,213326,213326,687600,900926,352266343.0666597,3107219.4666665853,149964,0,75,0.18130567882378965,4879596740,-1151,-1151,67074405.76667374,4146.250000078697,-916,0,0,0.581093284296276,-4838166801,1976.390945367425,1651.305246742824,325.08569862460104,0.7024767291151173,0.702980414951764,-916
1144,2020-02-19,2020,216230,216230,419781403.26666594,3167568.5666666664,152912,0,111,0.7699070434259826,42371019,6054438652,217369,217369,708214,925583,353046309.4666612,3162619.933333286,153882,0,111,0.18158609222511707,4893947574,-1139,-1139,66735093.80000472,4948.633333380334,-970,0,0,0.5883209512008656,-4851576555,1941.3652280750402,1624.179664380207,317.18556369483326,0.7071729177264949,0.7079298336009274,-970
1145,2020-02-20,2020,214823,214823,420058816.63333374,3173893.3499999987,151399,0,132,0.7680090120704024,42548264,6060084456,215974,215974,731069,947043,353632421.84999657,3169521.299999955,152336,0,132,0.17576921005698848,4906584508,-1151,-1151,66426394.783337176,4372.050000043586,-937,0,0,0.5922398020134139,-4864036244,1955.3717089572986,1637.3842307407215,317.9874782165771,0.704761594428902,0.7053441617972533,-937
1146,2020-02-21,2020,221871,221871,420846050.49999994,3221342.7333333325,155234,0,179,0.7716105304433653,43471033,6074594081,223052,223052,753418,976470,354663686.0833275,3216679.8833332583,156323,0,181,0.1770438415926735,4922177307,-1181,-1181,66182364.41667247,4662.850000074133,-1089,0,-2,0.5945666888506917,-4878706274,1896.8051277544155,1590.0493431277346,306.7557846266809,0.699658810750391,0.7008365762243782,-1089
1147,2020-02-22,2020,216090,216090,421126669.56666696,3171622.316666669,151243,0,167,0.7697348327085933,43945744,6086761863,217128,217128,780176,997304,355121146.7833309,3167015.9833332086,152333,0,167,0.16851531729542954,4939218120,-1038,-1038,66005522.78333604,4606.333333460614,-1090,0,0,0.6012195154131638,-4895272376,1948.8484870501502,1635.5382391185426,313.3102479316076,0.6999074459715859,0.7015815555801186,-1090
1148,2020-02-23,2020,218389,218389,421802899.9499999,3207678.0166666717,153346,0,163,0.7751764054050343,44448586,6101380247,219445,219445,806608,1026053,355959401.1333295,3202746.966666557,154425,0,163,0.16672822943844157,4958943987,-1056,-1056,65843498.81667042,4931.050000114832,-1079,0,0,0.6084481759665927,-4914495401,1931.4292384231803,1622.0893669636105,309.33987145956985,0.70216906529175,0.7037070792225842,-1079
1149,2020-02-24,2020,226575,226575,422849420.18333304,3294092.4000000013,160717,0,103,0.7761712457243738,43934646,6117403727,227826,227826,825775,1053601,357233143.91666335,3289192.1999999015,161832,0,103,0.1686739097628028,4978839824,-1251,-1251,65616276.26666969,4900.200000099838,-1115,0,0,0.607497335961571,-4934905178,1866.266888153296,1568.0086729199625,298.25821523333343,0.7093324506234139,0.7103315688288431,-1115
1150,2020-02-25,2020,226624,226624,423613362.7333332,3312090.933333333,161068,0,64,0.7766873764473311,43645414,6131532799,235462,235462,845013,1080475,358215529.70000374,3333849.9833332542,165234,0,63,0.167618871329739,4991270314,-8838,-8838,65397833.03332943,-21759.049999921117,-4166,0,1,0.6090685051175921,-4947624900,1869.2343385225447,1521.330531890512,347.9038066320327,0.7107279017226772,0.7017438057945655,-4166
1151,2020-02-26,2020,204530,204530,423613377.8000001,3233591.3166666687,157185,0,227,0.8301520559331146,42123153,6136376145,205840,205840,878048,1083888,358125518.3333312,3229259.266666528,158231,0,227,0.1580993608195698,5001569469,-1310,-1310,65487859.466668844,4332.050000140909,-1046,0,0,0.6720526951135448,-4959446316,2071.1552231946416,1739.8247101308357,331.33051306380594,0.7685180658094167,0.7687087057909056,-1046
1152,2020-02-27,2020,205281,205281,423449466.2999997,3240539.9666666696,158077,0,345,0.8366775298249717,43093599,6141501012,206287,206285,881705,1087992,358090109.9999992,3236317.383333234,158941,0,349,0.15910594930845046,5012368541,-1006,-1004,65359356.30000049,4222.583333435468,-864,0,-4,0.6775715805165212,-4969274942,2062.7796352317055,1735.8998957752585,326.87973945644694,0.7700517826783775,0.7704848099977216,-864
1153,2020-02-28,2020,208899,208899,424102726.2500004,3307668.199999996,163376,0,43,0.8511577365138181,43298259,6151557405,209981,209981,887074,1097055,358913060.24999785,3302743.3833332323,164339,0,43,0.16352963160461437,5025550312,-1082,-1082,65189666.00000256,4924.8166667637415,-963,0,0,0.6876281049092037,-4982252053,2030.180739256772,1709.2644584509924,320.9162808057797,0.7820812928735896,0.7826374767240846,-963
1154,2020-02-29,2020,205971,205971,423702962.7500002,3291654.8666666667,160971,0,49,0.8566982730578565,43252199,6152770819,207126,207126,894913,1102039,358888256.3333301,3286821.1166665503,161987,0,49,0.16152695140552864,5038798038,-1155,-1155,64814706.416670084,4833.750000116415,-1016,0,0,0.6951713216523279,-4995545839,2057.100090546728,1732.7050024300672,324.3950881166609,0.7815226415369154,0.782069851201684,-1016
1155,2020-03-01,2020,205649,205649,424138945.03333294,3277032.616666666,160357,0,199,0.8543148763183878,42672311,6162702448,206828,206827,245216,452044,359620641.1166776,3272170.249999837,161496,0,199,0.3928843209953014,5015640726,-1179,-1178,64518303.91665536,4862.3666668292135,-1139,0,0,0.46143055532308636,-4972968415,2062.441076948261,1738.7509421723353,323.6901347759258,0.7797606601539516,0.7808227125921056,-1139
1156,2020-03-02,2020,207812,207812,424787308.11666715,3296776.1666666684,161550,0,283,0.8482570785132716,42953786,6175595936,209179,209179,257809,466988,360428094.4833455,3291821.133333197,162736,0,283,0.3816222258387752,5029360183,-1367,-1367,64359213.63332164,4955.033333471511,-1186,0,0,0.4666348526744964,-4986406397,2044.0942203369736,1723.0606059085544,321.03361442841924,0.7773853290474082,0.7779748445111603,-1186
1157,2020-03-03,2020,208502,208502,425016609.4666666,3299660.9833333353,162338,0,248,0.8484427007894398,43107949,6177879899,209699,209699,265349,475048,360979423.23334014,3294680.6166665293,163365,0,248,0.3758883312844151,5044498273,-1197,-1197,64037186.233326435,4980.36666680593,-1027,0,0,0.4725543695050247,-5001390324,2038.429412987245,1721.416998809437,317.01241417780807,0.7785920518748022,0.7790452028860414,-1027
1158,2020-03-04,2020,204781,204781,425013897.4833336,3286717.3833333333,159841,0,271,0.8483794883314376,43062110,6181362217,206075,206075,277787,483862,361359699.61667395,3281913.3999998644,160947,0,271,0.36277492342857803,5057951693,-1294,-1294,63654197.86665964,4803.983333468903,-1106,0,0,0.4856045649028596,-5014889583,2075.455718466721,1753.5348762182407,321.9208422484803,0.7805460467523843,0.7810117675603543,-1106
1159,2020-03-05,2020,213042,213042,425485151.56666666,3308019.116666667,164616,0,191,0.8370133588682035,43069705,6191622356,214462,214462,287505,501967,362059050.1000113,3303150.849999889,165821,0,191,0.3591869585052499,5076316111,-1420,-1420,63426101.46665537,4868.266666778363,-1205,0,0,0.4778264003629536,-5033246406,1997.1890592778263,1688.2200580989233,308.969001178903,0.772692708480018,0.7731952513732037,-1205
1160,2020-03-06,2020,219629,219629,425502884.04999983,3384937.0333333435,169311,0,172,0.8398162355608791,43917689,6194708903,220989,220989,296876,517865,362367214.5166856,3379930.8999998495,170445,0,172,0.3597443349135445,5088927120,-1360,-1360,63135669.53331423,5006.133333493955,-1134,0,0,0.4800719006473346,-5045009431,1937.371130633932,1639.7522705505053,297.6188600834266,0.7708954646244348,0.7712827335297232,-1134
1161,2020-03-07,2020,214999,214999,425595266.4000003,3386994.816666663,165378,0,93,0.8396829752696533,43696572,6201774322,216901,216901,306776,523677,362696771.1166756,3382478.333333197,166705,0,96,0.34883716489362865,5104920225,-1902,-1902,62898495.28332466,4516.483333466109,-1327,0,-3,0.49084581037602465,-5061223653,1979.5220740561597,1672.1765741821182,307.3454998740415,0.7692035776910591,0.7685764473192839,-1327
1162,2020-03-08,2020,211294,211294,425723086.80000055,3359789.266666669,164188,0,47,0.8472128882031674,43755203,6207766731,212610,212610,321195,533805,363082986.9833416,3354976.9499998596,165345,0,47,0.3389739698953735,5123825366,-1316,-1316,62640099.81665897,4812.316666809376,-1157,0,0,0.508238918307794,-5080070163,2014.837557147863,1707.741813571053,307.09574357681004,0.7770594527057086,0.777691547904614,-1157
1163,2020-03-09,2020,214515,214515,426801429.5833333,3385891.5333333313,167850,0,77,0.8505465818241148,43520237,6227696678,215872,215872,329242,545114,364278382.88334596,3381135.3666665107,169065,0,77,0.338496167774074,5139163871,-1357,-1357,62523046.69998735,4756.166666820645,-1215,0,0,0.5120504140500408,-5095643634,1989.6111208229415,1687.473979410697,302.13714141224455,0.7824627648416195,0.7831724355173436,-1215
1164,2020-03-10,2020,213269,213269,427040228.9499998,3380365.816666668,167418,0,238,0.8542357304624678,43218012,6233699821,229509,229509,338153,567662,364746552.4500048,3400914.7166665234,174638,0,239,0.33518361278366726,5149401728,-16240,-16240,62293676.49999499,-20548.899999855552,-7220,0,-1,0.5190521176788006,-5106183716,2002.354908355175,1589.2472733095644,413.10763504561055,0.7850086041571912,0.7609200510655355,-7220
1165,2020-03-11,2020,220883,220883,427680768.6333327,3432303.4333333364,172078,0,238,0.8474758129869654,43926417,6244568855,226080,226080,347902,573982,360549862.8333477,3428534.3499998776,174868,0,238,0.33209926443686166,5040582239,-5197,-5197,67130905.79998505,3769.0833334587514,-2790,0,0,0.5153765485501037,-4996655822,1936.2321619741344,1594.788848342833,341.4433136313014,0.7790459202383162,0.773478414720453,-2790
1166,2020-03-12,2020,221885,221885,428076403.4833333,3466092.116666664,172008,0,164,0.8452802127228063,44161124,6253490260,223414,223414,355335,578749,360787828.0000134,3463409.9999997793,173264,0,164,0.32748393517742413,5036578746,-1529,-1529,67288575.48331988,2682.116666884627,-1256,0,0,0.5177962775453822,-4992417622,1929.2714851537205,1614.8845998908457,314.3868852628748,0.7752123847939247,0.7755288388373155,-1256
1167,2020-03-13,2020,221509,221509,428241465.8833336,3433739.81666667,171177,0,150,0.8418077820765739,43286834,6257932415,222817,222817,364937,587754,361252941.4500138,3429750.1166664935,172243,0,152,0.32054396907549765,5055727235,-1308,-1308,66988524.43331981,3989.700000176672,-1066,0,-2,0.5212638130010763,-5012440401,1933.2914955299045,1621.2988302060157,311.9926653238888,0.7727767269050017,0.7730244999259482,-1066
1168,2020-03-14,2020,214980,214980,428178201.1333328,3400874.3166666673,168642,0,236,0.8574658107730959,42925434,6261355540,216521,216521,380480,597001,361506488.76667935,3397652.0666665225,169997,0,236,0.31225575836556396,5074788136,-1541,-1541,66671712.36665344,3222.2500001448207,-1355,0,0,0.545210052407532,-5031862702,1991.7117924147958,1669.6139809380122,322.0978114767836,0.7844543678481719,0.7851293869878673,-1355
1169,2020-03-15,2020,215667,215667,428427698.99999994,3404546.133333328,166867,0,64,0.8468425860238239,43084204,6270764011,217201,217201,389388,606589,361771138.01667476,3400315.566666479,168275,0,64,0.30512587600500335,5086207859,-1534,-1534,66656560.98332518,4230.5666668489575,-1408,0,0,0.5417167100188205,-5043123655,1986.5241274743005,1665.6053057613674,320.9188217129331,0.7737252338095304,0.7747432102062145,-1408
1170,2020-03-16,2020,225420,225420,429105751.9,3478068.483333333,171716,0,94,0.8307204329695681,43322469,6282433439,226947,226947,397520,624467,362629444.30001247,3472658.5166664473,173036,0,94,0.3033995391269696,5106626777,-1527,-1527,66476307.59998751,5409.966666885652,-1320,0,0,0.5273208938425985,-5063304308,1903.583319581226,1597.8596073092506,305.7237122719755,0.7617602697187472,0.7624511449809868,-1320
1171,2020-03-17,2020,229346,229346,429520458.016667,3551813.3999999985,174766,0,202,0.8392559713271647,44038072,6286485648,231718,231718,402469,634187,363312514.61667156,3547580.2666661856,176264,0,202,0.30733048769526744,5117514960,-2372,-2372,66207943.399995446,4233.133333812933,-1498,0,0,0.5319254836318972,-5073476888,1872.8055340693406,1567.9080374276991,304.8974966416415,0.7620189582552126,0.760683244288316,-1498
1172,2020-03-18,2020,227723,227723,430228924.58333325,3527533.0499999993,172033,0,186,0.8277863896049151,43994151,6299383829,229216,229216,413667,642883,364179620.6500095,3522385.0333331465,173364,0,186,0.29695294478154893,5132249220,-1493,-1493,66049303.93332374,5148.016666852869,-1331,0,0,0.5308334448233663,-5088255069,1889.264257819075,1588.8054090901574,300.4588487289177,0.7554485054210598,0.756334636325562,-1331
1173,2020-03-19,2020,221284,221284,430033297.7333333,3456913.449999998,170064,0,191,0.8401104463042967,42908648,6300101893,222591,222591,428632,651223,364256380.01668096,3451674.0833331794,171167,0,191,0.28808411250830745,5144244851,-1307,-1307,65776917.716652334,5239.366666818503,-1103,0,0,0.5520263337959892,-5101336203,1943.3546832727775,1636.4380411457828,306.9166421269947,0.7685327452504473,0.768975385348015,-1103
1174,2020-03-20,2020,225462,225462,430326560.06666744,3496923.2166666645,171902,0,207,0.8347082878711264,43165633,6306854327,226945,226945,438040,664985,364753951.9500096,3491819.399999855,173116,0,207,0.2861147243922825,5158770202,-1483,-1483,65572608.11665785,5103.816666809376,-1214,0,0,0.5485935634788439,-5115604569,1908.6434080539843,1607.2350214810178,301.4083865729665,0.7624433385670313,0.7628103725572275,-1214
1175,2020-03-21,2020,222560,222560,430389778.13333267,3478404.499999998,169580,0,143,0.8320767433501087,42582943,6308951987,223797,223797,446548,670345,365123984.60000527,3473299.183333167,170690,0,146,0.2788250826067166,5170822120,-1237,-1237,65265793.5333274,5105.316666831262,-1110,0,-3,0.5532516607433922,-5128239177,1933.8146034028248,1631.4963319437047,302.31827145912007,0.7619518332135155,0.7627001255602175,-1110
1176,2020-03-22,2020,221351,221351,430476743.78333324,3458259.4833333385,167023,0,239,0.8276673699237856,43292360,6313646632,229191,229191,456966,686157,365418856.05000776,3461507.099999861,170232,0,239,0.2732013227293394,5191935768,-7840,-7840,65057887.73332548,-3247.6166665223427,-3209,0,0,0.5544660471944463,-5148643408,1944.7698170929123,1594.385713444279,350.3841036486333,0.75456175937764,0.7427516787308402,-3209
1177,2020-03-23,2020,226199,226199,431041535.4,3486567.8666666653,169193,0,242,0.8187038846325579,43563061,6327405167,230632,230632,468551,699183,364130834.61668164,3483378.0999998357,171327,0,244,0.268909570169764,5159027267,-4433,-4433,66910700.78331834,3189.766666829586,-2134,0,-2,0.5497943144627939,-5115464206,1905.5855039146945,1578.8391663632178,326.7463375514767,0.7479829707469972,0.742858753338652,-2134
1178,2020-03-24,2020,228913,228913,431543508.51666725,3513545.8999999994,170064,0,207,0.8155500124501444,43525040,6336524706,230258,230258,478741,708999,364272420.5500118,3508014.8166664606,171276,0,207,0.2662274558920394,5150437954,-1345,-1345,67271087.96665543,5531.083333538845,-1212,0,0,0.549322556558105,-5106912914,1885.1856754167184,1582.0185207463446,303.16715467037375,0.742919799225033,0.7438438621025111,-1212
1179,2020-03-25,2020,226038,226038,431637878.71666676,3501574.3499999945,171003,0,216,0.8276572965607565,43288015,6341931410,227236,227236,487660,714896,364634556.4333408,3496409.249999579,172119,0,216,0.26406078646405634,5166043780,-1198,-1198,67003322.28332597,5165.100000415463,-1116,0,0,0.5635965100967002,-5122755765,1909.5810382177633,1604.65135996647,304.92967825129335,0.7565232394553129,0.7574460032741291,-1116
1180,2020-03-26,2020,221587,221587,431985309.59999967,3456197.2333333245,168884,0,138,0.8329414631724792,43786851,6351107777,222603,222603,499792,722395,365224771.93333,3450458.766666628,169794,0,137,0.2572581482429986,5180819665,-1016,-1016,66760537.66666967,5738.466666696593,-910,0,1,0.5756833149294807,-5137032814,1949.5065576951702,1640.7001340203412,308.8064236748289,0.7621566247117385,0.7627660004582149,-910
1181,2020-03-27,2020,218560,218560,432039717.71666616,3414813.1500000022,166768,0,174,0.8359672401171301,43680280,6357356859,219935,219935,512918,732853,365492547.6500131,3409069.8999995594,168059,0,174,0.2518636070262386,5195406523,-1375,-1375,66547170.06665307,5743.250000442844,-1291,0,0,0.5841036330908915,-5151726243,1976.7556630520962,1661.820754541174,314.93490851092224,0.7630307467057101,0.7641303112283174,-1291
1182,2020-03-28,2020,215719,215719,431876085.70000017,3408104.699999999,164813,0,150,0.8378214250946836,43361241,6360676977,216942,216942,525583,742525,365653136.1666771,3403411.1999996547,166007,0,151,0.24583010673040742,5211484024,-1223,-1223,66222949.53332305,4693.500000344124,-1194,0,-1,0.5919913183642762,-5168122783,2002.030816478846,1685.4879929505448,316.54282352830114,0.7640170777724725,0.7652137437656148,-1194
1183,2020-03-29,2020,219109,219109,432064219.4333328,3425101.8833333347,167246,0,148,0.8389659940942641,43261423,6367200602,220522,220522,533560,754082,366062052.1499962,3419772.7666666256,168561,0,151,0.24624642943340422,5224832039,-1413,-1413,66002167.28333658,5329.116666709073,-1315,0,-3,0.5927195646608598,-5181570616,1971.9145239736058,1659.9797396631457,311.93478431046015,0.7633004577630312,0.7643727156474184,-1315
1184,2020-03-30,2020,225336,225336,432878537.75,3503881.7333333357,170428,0,133,0.8309724145276385,43723718,6378793340,226860,226860,539490,766350,367039240.149995,3499823.099999919,171809,0,133,0.24688458276244532,5243207116,-1524,-1524,65839297.60000497,4058.6333334166557,-1381,0,0,0.5840878317651932,-5199483398,1921.035865329996,1617.9107826412546,303.1250826887415,0.7563283274754145,0.7573349202151106,-1381
1185,2020-03-31,2020,229010,229010,433457587.48333335,3488810.6499999957,170981,0,221,0.8220427055587094,43566516,6387796216,230328,230328,546091,776419,367861545.3166616,3484543.7833333053,172179,0,221,0.2446913329014352,5253090356,-1318,-1318,65596042.16667175,4266.866666690446,-1198,0,0,0.5773513726572742,-5209523840,1892.745240309739,1597.1203905589489,295.6248497507902,0.7466093183703768,0.7475382932166302,-1198
1186,2020-04-01,2020,219005,219005,433423479.1166664,3434562.583333334,167997,0,248,0.8432775507408506,43292066,6392710558,220566,220566,279030,499596,368116615.5166832,3429992.2666664557,169473,0,248,0.3737059544111658,5200883192,-1561,-1561,65306863.599983156,4570.316666878294,-1476,0,0,0.46957159632968487,-5157591126,1979.0574604080564,1668.963555201995,310.09390520606144,0.7670920755233899,0.768355050189059,-1476
1187,2020-04-02,2020,219417,219417,433876516.2500005,3463224.3333333386,167171,0,260,0.8365851324190928,43524212,6400436355,221134,221134,287684,508818,368765483.8833487,3459057.683333155,168697,0,260,0.3650892853633327,5215459580,-1717,-1717,65111032.36665177,4166.650000183843,-1526,0,0,0.47149584705576014,-5171935368,1977.4061091437786,1667.6109683872617,309.79514075651696,0.7618871828527416,0.7628722855824975,-1526
1188,2020-04-03,2020,218380,218380,434436607.0333335,3418525.450000004,166787,0,57,0.8341285832035898,43832256,6412894592,219960,219960,297071,517031,369460721.466681,3412783.833333164,168235,0,57,0.3561604623320418,5232090735,-1580,-1580,64975885.56665248,5741.616666839924,-1448,0,0,0.47796812087154805,-5188258479,1989.3607795280404,1679.672310723227,309.6884688048135,0.7637466800989101,0.7648436079287143,-1448
1189,2020-04-04,2020,207439,207439,434357051.35000014,3345209.0999999954,161456,0,59,0.8470441913044312,42752179,6416715103,208699,208699,313607,522306,369629265.7666805,3340466.883333177,162697,0,59,0.3395231913858967,5245542363,-1260,-1260,64727785.583319664,4742.216666818596,-1241,0,0,0.5075209999185345,-5202790184,2093.9025513524466,1771.111820213228,322.7907311392187,0.7783300150887731,0.7795772859477046,-1241
1190,2020-04-05,2020,213607,213607,434702336.2833328,3431138.2666666624,164361,0,59,0.8404125332971296,44024288,6424881708,214836,214836,321431,536267,370143473.68334115,3425022.849999818,165545,0,59,0.33767134654938674,5266434737,-1229,-1229,64558862.59999168,6115.416666844394,-1184,0,0,0.5027411867477429,-5222410449,2035.0566052766662,1722.9117730889661,312.1448321877001,0.769455120852781,0.7705645236366344,-1184
1191,2020-04-06,2020,223763,223763,435845530.4333328,3516291.7166666663,170299,0,62,0.8297037490559207,44100897,6440910080,230188,230188,324632,554820,371458420.78334737,3523005.433333156,173125,0,62,0.34072672218016714,5283490697,-6425,-6425,64387109.64998543,-6713.71666648984,-2826,0,0,0.48897702687575356,-5239389800,1947.799816919387,1613.7175733893487,334.08224353003834,0.7610686306493925,0.7521026291552991,-2826
1192,2020-04-07,2020,228798,228798,436219164.6666663,3526978.283333332,169563,0,49,0.7983985874002403,43931081,6450848612,229777,229777,336929,566706,371558512.9666778,3521845.0666665277,170654,0,49,0.3250362621888632,5283372871,-979,-979,64660651.699988544,5133.216666804161,-1091,0,0,0.47336232521137706,-5239441790,1906.5689589361198,1617.0396208788425,289.5293380572773,0.7411035061495292,0.7426940033162588,-1091
1193,2020-04-08,2020,224758,224758,436220421.70000005,3532157.3166666725,168064,0,73,0.803326244227125,44147730,6462157499,225878,225878,343494,569372,371697601.9333433,3527524.199999819,169261,0,73,0.320214200909068,5303344488,-1120,-1120,64522819.76665676,4633.116666853428,-1197,0,0,0.48311204331805696,-5259196758,1940.844916309987,1645.5679700251608,295.2769462848262,0.7477553635465701,0.749346992624337,-1197
1194,2020-04-09,2020,221781,221781,436504759.3833337,3484012.516666663,166298,0,77,0.8048931152803899,43245681,6469942722,222841,222841,356950,579791,372207035.31668127,3479343.033333103,167469,0,77,0.3105343132266585,5315614671,-1060,-1060,64297724.06665242,4669.483333559707,-1171,0,0,0.4943588020537314,-5272368990,1968.1792371002641,1670.2807621428788,297.89847495738536,0.7498297870421722,0.7515178984118721,-1171
1195,2020-04-10,2020,222712,222712,437164180.8166668,3475678.433333333,166942,0,74,0.8098306332842414,44360298,6484883485,223750,223750,369668,593418,372965606.6666759,3471724.3666664776,168037,0,75,0.30647705327441355,5335822614,-1038,-1038,64198574.14999086,3954.066666855477,-1095,0,-1,0.5033535800098279,-5291462316,1962.9125544050917,1666.8853929236914,296.0271614814003,0.7495869104493695,0.7510033519553072,-1095
1196,2020-04-11,2020,223734,223734,437500302.7499991,3480141.7,168003,0,96,0.8116245184013157,44208137,6494086813,224870,224870,380524,605394,373437884.80001223,3476042.633333113,169175,0,95,0.302531904842142,5352143314,-1136,-1136,64062417.949986875,4099.066666887142,-1172,0,1,0.5090926135591737,-5307935177,1955.448446592825,1660.6834384311478,294.7650081616771,0.7509050926546703,0.7523235647262863,-1172
1197,2020-04-12,2020,217484,217484,437860715.35,3419996.5499999984,161789,0,149,0.803774070736238,44412342,6508158628,218395,218395,396771,615166,373903763.36667675,3415450.983333172,162855,0,149,0.28649015062600847,5371103419,-911,-911,63956951.983323276,4545.566666826606,-1066,0,0,0.5172839201102295,-5326691077,2013.3008191407184,1712.052763875898,301.2480552648203,0.7439121958396939,0.7456901485839877,-1066
1198,2020-04-13,2020,230219,230219,438880371.19999963,3552620.366666669,170813,0,227,0.8060889848361771,44858922,6524838618,231146,231146,405388,636534,375075070.1333438,3548181.766666511,171856,0,227,0.2939827251961533,5393673400,-927,-927,63805301.066655815,4438.600000157952,-1043,0,0,0.5121062596400238,-5348814478,1906.3603403715576,1622.6760148708775,283.6843255006802,0.7419587436310643,0.7434954530902547,-1043
1199,2020-04-14,2020,234460,234460,439660326.3666663,3634744.7999999984,174065,0,148,0.8011771730785625,45078918,6535789776,238213,238212,409636,647849,376024117.2166778,3631532.849999795,175621,0,148,0.29318714700492615,5405345881,-3753,-3752,63636209.14998853,3211.9500002032146,-1556,0,0,0.5079900260736363,-5360266963,1875.2039851858156,1578.5271825797097,296.67680260610587,0.7424080866672353,0.7372435593355526,-1556
1200,2020-04-15,2020,238544,238544,440645114.88333356,3661743.2166666696,175251,0,96,0.7950273324837347,45301960,6549600178,239447,239447,417448,656895,377095137.6000018,3657311.549999529,176191,0,96,0.29073748468173133,5417169210,-903,-903,63549977.28333175,4431.666667140555,-940,0,0,0.5042898478020034,-5371867250,1847.2278275007277,1574.85847640606,272.36935109466776,0.7346694949359447,0.7358246292498967,-940
1201,2020-04-16,2020,236171,236171,440713324.48333305,3608583.3500000015,173198,0,190,0.7942253706001161,44263955,6556390223,239181,239181,429110,668291,377443089.0500176,3607862.4833331117,174857,0,190,0.2838075030188939,5430935177,-3010,-3010,63270235.433315456,720.8666668897495,-1659,0,0,0.5104178675812222,-5386671222,1866.07722575309,1578.064683440648,288.01254231244206,0.733358456372713,0.7310655946751623,-1659
1202,2020-04-17,2020,232406,232406,441289611.4500001,3558940.5666666655,173426,0,199,0.8027976902489619,44269306,6568529385,240966,240966,446258,687224,378227570.7166855,3563722.7833331516,177068,0,199,0.27726912913401985,5448448212,-8560,-8560,63062040.73331463,-4782.216666486114,-3642,0,0,0.5255285611149421,-5404178906,1898.787516027986,1569.6304487632508,329.15706726473513,0.7462199771090248,0.7348256600516255,-3642
1203,2020-04-18,2020,226049,226049,441267138.96666616,3555227.91666667,169587,0,225,0.8113152458095373,45047939,6570121408,226990,226990,464236,691226,377022503.4666773,3552316.7333331886,170536,0,227,0.26710656138513866,5414955677,-941,-941,64244635.499988854,2911.1833334811963,-949,0,-2,0.5442086844243986,-5369907738,1952.0862245206401,1660.9652560318839,291.12096848875626,0.7502222969356201,0.7512930085025772,-949
1204,2020-04-19,2020,224848,224848,441749767.56666684,3530269.6500000004,168850,0,205,0.8134295168291472,44869385,6582458170,225756,225756,467179,692935,377674628.11667544,3527239.366666463,169860,0,205,0.26574931270609203,5434935693,-908,-908,64075139.449991405,3030.283333537169,-1010,0,0,0.5476802041230552,-5390066308,1964.6595369612664,1672.9328483702557,291.72668859101077,0.7509517540738633,0.7524052516876628,-1010
1205,2020-04-20,2020,224347,224347,442239459.233333,3499759.566666665,168230,0,183,0.8085510392383234,44388648,6594273776,225308,225308,480305,705613,378329976.0000142,3494258.0166664748,169242,0,183,0.25895639677840776,5453347789,-961,-961,63909483.233318806,5501.550000190269,-1012,0,0,0.5495946424599156,-5408959141,1971.2296542112574,1679.167965629335,292.06168858192245,0.7498651642321938,0.7511584142595913,-1012
1206,2020-04-21,2020,218004,218004,442219327.0499995,3452548.7500000023,165734,0,185,0.8181547127575631,44605012,6600034423,219068,219068,490449,709517,378594044.2000133,3450943.1999998237,166774,0,185,0.25343437859840057,5460539895,-1064,-1064,63625282.849986196,1605.5500001786277,-1040,0,0,0.5647203341591626,-5415934883,2028.49180313205,1728.2033167784125,300.2884863536376,0.7602337571787674,0.7612887322657805,-1040
1207,2020-04-22,2020,222062,222062,442673006.66666716,3484831.9000000004,168386,0,73,0.8151552269186091,44402583,6610766566,223055,223055,500114,723169,379267956.249995,3482200.1166665857,169392,0,73,0.2521139595309008,5476369597,-993,-993,63405050.41667217,2631.7833334147,-1006,0,0,0.5630412673877083,-5431967014,1993.465818855397,1700.3338022012283,293.13201665416864,0.7582837225639686,0.7594180807424178,-1006
1208,2020-04-23,2020,222214,222214,442666088.01666665,3528019.8833333366,169373,0,76,0.8171402341886651,44488699,6614130923,223297,223297,507235,730532,379526807.6500106,3526597.233332961,170406,0,77,0.2505051113435138,5488753080,-1083,-1083,63139280.366656065,1422.6500003756955,-1033,0,-1,0.5666351228451514,-5444264381,1992.0711027058,1699.6502758658226,292.4208268399775,0.762206701647961,0.7631360922896412,-1033
1209,2020-04-24,2020,229340,229340,443193812.69999963,3545092.3166666655,172018,0,59,0.804369059038981,45052979,6623011696,230475,230475,514694,745169,380270138.74999696,3542788.9666665588,173140,0,60,0.24950850075620298,5499796477,-1135,-1135,62923673.95000267,2303.3500001067296,-1122,0,-1,0.554860558282778,-5454743498,1932.4749834307127,1649.940942618492,282.5340408122206,0.7500566843987093,0.7512311530534765,-1122
1210,2020-04-25,2020,230542,230542,443026112.3000001,3596235.516666668,172499,0,84,0.8077400213410143,45414221,6625285026,231652,231652,525788,757440,380320821.34999835,3592680.366666572,173639,0,84,0.24781896915927365,5516225668,-1110,-1110,62705290.95000172,3555.150000095833,-1140,0,0,0.5599210521817406,-5470811447,1921.6720263552847,1641.7765499542345,279.89547640105025,0.7482324261956607,0.7495683179942327,-1140
1211,2020-04-26,2020,234519,234519,444044323.20000046,3665820.3666666658,174275,0,89,0.8032654070672325,45730790,6640816311,235668,235668,531517,767185,381525499.1499953,3661132.0333332606,175519,0,89,0.24778638789861868,5536846360,-1149,-1149,62518824.05000514,4688.3333334052,-1244,0,0,0.5554790191686139,-5491115570,1893.425791513696,1618.9109219325294,274.5148695811665,0.7431167623945182,0.7447723068044877,-1244
1212,2020-04-27,2020,243117,243117,445236760.38333297,3722544.849999997,179142,0,114,0.8021775523719034,46238372,6657461929,244199,244199,538155,782354,382889917.71666276,3718001.216666528,180293,0,114,0.25138236655017876,5557866963,-1082,-1082,62346842.6666702,4543.63333346881,-1151,0,0,0.5507951858217246,-5511628591,1831.3682728206295,1567.9422017152517,263.4260711053778,0.7368550944606918,0.738303596656825,-1151
1213,2020-04-28,2020,233124,233124,445731057.3666668,3652505.4499999993,175405,0,101,0.8092731765069232,45543523,6668169005,234336,234336,552664,787000,383555244.1333489,3647010.316666232,176640,0,101,0.24186658195679425,5564592320,-1212,-1212,62175813.23331791,5495.133333767299,-1235,0,0,0.567406594550129,-5519048797,1911.991289471126,1636.7747342847401,275.2165551863859,0.7524107342015408,0.7537894305612454,-1235
1214,2020-04-29,2020,238328,238328,446347062.6666664,3685867.966666672,177876,0,77,0.8015340203417142,45907270,6678060250,239437,239437,561353,800790,384368285.9666617,3681145.9833332044,179075,0,77,0.2406061514254639,5582215306,-1109,-1109,61978776.7000047,4721.983333467506,-1199,0,0,0.5609278689162502,-5536308036,1872.8267877323117,1605.3002917955941,267.52649593671754,0.7463495686616763,0.7479002827466098,-1199
1215,2020-04-30,2020,238502,238502,446955744.38333315,3674055.8666666597,179448,0,48,0.808760513538671,46024345,6687944954,240805,240805,570810,811615,385156501.2166741,3670201.7499995925,180884,0,48,0.24026293254807105,5601783257,-2303,-2303,61799243.16665906,3854.1166670671664,-1436,0,0,0.5684975809905999,-5555758912,1874.0125633467776,1599.4539200459878,274.55864330078975,0.752396206321121,0.7511638047382737,-1436
1216,2020-05-01,2020,223479,223479,446652219.6666663,3521091.816666662,169839,0,61,0.8141973071295289,45204472,6694635227,225149,225149,265460,490609,385089091.88334316,3516389.749999841,171375,0,61,0.3751847193997658,5565917741,-1670,-1670,61563127.78332317,4702.066666821018,-1536,0,0,0.4390125877297631,-5520713269,1998.631726769255,1710.3744270831457,288.25729968610926,0.759977447545407,0.7611626078730085,-1536
1217,2020-05-02,2020,210757,210757,446341965.68333316,3456441.4666666654,164071,0,50,0.8276545974748182,44407249,6698114698,211966,211966,282875,494841,384991823.8833388,3451609.133333168,165207,0,50,0.35556471674740564,5582000573,-1209,-1209,61350141.79999435,4832.333333497401,-1136,0,0,0.47208988072741254,-5537593324,2117.803753532899,1816.2904611274394,301.51329240545965,0.7784842259094598,0.7794033005293302,-1136
1218,2020-05-03,2020,213841,213841,446640142.4333331,3446957.0833333326,164811,0,99,0.8191179427705629,44864848,6705564639,214846,214846,292249,507095,385521222.233348,3442732.68333318,165978,0,99,0.34854810242656276,5602875256,-1005,-1005,61118920.19998509,4224.400000152644,-1167,0,0,0.4705698403440002,-5558010408,2088.655320697776,1794.4072602391852,294.24806045859077,0.7707174957094289,0.7725440548113532,-1167
1219,2020-05-04,2020,219569,219569,447684987.8833335,3512972.333333335,168150,0,149,0.8155613952789335,45011623,6723781238,220675,220675,301276,521951,386686385.2000091,3508424.649999841,169350,0,150,0.3463965008209622,5618075825,-1106,-1106,60998602.6833244,4547.683333493769,-1200,0,-1,0.46916489445797127,-5573064202,2038.926204898385,1752.2890458819943,286.6371590163908,0.7658184898596796,0.7674181488614479,-1200
1220,2020-05-05,2020,220954,220954,448402212.95000035,3529026.5833333344,169282,0,199,0.8204648931451787,45171868,6736271895,222040,222040,308177,530217,387609775.8833406,3524771.3833331903,170496,0,201,0.34519074265819566,5630229644,-1086,-1086,60792437.06665975,4255.200000144076,-1214,0,-2,0.475274150486983,-5585057776,2029.391696688,1745.6754453402116,283.71625134778833,0.7661413687916941,0.7678616465501712,-1214
1221,2020-05-06,2020,224600,224600,448974602.8666667,3537599.966666668,169905,0,123,0.810877114870882,45644610,6744050391,225889,225889,318620,544509,388361994.4333434,3532911.0499998415,171305,0,123,0.3380403262388627,5649386766,-1289,-1289,60612608.433323264,4688.916666826699,-1400,0,0,0.4728367886320193,-5603742156,1998.996450875631,1719.260320039238,279.73613083639293,0.7564781834372217,0.7583591941174648,-1400
1222,2020-05-07,2020,218967,218967,449549073.53333366,3487665.883333334,167675,0,54,0.8159448684048283,45094940,6755288113,220070,220070,332390,552460,389099392.45001173,3482840.999999836,168917,0,54,0.32670238569308147,5665843523,-1103,-1103,60449681.08332193,4824.883333497681,-1242,0,0,0.4892424827117468,-5620748583,2053.0448585098834,1768.0710339892385,284.97382452064494,0.765754657094448,0.7675603217158177,-1242
1223,2020-05-08,2020,214735,214735,449561325.5000004,3423770.450000003,165377,0,52,0.816750878990384,44965997,6761239712,215938,215938,347139,563077,389301286.83334595,3419987.833333155,166690,0,52,0.31535473833951877,5683537170,-1203,-1203,60260038.66665447,3782.61666684784,-1313,0,0,0.5013961406508652,-5638571173,2093.5633478473487,1802.8382537272084,290.7250941201403,0.7701445968286492,0.7719345367651826,-1313
1224,2020-05-09,2020,215026,215026,449652689.7833331,3420629.066666665,165113,0,54,0.8141899119176282,45104370,6768515071,216314,216314,360151,576465,389551110.20001197,3416380.2166664917,166485,0,54,0.3074132861491997,5701798901,-1288,-1288,60101579.583321154,4248.850000173319,-1372,0,0,0.5067766257684285,-5656694531,2091.154975599849,1800.859445990606,290.295529609243,0.7678745826086147,0.7696450530247696,-1372
1225,2020-05-10,2020,214907,214907,449952431.5333335,3424885.033333336,162819,0,37,0.8092430679317093,45183247,6779941308,216241,216241,370122,586363,389994539.01667756,3420731.3999998327,164289,0,37,0.3004913338665643,5719240878,-1334,-1334,59957892.51665592,4153.633333503269,-1470,0,0,0.5087517340651451,-5674057631,2093.7076574208077,1803.5180146996988,290.18964272110884,0.7576253914483939,0.7597495387091254,-1470
1226,2020-05-11,2020,218296,218296,451028392.1833332,3491729.4833333306,165397,0,49,0.8041100157584192,45058722,6798542088,219461,219461,379582,599043,391207843.6166755,3487685.2999998606,166683,0,49,0.2962258135058693,5734867736,-1165,-1165,59820548.56665772,4044.1833334700204,-1286,0,0,0.5078842022525499,-5689809014,2066.1321883283854,1782.5848037540861,283.54738457429926,0.757673067761205,0.7595108014635857,-1286
1227,2020-05-12,2020,219038,219038,451962101.28333336,3513994.533333335,168261,0,51,0.8182507144878978,44983941,6811332185,220139,220139,385895,606034,392304344.6166741,3509374.0333331246,169451,0,51,0.29872086384592494,5744600665,-1101,-1101,59657756.666659236,4620.500000210479,-1190,0,0,0.5195298506419728,-5699616724,2063.395854981023,1782.0756186621823,281.3202363188409,0.7681817766780193,0.7697454789928182,-1190
1228,2020-05-13,2020,220215,220215,452786793.1666663,3517032.2333333315,168955,0,47,0.8164384805758004,45033953,6824040994,221447,221447,394556,616003,393260119.1000134,3512415.7833331116,170221,0,47,0.29475018790493007,5764661049,-1232,-1232,59526674.06665295,4616.450000219978,-1266,0,0,0.5216882926708704,-5719627096,2056.1124045440424,1775.8656432465257,280.24676129751674,0.7672274822332721,0.7686760263178096,-1266
1229,2020-05-14,2020,217910,217910,452863217.10000014,3488868.6333333366,170024,0,50,0.8306181451057776,44291603,6827841665,219196,219195,406637,625833,393398206.91667575,3484752.8499998134,171336,0,50,0.29225208641922334,5776437613,-1286,-1285,59465010.1833244,4115.783333523199,-1312,0,0,0.5383660586865542,-5732146010,2078.212184388051,1794.7407875027977,283.47139688525317,0.7802487265384792,0.781656599572985,-1312
1230,2020-05-15,2020,221088,221088,452048852.26666623,3461288.1499999985,171979,0,45,0.8273266753509916,43841538,6818165193,222194,222194,417427,639621,392749219.7333433,3456795.549999832,173133,0,45,0.2882300612393925,5773773825,-1106,-1106,59299632.53332293,4492.600000166334,-1154,0,0,0.5390966141115991,-5729932287,2044.6557581897987,1767.5959734886778,277.05978470112086,0.7778757779707628,0.7791974580771758,-1154
1231,2020-05-16,2020,223506,223506,449210705.3000005,3478163.649999997,172891,0,46,0.8221613737438823,44627083,6772838332,224736,224735,428146,652882,390099144.23333955,3473157.316666481,174246,0,46,0.2841692679534769,5744033301,-1230,-1229,59111561.06666094,5006.333333516028,-1355,0,0,0.5379921057904054,-5699406218,2009.8373435165074,1735.8183826877857,274.0189608287217,0.7735407550580298,0.7753363947031183,-1355
1232,2020-05-17,2020,222988,222988,446013724.4500001,3453895.183333331,173267,0,47,0.8252910470518591,43971950,6717553356,224218,224218,437165,661383,387332479.2500104,3448112.1999998223,174579,0,47,0.2807798204671136,5702852769,-1230,-1230,58681245.199989736,5782.983333508484,-1312,0,0,0.5445112265847455,-5658880819,2000.1691770409175,1727.481643980458,272.6875330604594,0.7770238757242542,0.7786127786350784,-1312
1233,2020-05-18,2020,241951,241951,443137887.1166671,3485815.933333333,175107,0,48,0.7695607788353847,44957906,6666790633,243256,243256,449665,692921,385518553.4500153,3480522.549999863,176536,0,48,0.2713888018980508,5674448308,-1305,-1305,57619333.666651785,5293.383333470207,-1429,0,0,0.49817197693733384,-5629490402,1831.5191386547983,1584.8264932828597,246.69264537193862,0.723729184834946,0.7257210510737659,-1429
1234,2020-05-19,2020,251706,251706,441091613.38333297,3540532.266666666,179281,0,168,0.7558262417264582,45435863,6629840875,252786,252786,474127,726913,383927386.56666166,3535223.8833332714,180510,0,168,0.26406736432007655,5643656063,-1080,-1080,57164226.81667131,5308.38333339477,-1229,0,0,0.49175887740638163,-5598220200,1752.4080211966857,1518.7842149749656,233.6238062217201,0.712263513781952,0.7140822672141653,-1229
1235,2020-05-20,2020,235556,235556,438705102.3666664,3602469.249999996,181689,0,206,0.8169182699655286,46010298,6585575751,236838,236838,499497,736335,382423508.299997,3597587.1666665813,182979,0,206,0.26361099227933643,5609293985,-1282,-1282,56281594.066669405,4882.083333414514,-1290,0,0,0.5533072776861923,-5563283687,1862.4238073607396,1614.7050232648348,247.71878409590477,0.7713197710947716,0.7725913915841208,-1290
1236,2020-05-21,2020,231621,231621,436704028.96666664,3603264.899999997,180454,0,52,0.8220454967382068,46269620,6545179725,232890,232890,505876,738766,381089565.2499991,3598306.566666523,181723,0,52,0.26004039168018767,5581194358,-1269,-1269,55614463.71666753,4958.333333474118,-1269,0,0,0.5620051050580191,-5534924738,1885.4250217668805,1636.350059040745,249.07496272613548,0.7790917058470519,0.7802954184378891,-1269
1237,2020-05-22,2020,224547,224547,436186790.09999985,3564802.483333337,174489,0,53,0.8200866633711426,45381345,6539034584,225465,225465,517203,742668,380857590.06667334,3560166.9833328426,175515,0,53,0.24983034141769622,5587269114,-918,-918,55329200.03332651,4635.500000494532,-1026,0,0,0.5702563219534463,-5541887769,1942.5188940399999,1689.2093676032791,253.30952643672072,0.7770711699555104,0.7784578537688777,-1026
1238,2020-05-23,2020,222027,222027,436175063.53333336,3543685.416666666,172108,0,51,0.8188013169569475,44532697,6540609273,223052,223052,527583,750635,381017360.71666443,3540174.366666602,173103,0,52,0.2438748526247817,5597135156,-1025,-1025,55157702.81666893,3511.050000064075,-995,0,-1,0.5749264643321658,-5552602459,1964.513611107358,1708.1997055245613,256.3139055827967,0.7751669841956158,0.7760656707852878,-995
1239,2020-05-24,2020,221006,221006,436366859.03333265,3509811.6500000004,171165,0,54,0.8237423418368732,44856205,6548648710,221912,221912,538362,760274,381385506.2999959,3505550.7999999127,172140,0,54,0.24113937869768026,5612240459,-906,-906,54981352.73333675,4260.850000087637,-975,0,0,0.5826029631391929,-5567384254,1974.457069189672,1718.6339914019786,255.82307778769336,0.7744812358035529,0.7757128952017016,-975
1240,2020-05-25,2020,225774,225774,436979652.6833334,3575937.366666669,174377,0,57,0.8219502688529235,44697676,6556690211,226745,226745,546275,773020,382224315.4499979,3570873.8833332094,175399,0,57,0.242033841297763,5627881413,-971,-971,54755337.233335495,5063.48333345959,-1022,0,0,0.5799164275551605,-5583183737,1935.4737599694092,1685.7011861341944,249.77257383521487,0.7723519980157149,0.7735517872499945,-1022
1241,2020-05-26,2020,223726,223726,437254613.8666666,3551322.8499999996,172372,0,54,0.8182196079132519,44667216,6560159440,224652,224652,553362,778014,382723571.23332775,3547674.866666534,173276,0,54,0.23684535239725893,5632442421,-926,-926,54531042.63333887,3647.983333465643,-904,0,0,0.581374255515993,-5587775205,1954.420200900506,1703.6285954869209,250.7916054135851,0.7704602951825,0.7713085127218987,-904
1242,2020-05-27,2020,227668,227668,437900181.99999964,3585523.3166666636,174737,0,163,0.8166145439851007,45195731,6568320306,228610,228610,562202,790812,383593891.1666616,3581087.833333273,175694,0,163,0.23684896030915392,5643577834,-942,-942,54306290.83333802,4435.483333390672,-957,0,0,0.5797655836759468,-5598382103,1923.4155963947487,1677.9401214586485,245.47547493610023,0.7675079501730591,0.7685315602991996,-957
1243,2020-05-28,2020,232602,232602,438494692.31666666,3620195.716666667,177981,0,52,0.8179551336617913,44928286,6575751308,233502,233502,570505,804007,384236953.14999735,3615369.1166665587,178963,0,52,0.23853896794430934,5653448576,-900,-900,54257739.16666931,4826.600000108127,-982,0,0,0.5794161657174819,-5608520290,1885.1716335915712,1645.5403086483086,239.6313249432626,0.7651739881858282,0.7664302661219176,-982
1244,2020-05-29,2020,234182,234182,438971672.73333347,3623248.783333333,180184,0,96,0.8239104628024367,45528385,6583503665,235021,235021,581487,816508,384876005.61667514,3618549.69999959,181108,0,96,0.23792418445379043,5668091580,-839,-839,54095667.11665833,4699.0833337432705,-924,0,0,0.5859862783486463,-5622563195,1874.4893831862973,1637.6238958079284,236.86548737836893,0.7694186572836512,0.7706034779870735,-924
1245,2020-05-30,2020,227796,227796,438515839.41666687,3599745.4000000004,176398,0,87,0.8240311506786768,44973881,6578129689,228922,228922,592675,821597,384621736.29999954,3595370.3666662904,177513,0,87,0.23034163951426295,5676577629,-1126,-1126,53894103.11666733,4375.033333709929,-1115,0,0,0.5936895111644138,-5631603748,1925.0374871229822,1680.143176715211,244.89431040777117,0.7743682944388839,0.7754300591467836,-1115
1246,2020-05-31,2020,228200,228200,438629920.9333333,3592291.0000000005,178078,0,102,0.8321165644171783,45028310,6580359439,229177,229177,601698,830875,384948220.0833291,3587345.983333227,179172,0,103,0.2305027832104713,5692185310,-977,-977,53681700.850004196,4945.016666773241,-1094,0,-1,0.601613781206707,-5647157000,1922.1293643003212,1679.6983121488154,242.4310521515058,0.7803593339176161,0.7818062021930647,-1094
1247,2020-06-01,2020,233671,233671,439404202.70000035,3650983.649999997,181354,0,56,0.8265595645159219,46127724,6592294744,234889,234889,261888,496777,385763376.2166696,3647658.099999535,182641,0,57,0.39224239447478576,5655899536,-1218,-1218,53640826.48333073,3325.5500004622154,-1287,0,-1,0.4343171700411362,-5609771812,1880.439603973109,1642.3220168533633,238.11758711974562,0.7761082890046261,0.7775630191281839,-1287
1248,2020-06-02,2020,232357,232357,439846317.06666684,3626673.266666669,181018,0,81,0.8275928850863116,44788537,6600009891,233536,233536,273989,507525,386297867.216667,3622087.7666662373,182164,0,81,0.3818215851435867,5657729296,-1179,-1179,53548449.849999845,4585.500000431668,-1146,0,0,0.44577129994272485,-5612940759,1892.9763986738806,1654.1255618691207,238.85083680475987,0.7790512013840771,0.7800253494107975,-1146
1249,2020-06-03,2020,233005,233005,438554996.6500003,3630051.26666667,181648,0,140,0.8328147464646687,46139665,6580377655,234482,234482,284357,518839,385256647.35000193,3625052.6999996738,183065,0,140,0.3778031335346743,5646642429,-1477,-1477,53298349.29999834,4998.5666669961065,-1417,0,0,0.45501161292999437,-5600502764,1882.169896139569,1643.0116057949094,239.15829034465946,0.779588420849338,0.7807209082147031,-1417
1250,2020-06-04,2020,229439,229439,436504352.8333333,3608868.4666666626,179114,0,115,0.8333413238377084,46008796,6542855863,230866,230865,295919,526785,383614662.8000026,3603371.5499995584,180486,0,117,0.36651385290014166,5619071796,-1427,-1426,52889690.03333074,5496.916667104233,-1372,0,-2,0.46682747093756677,-5573063000,1902.4854224143817,1661.6406246074657,240.84479780691595,0.7806606549017386,0.7817781743522216,-1372
1251,2020-06-05,2020,227884,227884,434359138.3000001,3595937.2500000065,177392,0,47,0.8282240087061837,46541598,6506615571,229316,229316,305552,534868,382176829.03334105,3591539.349999789,178779,0,47,0.356400083758983,5605472055,-1432,-1432,52182309.26665902,4397.900000217371,-1387,0,0,0.4718239249472007,-5558930457,1906.0536865247234,1666.5946948025478,239.4589917221756,0.7784311316283723,0.7796185176786617,-1387
1252,2020-06-06,2020,225194,225194,432817943.5833337,3590989.4999999963,175633,0,53,0.8283790864765481,46456555,6482637551,226570,226570,316526,543096,381173551.9333435,3585944.2666664617,177049,0,53,0.34655935598862486,5593630121,-1376,-1376,51644391.64999014,5045.233333534561,-1416,0,0,0.48181973048792326,-5547173566,1921.9781325582994,1682.3655026408771,239.61262991742228,0.7799186479213478,0.7814317870856688,-1416
1253,2020-06-07,2020,227161,227161,431630326.7333336,3583670.2500000037,176480,0,55,0.8239442509937885,46855733,6459951812,228585,228585,325772,554357,380368643.5166714,3578845.983333008,177932,0,55,0.34099686664008666,5589374451,-1424,-1424,51261683.21666217,4824.266666995827,-1452,0,0,0.4829473843537019,-5542518718,1900.107530488656,1664.0140145533232,236.0935159353328,0.7768939210515889,0.7784062821269987,-1452
1254,2020-06-08,2020,231287,231287,431203664.90000004,3629012.5666666725,179402,0,57,0.8231245162936095,46077722,6451461550,232650,232650,333711,566361,380240101.61667216,3624020.4999996573,180763,0,57,0.3391935532284236,5588133921,-1363,-1363,50963563.28332788,4992.066667015199,-1361,0,0,0.4839309630651859,-5542056199,1864.3661982731412,1634.3868541443032,229.97934412883797,0.7756683255003524,0.7769739952718676,-1361
1255,2020-06-09,2020,231098,231098,430270718.2500009,3615829.666666665,180508,0,59,0.8262598551263961,45272845,6431609086,232455,232455,339148,571603,379729318.43334025,3610695.1999998507,181816,0,59,0.33713608920876675,5574965639,-1357,-1357,50541399.81666064,5134.4666668144055,-1308,0,0,0.48912376591762935,-5529692794,1861.85392452553,1633.5605533687822,228.29337115674775,0.7810885425230855,0.7821556860467618,-1308
1256,2020-06-10,2020,231205,231205,429181942.7333339,3611652.9499999946,181157,0,53,0.8322873640275948,45341403,6413222238,232324,232324,347818,580142,379047767.7333451,3607006.383333193,182280,0,53,0.33412509351158354,5564287070,-1119,-1119,50134174.999988794,4646.56666680146,-1123,0,0,0.4981622705160113,-5518945667,1856.2831371870586,1631.5480438239058,224.73509336315283,0.7835340931208236,0.7845939291678862,-1123
1257,2020-06-11,2020,233913,233913,428465501.6999998,3644370.466666671,181649,0,232,0.8276752467797853,45607499,6390916096,234985,234985,354987,589972,378707552.2166699,3639347.616666437,182698,0,235,0.33050382052028615,5548730796,-1072,-1072,49757949.48332989,5022.850000233855,-1049,0,-3,0.49717142625949917,-5503123297,1831.7301804517056,1611.6243684348785,220.10581201682703,0.7765665012205393,0.7774879247611549,-1049
1258,2020-06-12,2020,236332,236332,427230968.9666669,3649529.683333341,184311,0,55,0.8309708376351905,45223091,6360681396,237431,237431,363983,601414,378062364.33334404,3644116.349999802,185430,0,55,0.3291060733537919,5536372331,-1099,-1099,49168604.633322835,5413.333333538845,-1119,0,0,0.5018647642813987,-5491149240,1807.7575993376558,1592.3041402906279,215.453459047028,0.7798816918572178,0.7809847913709668,-1119
1259,2020-06-13,2020,231393,231393,426334942.1166666,3623327.8166666664,182189,0,50,0.83574265427217,45458025,6345911719,232536,232536,374334,606870,377491370.15001047,3618510.766666471,183316,0,50,0.32125166839685326,5533524503,-1143,-1143,48843571.96665615,4817.0500001953915,-1127,0,0,0.5144909858753167,-5488066478,1842.4712161416578,1623.3674362249735,219.1037799166843,0.7873574395076774,0.7883338493824612,-1127
1260,2020-06-14,2020,230933,230933,425394764.8833334,3604063.399999999,182072,0,57,0.8364633898143609,46133088,6329216759,232121,232121,384467,616588,376971782.48334193,3599466.9999998184,183199,0,57,0.3158494813392392,5533404861,-1188,-1188,48422982.39999145,4596.400000180583,-1127,0,0,0.5206139084751217,-5487271773,1842.0700587760666,1624.0313564190312,218.0387023570354,0.7884191518752193,0.7892392329862442,-1127
1261,2020-06-15,2020,231229,231229,424997657.4833336,3639671.6833333345,180637,0,60,0.8264058573967802,45443481,6320132091,232467,232467,393838,626305,376961064.28334,3634893.3499998534,181889,0,60,0.3077398392157178,5526837056,-1238,-1238,48036593.19999361,4778.333333481103,-1252,0,0,0.5186660181810624,-5481393575,1837.9946178175471,1621.5680689445812,216.4265488729659,0.7812039147338785,0.7824293340560166,-1252
1262,2020-06-16,2020,231627,231627,424444512.26666623,3654253.1833333354,180078,0,52,0.8234014169332584,45443226,6307554300,232803,232802,398000,630803,376737186.516683,3649081.216666431,181217,0,52,0.3046561287755498,5515649247,-1176,-1175,47707325.74998325,5171.966666904278,-1139,0,0,0.5187452881577086,-5470206021,1832.4483426658646,1618.2729809738876,214.17536169197706,0.7774482249478688,0.7784135084169878,-1139
1263,2020-06-17,2020,229961,229961,424141258.6666671,3610466.633333326,178916,0,66,0.8239788485873696,44732973,6303079738,232777,232777,406464,639241,376770900.5833431,3606322.016666465,180229,0,66,0.29897331366418034,5516275508,-2816,-2816,47370358.083324015,4144.6166668608785,-1313,0,0,0.5250055349231892,-5471542535,1844.4051759501267,1618.5916159386154,225.8135600115113,0.778027578589413,0.774256047633572,-1313
1264,2020-06-18,2020,227236,227236,422415477.3500004,3573623.0999999987,176717,0,61,0.8208470488831,44591094,6290017649,228212,228212,419980,648192,375225318.06668115,3569065.566666475,177652,0,61,0.28952995408768106,5520371019,-976,-976,47190159.283319235,4557.533333523665,-935,0,0,0.5313170947954189,-5475779925,1858.9285031861166,1644.196265168708,214.7322380174087,0.7776804731644634,0.7784516151648467,-935
1265,2020-06-19,2020,234501,234501,421582136.21666694,3610471.516666661,180631,0,73,0.8152673122929115,44738227,6280936262,237732,237732,425876,663608,374555270.85001564,3608715.6999998153,182410,0,73,0.2912864221046175,5517982907,-3231,-3231,47026865.3666513,1755.816666845698,-1779,0,0,0.523980890188294,-5473244680,1797.7839592013122,1575.535774948327,222.2481842529853,0.7702781651250954,0.7672925815624316,-1779
1266,2020-06-20,2020,232814,232814,420616263.1333332,3602637.7166666654,181667,0,58,0.8253584406436036,44273527,6269317117,233774,233774,436139,669913,373699233.7833457,3597670.249999835,182625,0,58,0.28875540555266915,5510529560,-960,-960,46917029.34998751,4967.466666830238,-958,0,0,0.5366030350909345,-5466256033,1806.662241675042,1598.5491704952035,208.11307117983847,0.7803096033743675,0.7812032133599117,-958
1267,2020-06-21,2020,229647,229647,419921657.13333297,3557498.316666671,178634,0,63,0.8221444216558462,44920817,6259229763,179710,179710,468310,648020,356706870.3333348,2716657.566666588,99691,0,63,0.15893953890312168,5494681335,49937,49937,63214786.799998164,840840.7500000829,78943,0,0,0.6632048827527246,-5449760518,1828.5527663471892,1984.9027340344712,-156.34996768728206,0.7778634164609161,0.5547326247843748,78943
1268,2020-06-22,2020,228276,228276,419586142.4833335,3589102.133333334,177524,0,52,0.8224386269253003,45041628,6255532098,228987,228987,470471,699458,357936051.5000074,3585652.1333328052,178282,0,52,0.269907556994121,5508266022,-711,-711,61650090.98332614,3450.0000005285256,-758,0,0,0.5525310699311794,-5463224394,1838.0650724707527,1563.1282627398384,274.9368097309143,0.7776726418896424,0.7785682156628979,-758
1269,2020-06-23,2020,232639,232639,419242658.1999997,3611749.766666661,182373,0,50,0.8293450367307292,44209210,6246443974,233626,233626,453600,687226,358426064.55000734,3606471.2499997886,183323,0,51,0.2825504273703217,5423323685,-987,-987,60816593.64999235,5278.516666872427,-950,0,-1,0.5467946093604075,-5379114475,1802.1168342367346,1534.1873958806268,267.92943835610777,0.7839313270775752,0.7846857798361484,-950
1270,2020-06-24,2020,234655,234655,418805993.26666707,3648069.9166666665,186020,0,53,0.8386780592785154,44398253,6235529239,235773,235773,460689,696462,358589449.2166785,3642566.266666487,187109,0,53,0.2846587466365739,5410143027,-1118,-1118,60216544.04998857,5503.650000179652,-1089,0,0,0.5540193126419415,-5365744774,1784.7733620279434,1520.9097276476887,263.8636343802548,0.7927382753403933,0.79359807950868,-1089
1271,2020-06-25,2020,235423,235423,418036308.316666,3634029.8166666664,184593,0,55,0.829094863288633,45598308,6223812406,236746,236746,469569,706315,358158145.10000664,3628985.3999995287,185750,0,55,0.27835739011631194,5403172615,-1323,-1323,59878163.21665937,5044.416667137761,-1157,0,0,0.5507374731723211,-5357574307,1775.6816807052242,1512.8371550100387,262.84452569518544,0.7840907642838635,0.7845961494597585,-1157
1272,2020-06-26,2020,238067,238067,416553427.20000046,3664840.583333332,185451,0,50,0.821798065250538,46264339,6200205272,239131,239129,477220,716351,357350481.2166745,3658727.3166661607,186483,0,51,0.27509838054249247,5392380311,-1064,-1062,59202945.98332596,6113.266667171381,-1032,0,-1,0.5466996847080455,-5346115972,1749.731912444818,1494.3837059356017,255.3482065092162,0.7789865878093142,0.7798361567509022,-1032
1273,2020-06-27,2020,235888,235888,415793285.9666661,3654894.86666667,183101,0,53,0.8195075629112115,46057552,6188926054,236732,236732,484120,720852,357001254.1000002,3650033.333332887,183961,0,54,0.26970723532709306,5386011010,-844,-844,58792031.8666659,4861.533333783038,-860,0,-1,0.5498003275841185,-5339953458,1762.6724800187635,1508.0396993224415,254.63278069632202,0.7762200705419521,0.777085480627883,-860
1274,2020-06-28,2020,232399,232399,415183677.2333338,3595829.5166666675,180981,0,47,0.825571538603867,45038643,6180175607,233147,233147,493930,727077,356763122.5666848,3591507.3499994506,181818,0,50,0.2653694175444979,5386834999,-748,-748,58420554.66664904,4322.166667216923,-837,0,-3,0.5602021210593691,-5341796356,1786.5123224856125,1530.2067904227151,256.3055320628973,0.7787511994457808,0.7798427601470317,-837
1275,2020-06-29,2020,225834,225834,414541940.50000006,3557631.7999999993,175903,0,54,0.8234278275193286,44378674,6174649821,226866,226866,506238,733104,356711784.4833396,3552276.3166661705,176912,0,54,0.2554166939479323,5393089253,-1032,-1032,57830156.01666045,5355.483333828859,-1009,0,0,0.5680111335713963,-5348710579,1835.6046498755725,1572.3457216301235,263.25892824544894,0.7789039737152067,0.7798083450142375,-1009
1276,2020-06-30,2020,228636,228636,413683336.0833335,3583354.183333327,177619,0,55,0.8207718819433509,44493792,6160966836,229508,229507,511754,741262,356403582.13332677,3578217.416666608,178520,0,55,0.254824879732132,5384655666,-872,-871,57279753.95000672,5136.766666719224,-901,0,0,0.565947002211219,-5340161874,1809.3534530141076,1552.909419465754,256.4440335483537,0.7768636610157631,0.7778378095752654,-901
1277,2020-07-01,2020,234417,234417,413499531.86666644,3630032.283333342,181435,0,53,0.8175345644727129,45154829,6157293799,235472,235472,268014,503486,356654869.733333,3624683.5666662953,182586,0,54,0.38372268543712656,5339622188,-1055,-1055,56844662.133333445,5348.71666704677,-1151,0,-1,0.4338118790355863,-5294467359,1763.948569714084,1514.6381299404302,249.3104397736538,0.7739839687394685,0.7754042943534688,-1151
1278,2020-07-02,2020,235171,235171,412955284.91666657,3653179.2500000014,184576,0,58,0.8284694966641297,45499711,6150898276,236228,236228,275790,512018,356592128.716668,3647894.0333329528,185598,0,58,0.3832228554464889,5336934462,-1057,-1057,56363156.19999856,5285.216667048633,-1022,0,0,0.44524664121764085,-5291434751,1755.9787767907887,1509.5252413628698,246.45353542791895,0.7848586773028987,0.7856731632151989,-1022
1279,2020-07-03,2020,233204,233204,412584794.83333254,3562273.2666666647,184706,0,48,0.8369967925078471,44371828,6144658448,234013,234013,284469,518482,356712930.683333,3557268.666666322,185580,0,48,0.37894083111852783,5337603070,-809,-809,55871864.14999956,5004.60000034282,-874,0,0,0.45805596138931925,-5293231242,1769.2011922322624,1524.3295487145285,244.8716435177339,0.7920361571842679,0.7930328656954956,-874
1280,2020-07-04,2020,228977,228977,411919487.3166671,3596751.833333338,180763,0,69,0.8356472484135958,44024635,6136188221,229831,229831,297582,527413,356478584.7500013,3591655.1666663447,181624,0,69,0.3648715522749733,5342550204,-854,-854,55440902.56666577,5096.666666993406,-861,0,0,0.4707756961386225,-5298525569,1798.9557349282552,1551.0465722639735,247.90916266428167,0.789437367071802,0.7902502273409592,-861
1281,2020-07-05,2020,227140,227140,411372476.93333286,3572546.816666663,179978,0,72,0.8386809896979829,44673340,6128252999,227897,227897,306149,534046,356353870.0666698,3567967.2999996543,180798,0,72,0.35900465502971485,5348635789,-757,-757,55018606.86666304,4579.516667008866,-820,0,0,0.47967633466826803,-5303962449,1811.0965789087472,1563.6619616171772,247.43461729157002,0.7923659417099587,0.7933320754551398,-820
1282,2020-07-06,2020,229478,229478,411231838.60000014,3605040.6833333345,181535,0,60,0.8367163736828803,44714075,6126299879,230482,230482,315368,545850,356596648.0166749,3599907.616666355,182470,0,60,0.35397087111844666,5351543083,-1004,-1004,54635190.58332527,5133.066666979343,-935,0,0,0.48274550256443366,-5306829008,1792.0316483497336,1547.177862117974,244.8537862317596,0.7910780118355573,0.791688721895853,-935
1283,2020-07-07,2020,230849,230849,410837480.3999998,3621342.633333333,182338,0,56,0.8333066203449018,44777796,6115227840,232866,232866,320871,553737,356592019.4000099,3617022.149999686,183543,0,57,0.35024027652116085,5344140758,-2017,-2017,54245460.99998993,4320.4833336467855,-1205,0,-1,0.4830663438237409,-5299362962,1779.680572148893,1531.3185239580268,248.36204819086606,0.7898583056456818,0.7881914921027544,-1205
1284,2020-07-08,2020,232356,232356,410198089.1499995,3633587.1500000013,183428,0,60,0.8316634818984661,44625502,6104288640,233265,233265,328752,562017,356429713.26668406,3627618.483333138,184262,0,61,0.3458151621748098,5344034337,-909,-909,53768375.883315444,5968.666666863486,-834,0,-1,0.4858483197236563,-5299408835,1765.3862570796514,1528.0034007102824,237.38285636936894,0.7894265695742739,0.7899256210747433,-834
1285,2020-07-09,2020,232414,232414,409645709.0666659,3627562.200000004,185337,0,60,0.8411068180057997,43982742,6089517692,233587,233587,336642,570229,356495693.66666853,3622534.0833329074,186142,0,60,0.34467205280684954,5342708226,-1173,-1173,53150015.39999735,5028.116667096503,-805,0,0,0.49643476519895013,-5298725484,1762.568989246198,1526.17951198769,236.38947725850812,0.7974433553916718,0.7968851006263191,-805
1286,2020-07-10,2020,235794,235794,409008132.0833336,3626385.9333333327,187803,0,47,0.8383249785830003,44545947,6079049118,236595,236595,344936,581531,356295533.9000101,3621548.24999989,188591,0,47,0.34179261294754487,5341514885,-801,-801,52712598.1833235,4837.683333442546,-788,0,0,0.4965323656354554,-5296968938,1734.5994049184187,1505.9301079904906,228.66929692792814,0.7964706481080943,0.7971047570743254,-788
1287,2020-07-11,2020,234417,234417,408253732.9333329,3632551.000000005,187150,0,48,0.8421829474824778,44467099,6066739013,235293,235293,352587,587880,355982653.86667883,3627890.833333209,188008,0,48,0.3378308498333051,5342151410,-876,-876,52271079.066654086,4660.166666795965,-858,0,0,0.5043520976491727,-5297684311,1741.570504414496,1512.9334653673454,228.63703904715067,0.7983635999095628,0.7990377954295282,-858
1288,2020-07-12,2020,234956,234956,408096853.2333325,3627135.283333331,188641,0,47,0.8474608011712835,44494408,6062598423,235730,235730,360458,596188,356256414.5666789,3621996.999999904,189420,0,47,0.33589236952102697,5346946724,-774,-774,51840438.66665363,5138.283333426807,-779,0,0,0.5115684316502566,-5302452316,1736.9075624088448,1511.290097003686,225.61746540515878,0.8028779856654011,0.8035464302379841,-779
1289,2020-07-13,2020,235627,235627,408143886.966667,3632723.516666665,188346,0,54,0.8455525045941245,44148492,6061923774,236438,236438,370401,606839,356584369.7333472,3627842.0166665576,189221,0,54,0.33043855124670907,5352185472,-811,-811,51559517.23331982,4881.500000107568,-875,0,0,0.5151139533474154,-5308036980,1732.1609449115213,1508.1516919164735,224.00925299504775,0.7993396342524414,0.8002985983640531,-875
1290,2020-07-14,2020,233726,233726,407599224.83333296,3624548.966666663,184691,0,50,0.8342332474778165,44070951,6050502947,234613,234613,377093,611706,356327118.9500114,3619806.849999856,185539,0,50,0.3206262485573156,5340225871,-887,-887,51272105.88332158,4742.116666806862,-848,0,0,0.5136069989205009,-5296154920,1743.919054077565,1518.7867635212515,225.1322905563136,0.7902030582819198,0.7908300051574295,-848
1291,2020-07-15,2020,234819,234819,407373301.0500004,3626794.8000000007,185455,0,49,0.8325007771943492,43457538,6043773848,235690,235690,384815,620505,356495501.7833419,3622436.16666649,186283,0,51,0.3169837471092064,5337564653,-871,-871,50877799.266658545,4358.633333510719,-828,0,-2,0.5155170300851428,-5294107115,1734.8396043335524,1512.560998698892,222.27860563466038,0.7897785102568361,0.7903729475158047,-828
1292,2020-07-16,2020,236249,236249,406853144.1999999,3665135.499999998,186817,0,53,0.8356352831123087,44245751,6036969161,237295,237295,392475,629770,356395341.5833436,3660450.1666664667,187870,0,53,0.31571684900836755,5338362630,-1046,-1046,50457802.6166563,4685.333333531395,-1053,0,0,0.5199184341039411,-5294116879,1722.1370003682553,1501.9083486097204,220.22865175853485,0.7907631355053355,0.7917149539602605,-1053
1293,2020-07-17,2020,239578,239578,406337518.9666671,3677220.1166666653,190072,0,46,0.8355065991034225,43633572,6026305898,241083,241081,399612,640695,356332961.45001036,3671366.5666663945,191363,0,46,0.3150578668477133,5335613033,-1505,-1503,50004557.51665676,5853.550000270829,-1291,0,0,0.5204487322557092,-5291979461,1696.0552261337314,1478.0632295784835,217.99199655524785,0.7933616609204518,0.7937639734033507,-1291
1294,2020-07-18,2020,239620,239620,405840585.1833331,3679103.300000003,190133,0,45,0.8360529171187707,44895105,6019738594,240466,240466,408171,648637,355961459.40001035,3673943.199999794,191016,0,45,0.310919666932347,5331315455,-846,-846,49879125.78332275,5160.100000209175,-883,0,0,0.5251332501864237,-5286420350,1693.6841047630962,1480.2985012434622,213.38560351963406,0.7934771721892997,0.7943576222833997,-883
1295,2020-07-19,2020,237101,237101,405442693.23333275,3640517.1166666667,188716,0,54,0.8360740781354774,44494990,6013305892,237915,237915,416582,654497,355804240.0000117,3635196.616666439,189551,0,54,0.30463546815341036,5337304488,-814,-814,49638453.23332107,5320.500000227708,-835,0,0,0.531438609982067,-5292809498,1709.9999292847046,1495.509909001163,214.49002028354175,0.7959308480352255,0.7967173150074607,-835
1296,2020-07-20,2020,239867,239867,404446314.98333263,3705517.9499999965,189832,0,45,0.8370513659653056,44621119,5999250302,240796,240796,425970,666766,355396518.80001354,3701318.7833331004,190662,0,45,0.30266840240804943,5334761936,-929,-929,49049796.18331909,4199.1666668960825,-830,0,0,0.5343829635572561,-5290140817,1686.1273746840234,1475.9236814565588,210.20369322746456,0.7914052370688757,0.7917988670908155,-830
1297,2020-07-21,2020,240891,240891,404287349.58333355,3729319.6333333342,190730,0,44,0.8362039262571038,45327190,5994533149,241870,241870,428758,670628,355543953.11667067,3725259.433333137,191614,0,44,0.3022331307371533,5323305865,-979,-979,48743396.466662884,4060.200000197161,-884,0,0,0.5339707955199505,-5277978675,1678.2999347561079,1469.979547346387,208.32038740972075,0.7917688913242918,0.7922189605986687,-884
1298,2020-07-22,2020,240732,240732,404180995.8333341,3729398.1333333384,189743,0,28,0.831480650682087,45190777,5991163041,241678,241678,436801,678479,355693836.30000865,3723307.833333169,190635,0,28,0.29665914494036616,5321588754,-946,-946,48487159.533325434,6090.300000169314,-892,0,0,0.5348215057417208,-5276397977,1678.96663440396,1471.7675431773214,207.19909122663853,0.7881918481963345,0.7887974908762899,-892
1299,2020-07-23,2020,238525,238525,404130140.2166667,3706872.016666666,189079,0,24,0.8379331306990884,45229074,5990038886,239682,239682,446423,686105,355845299.41667557,3701455.516666469,190196,0,24,0.29365476129746904,5325373600,-1157,-1157,48284840.79999113,5416.500000196975,-1117,0,0,0.5442783694016193,-5280144526,1694.2883983509766,1484.6559166590548,209.63248169192184,0.7927009747405932,0.7935347668994751,-1117
1300,2020-07-24,2020,242267,242267,403847621.9833335,3705994.3333333354,191053,0,23,0.8333780498375755,44864103,5986541581,243360,243360,454474,697834,355896965.7499962,3701147.8833331643,192086,0,23,0.2918330147284292,5328928533,-1093,-1093,47950656.23333734,4846.450000171084,-1033,0,0,0.5415450351091462,-5284064430,1666.9526678554384,1462.4300039036661,204.5226639517723,0.7886051340050441,0.7893080210387903,-1033
1301,2020-07-25,2020,241331,241331,403578125.7833336,3731578.7666666694,190247,0,47,0.8320439562260952,44764725,5982478838,242249,242249,462460,704709,355985974.0333387,3725905.399999544,191224,0,47,0.2871397981294421,5333873521,-918,-918,47592151.749994874,5673.366667125374,-977,0,0,0.544904158096653,-5289108796,1672.3012202466057,1469.5044108885434,202.79680935806232,0.7883239202588975,0.7893696155608485,-977
1302,2020-07-26,2020,238842,238842,403614409.78333366,3690064.866666664,188114,0,50,0.8280830004773023,44978258,5980962681,239881,239881,470267,710148,356269466.8666603,3684510.216666585,189160,0,50,0.2806246021956049,5343641505,-1039,-1039,47344942.91667336,5554.650000079069,-1046,0,0,0.5474583982816974,-5298663247,1689.8803802653372,1485.1925199022028,204.6878603631344,0.7876085445608394,0.7885576598396705,-1046
1303,2020-07-27,2020,238407,238407,403609965.21666723,3706598.866666674,188146,0,51,0.8312801218085042,44690624,5977503758,239482,239482,480415,719897,356470318.4666685,3701273.199999542,189162,0,52,0.2771424245412791,5347329407,-1075,-1075,47139646.74999875,5325.666667132173,-1016,0,-1,0.5541376972672252,-5302638783,1692.9451115808984,1488.505685048014,204.43942653288445,0.7891798479071503,0.789879823953366,-1016
1304,2020-07-28,2020,237222,237222,403274357.0499998,3714606.1333333296,187973,0,181,0.8370345077606633,44591922,5969446649,238358,238358,486217,724575,356550114.2833261,3708869.5666665724,189068,0,181,0.275943829141223,5339875266,-1136,-1136,46724242.766673684,5736.566666757222,-1095,0,0,0.5610906786194403,-5295283344,1699.987172564095,1495.859649281023,204.12752328307215,0.7923927797590443,0.7932102132087029,-1095
1305,2020-07-29,2020,241451,241451,402987611.0833337,3757869.9666666654,191042,0,187,0.8343307751883408,45452722,5963823967,242497,242497,492449,734946,356610254.1166626,3751433.9166665412,192107,0,188,0.27597673842704057,5338633400,-1046,-1046,46377356.96667105,6436.050000124145,-1065,0,-1,0.5583540367613002,-5293180678,1669.02440281189,1470.5759416267526,198.44846118513738,0.7912247205437128,0.7922036148900811,-1065
1306,2020-07-30,2020,247234,247234,403150254.55000013,3777577.100000004,194230,0,126,0.8289232063551127,45044702,5962793195,248382,248382,497595,745977,356998033.2999935,3771526.7999999328,195281,0,128,0.27635972690847044,5337436847,-1148,-1148,46152221.250006616,6050.30000007106,-1051,0,-2,0.5525634794466423,-5292392145,1630.6424462250343,1437.2943019220133,193.34814430302094,0.7856120112929451,0.786212366435571,-1051
1307,2020-07-31,2020,249348,249348,402859135.2333337,3809427.899999999,196467,0,101,0.8317492019186039,44935804,5954314487,250433,250433,507344,757777,357059439.4333271,3804338.0999998767,197494,0,101,0.2753857665249773,5333381670,-1085,-1085,45799695.80000663,5089.800000122283,-1027,0,0,0.5563634353936266,-5288445866,1615.6501565415954,1425.76832699096,189.8818295506353,0.7879229029308437,0.7886101272595863,-1027
1308,2020-08-01,2020,251197,251197,402211944.43333316,3849905.2833333323,198491,0,73,0.8384295990796066,45526299,5946033607,252251,252251,105272,357523,356878121.1500138,3845397.4666663483,199557,0,48,0.5939002525711664,5219512083,-1054,-1054,45333823.283319354,4507.816666983999,-1066,0,25,0.24452934650844016,-5173985784,1601.1813215656762,1414.7738607577921,186.40746080788404,0.7901806152143537,0.7911048915564259,-1066
1309,2020-08-02,2020,241218,241218,402328924.38333327,3781852.6666666707,190269,0,39,0.8403684633816716,45642260,5950592089,242009,242007,82462,324471,357196624.90001166,3776890.749999747,191133,0,38,0.6293228054279087,5214311128,-791,-789,45132299.48332161,4961.9166669235565,-864,0,1,0.21104565795376284,-5168668868,1667.905895842488,1475.9764176243318,191.9294782181562,0.7887844190732035,0.7897764132738865,-864
1310,2020-08-03,2020,237962,237962,402718865.13333315,3756817.4166666595,186514,0,40,0.834196216202587,45144126,5962135858,238672,238672,80065,318737,357772850.3500086,3752285.499999585,187389,0,41,0.6263094651703403,5224378781,-710,-710,44946014.78332454,4531.916667074431,-875,0,-1,0.20788675103224674,-5179234655,1692.366281731256,1499.0147581199662,193.35152361128985,0.7837974130323329,0.7851318964939331,-875
1311,2020-08-04,2020,234269,234269,402860118.1000004,3749237.3333333293,184155,0,83,0.8371615535986403,44997468,5969770045,235948,235948,74632,310580,358088215.11667866,3743036.1166663254,185055,0,83,0.6351600231824275,5233370463,-1679,-1679,44771902.98332173,6201.21666700393,-900,0,0,0.20200153041621283,-5188372995,1719.6475765039352,1517.657344485559,201.99023201837622,0.7860835193730284,0.7843041687151406,-900
1312,2020-08-05,2020,243616,243616,403499144.1500002,3770404.7833333337,190854,0,38,0.8336931892814919,44867205,5980446818,244380,244380,73175,317555,358943696.13334507,3765816.866666351,191781,0,38,0.6435452126403226,5244157381,-764,-764,44555448.01665515,4587.9166669826955,-927,0,0,0.19014797664116934,-5199290176,1656.2916399169194,1468.7932569496074,187.49838296731195,0.7834214501510574,0.7847655290940339,-927
1313,2020-08-06,2020,249614,249614,403749926.06666636,3860864.300000001,195204,0,29,0.8326536171849339,44600348,5980542297,250464,250464,75866,326330,359451034.0500135,3855216.8666663216,196183,0,31,0.641157723776543,5249496594,-850,-850,44298892.01665288,5647.433333679568,-979,0,-2,0.1914958934083909,-5204896246,1617.497119819667,1435.140515403465,182.3566044162019,0.7820234441978414,0.7832782355947362,-979
1314,2020-08-07,2020,254255,254255,404441152.9833336,3876454.233333332,197986,0,23,0.8266346777841124,44450486,5986830619,255079,255079,76386,331465,360496041.78334475,3870297.0333330245,198948,0,23,0.6388879670553377,5255773210,-824,-824,43945111.19998884,6157.200000307523,-962,0,0,0.1877467107287747,-5211322724,1590.6910502579442,1413.2721305295408,177.41891972840335,0.7786906845489764,0.7799466047773435,-962
1315,2020-08-08,2020,252173,252173,404819251.3166666,3862767.5833333363,196950,0,37,0.8320557712364122,44346827,5989226004,253163,253163,81535,334698,361017821.1833463,3856561.3999996083,198030,0,37,0.6324985509324836,5262720531,-990,-990,43801430.13332033,6206.183333727997,-1080,0,0,0.19955722030392853,-5218373704,1605.323533116815,1426.029163753575,179.2943693632401,0.7810114484897273,0.7822233106733606,-1080
1316,2020-08-09,2020,252259,252259,405186139.05,3831726.650000001,196783,0,29,0.8305114981031397,44595944,5996049325,253048,253048,81501,334549,361565265.5833467,3826230.2166663557,197745,0,29,0.6315636872326618,5273682667,-789,-789,43620873.46665329,5496.433333645109,-962,0,0,0.19894781087047797,-5229086723,1606.2306559924523,1428.840637283625,177.39001870882726,0.7800831684895286,0.7814525307451551,-962
1317,2020-08-10,2020,245060,245060,405584347.7333332,3754436.4166666707,191817,0,196,0.8314331184199792,44943745,6007774554,246437,246437,85739,332176,362051591.9166825,3749891.1166662974,192825,0,196,0.617446775203505,5284787954,-1377,-1377,43532755.81665069,4545.300000373274,-1008,0,0,0.21398634321647425,-5239844209,1655.0410011153724,1469.1446167445736,185.89638437079884,0.7827348404472374,0.7824514987603323,-1008
1318,2020-08-11,2020,244494,244494,405307464.13333344,3767663.6166666676,192052,0,303,0.8353701931335733,45671672,6015360051,245240,245240,81589,326829,361863505.38334775,3763198.1666663047,192938,0,304,0.6290108894865517,5293073383,-746,-746,43443958.749985695,4465.450000362936,-886,0,-1,0.2063593036470216,-5247401711,1657.7399205433812,1475.54846429354,182.19145624984117,0.7855080288268833,0.78673136519328,-886
1319,2020-08-12,2020,246397,246397,405943639.1166667,3821473.8666666695,193152,0,222,0.8344906796754821,46007775,6023545772,247236,247236,76434,323670,362629366.9000075,3815529.7666663514,194135,0,224,0.6390953749189048,5302672010,-839,-839,43314272.21665919,5944.10000031814,-983,0,-2,0.1953953047565773,-5256664235,1647.5185944498783,1466.733675112069,180.78491933780924,0.7839056482018856,0.785221407885583,-983
1320,2020-08-13,2020,248763,248763,406583632.93333364,3844080.2333333357,193902,0,122,0.8311324433295949,45402110,6031833497,249571,249571,77490,327061,363478537.75000834,3839198.149999676,194892,0,122,0.6359455881318709,5311999388,-808,-808,43105095.18332529,4882.083333659917,-990,0,0,0.19518685519772405,-5266597278,1634.4216500578207,1456.4133563194775,178.00829373834313,0.7794647917897758,0.7809080381935402,-990
1321,2020-08-14,2020,251964,251964,407237881.00000006,3874317.8833333366,195324,0,57,0.8253440967757297,44373122,6040418609,252758,252758,77390,330148,364334695.28334415,3869794.2166662477,196194,0,57,0.6340520009208043,5319335374,-794,-794,42903185.71665591,4523.666667088866,-870,0,0,0.19129209585492546,-5274962252,1616.2542307631252,1441.4368498063134,174.8173809568118,0.7752059818069248,0.7762128201679076,-870
1322,2020-08-15,2020,250240,250240,407792730.73333323,3881117.9833333357,194220,0,105,0.8255195012787719,44100754,6048926455,250960,250960,80509,331469,365026517.71667653,3875927.8999996297,195036,0,105,0.6270691980245479,5328013624,-720,-720,42766213.0166567,5190.083333706018,-816,0,0,0.19845030325422408,-5283912870,1629.6065006926679,1454.5207113351792,175.0857893574887,0.7761349104859335,0.7771597067261715,-816
1323,2020-08-16,2020,258905,258905,408586087.1000001,3959350.383333337,200762,0,243,0.8300689442073346,44853946,6056790237,259770,259770,78312,338082,366052299.48332554,3953689.4833331206,201742,0,246,0.6403091557669381,5339047388,-865,-865,42533787.61667454,5660.900000216439,-980,0,-3,0.18975978844039643,-5294193442,1578.131311098666,1409.1400064800614,168.99130461860454,0.7754272802765493,0.7766177772645032,-980
1324,2020-08-17,2020,253417,253417,409074656.3999997,3914241.200000002,196686,0,90,0.827059747372907,44570205,6067041836,254221,254221,86718,340939,366697073.4333478,3909499.6499996623,197603,0,90,0.6190227577367222,5352689713,-804,-804,42377582.96665186,4741.5500003397465,-917,0,0,0.20803698963618478,-5308119508,1614.2352580923919,1442.4342341244344,171.80102396795746,0.7761357762107515,0.7772882649348402,-917
1325,2020-08-18,2020,251082,251082,409492185.3166665,3885768.833333334,195137,0,39,0.8246150659943758,44228611,6075139083,251820,251820,80960,332780,367341046.183342,3881033.7999997446,195930,0,39,0.6259991586032784,5359229711,-738,-738,42151139.133324504,4735.033333589323,-793,0,0,0.19861590739109747,-5315001100,1630.9101620851613,1458.7445245943213,172.16563749084003,0.7771843461498634,0.7780557541100787,-793
1326,2020-08-19,2020,254174,254174,409997118.99999964,3924081.016666664,197446,0,144,0.8263945171418003,44760217,6081651401,254958,254958,80624,335582,368017303.53334606,3919026.283332926,198369,0,144,0.6302334451788275,5370280957,-784,-784,41979815.466653585,5054.733333737589,-923,0,0,0.19616107196297283,-5325520740,1613.056878358918,1443.4428554246035,169.61402293431456,0.7768143083084816,0.7780457957781282,-923
1327,2020-08-20,2020,254541,254541,410512760.91666657,3931762.916666665,196883,0,83,0.8242837106792223,45258523,6092095110,255454,255454,80084,335538,368644372.66667753,3925773.083333148,197804,0,83,0.6291656980729456,5378642676,-913,-913,41868388.24998903,5989.833333516959,-921,0,0,0.1951180126062767,-5333384153,1612.7569268474099,1443.0949316380934,169.6619952093165,0.7734824645145576,0.7743233615445442,-921
1328,2020-08-21,2020,251033,251033,410424805.3333331,3923263.1166666634,195144,0,38,0.8283134089940363,45192451,6090863115,251834,251834,80979,332813,368750447.683342,3917845.3833330516,195987,0,39,0.6283889150964779,5379621840,-801,-801,41674357.649991095,5417.733333611861,-843,0,-1,0.1999244938975584,-5334429389,1634.9436342366664,1464.2599795235828,170.68365471308357,0.7773639322320173,0.7782388398707085,-843
1329,2020-08-22,2020,253753,253753,410970157.6000004,3935320.35,196712,0,25,0.8305320528230205,46255854,6099614845,254539,254539,79779,334318,369370343.31667566,3929135.699999664,197651,0,25,0.6344049677253442,5388022608,-786,-786,41599814.28332472,6184.650000336114,-939,0,0,0.1961270850976763,-5341766754,1619.5676803821054,1451.134573942208,168.43310643989753,0.7752105393827856,0.7765057613960925,-939
1330,2020-08-23,2020,254798,254798,411450707.45000064,3955501.8166666673,198078,0,69,0.8349555334029306,45997368,6108924917,255457,255457,79659,335116,370037541.2166777,3950983.166666301,198893,0,69,0.6382864440969757,5397990527,-659,-659,41413166.23332292,4518.650000366382,-815,0,0,0.19666908930595495,-5351993159,1614.811369987208,1448.5316167365847,166.27975325062334,0.7773922872236045,0.7785772165178484,-815
1331,2020-08-24,2020,251954,251954,411955870.16666627,3936872.6333333375,194825,0,88,0.8290005318431151,45234753,6119854293,252683,252683,82992,335675,370665519.03334546,3931419.183332977,195627,0,88,0.6257659938928983,5410136969,-729,-729,41290351.13332081,5453.450000360608,-802,0,0,0.20323453795021673,-5364902216,1635.0439769428795,1466.9191003484423,168.12487659443718,0.7732562293116998,0.7741992931855328,-802
1332,2020-08-25,2020,245061,245061,412320389.4333332,3881496.133333337,191602,0,37,0.838440225086815,44756217,6128618778,245756,245756,79266,325022,371141150.6166774,3876255.583332916,192416,0,37,0.6358400354437613,5419729381,-695,-695,41179238.816655815,5240.550000421237,-814,0,0,0.2026001896430537,-5374973164,1682.5214515297548,1510.2017880201395,172.31966350961534,0.781854313823905,0.7829554517488891,-814
1333,2020-08-26,2020,246619,246619,412324296.70000035,3846069.800000004,194015,0,50,0.8405962233242367,44528075,6131737802,247350,247350,77672,325022,371213822.5333473,3840842.216666188,194905,0,50,0.6417873251656839,5428139457,-731,-731,41110474.16665304,5227.583333815914,-890,0,0,0.19880889815855274,-5383611382,1671.9080715597759,1500.7633819824027,171.14468957737313,0.7866993216256655,0.7879725085910653,-890
1334,2020-08-27,2020,246859,246859,412511924.88333374,3838305.383333333,193381,0,26,0.8341401366772137,44171788,6137236330,247606,247606,79356,326962,371524784.6666836,3833737.3999998868,194190,0,21,0.6332570757458018,5435237335,-747,-747,40987140.21665013,4567.983333446085,-809,0,5,0.20088306093141184,-5391065547,1671.042679761863,1500.4676165629412,170.57506319892173,0.7833662131014061,0.7842701711590188,-809
1335,2020-08-28,2020,254138,254138,413138025.15000033,3927710.883333333,196874,0,28,0.8276448228914998,44184715,6143489242,254755,254755,75573,330328,372267869.26667464,3922701.4833329944,197527,0,28,0.639412947131335,5436262081,-617,-617,40870155.883325696,5009.400000338443,-653,0,0,0.18823187576016476,-5392077366,1625.6444339295986,1461.2779700758558,164.36646385374274,0.7746736025309084,0.7753606406154934,-653
1336,2020-08-29,2020,250920,250920,413159268.3000002,3939093.2833333337,194301,0,38,0.8296150167384028,43932063,6144762566,251391,251391,79877,331268,372490157.5166771,3934269.6499995925,194873,0,38,0.6307611963727222,5445506716,-471,-471,40669110.78332311,4823.633333741222,-572,0,0,0.19885382036568056,-5401574653,1646.5776673840276,1481.7163602383423,164.86130714568526,0.7743543758967002,0.775178904574945,-572
1337,2020-08-30,2020,254097,254097,413617304.433334,3902194.550000001,197216,0,40,0.8294273446754573,43899058,6151264327,254692,254692,79052,333744,372962256.7666778,3896979.1666662777,197999,0,40,0.6347679658660559,5449811665,-595,-595,40655047.666656196,5215.383333723526,-783,0,0,0.19465937880940143,-5405912607,1627.7929469192238,1464.3658095530202,163.42713736620362,0.7761445432256185,0.7774056507467844,-783
1338,2020-08-31,2020,257337,257337,414034838.6333339,3957155.1833333354,198720,0,63,0.8302692578214567,44064622,6157268285,257878,257878,84246,342124,373518739.3500154,3952174.6166663277,199429,0,63,0.6273982532648944,5457642959,-541,-541,40516099.28331852,4980.566667007748,-709,0,0,0.20287100455656226,-5413578337,1608.9207484090275,1448.4319691870396,160.4887792219879,0.7722169761829818,0.7733463110463087,-709
1339,2020-09-01,2020,260362,260362,414392096.7666665,4083947.4833333306,201228,0,51,0.833961945291557,44204874,6158065813,260893,260893,81069,341962,373984722.33334506,4078843.866666509,201867,0,51,0.6376995104719277,5463156039,-531,-531,40407374.43332142,5103.616666821763,-639,0,0,0.19626243481962924,-5418951165,1591.5997602056616,1433.4793280515194,158.12043215414224,0.772877762499904,0.7737539910997996,-639
1340,2020-09-02,2020,265725,265725,415211740.28333294,4057109.3333333377,203563,0,131,0.8276300686800256,44236621,6167637655,266157,266157,81238,347395,374940167.4166821,4051478.9499996956,204212,0,131,0.6356050029505323,5468817946,-432,-432,40271572.86665082,5630.383333642036,-649,0,0,0.1920250657294933,-5424581325,1562.5618224981954,1408.7180401668268,153.84378233136863,0.7660664220528742,0.7672614284050391,-649
1341,2020-09-03,2020,260914,260914,415214382.96666634,4004893.6333333296,200731,0,230,0.8264830557195094,44263530,6150601593,261559,261558,89237,350796,375161372.0833458,3999793.766666335,201547,0,232,0.6180372638228563,5460298927,-645,-644,40053010.88332057,5099.866666994523,-816,0,-2,0.20844579189665313,-5416035397,1591.3840689524761,1434.3333871773975,157.0506817750786,0.7693377894631948,0.7705603707003009,-816
1342,2020-09-04,2020,269148,269148,416101327.9333328,4097490.2166666677,205913,0,180,0.8187651403688674,44493114,6162022183,269595,269595,82159,351754,376133273.0666758,4093505.249999539,206448,0,180,0.6287689692228028,5465470252,-447,-447,39968054.86665702,3984.966667128727,-535,0,0,0.1899961711460646,-5420977138,1545.994500918947,1395.1789649907298,150.8155359282173,0.7650549140249974,0.7657708785400322,-535
1343,2020-09-05,2020,270532,270532,416455306.5166675,4135720.2166666626,206658,0,180,0.8223685183268519,44475094,6168830882,271000,271000,86676,357676,376554404.0166798,4131169.0666662687,207308,0,180,0.6244478242878939,5476458678,-468,-468,39900902.49998766,4551.150000393856,-650,0,0,0.19792069403895796,-5431983584,1539.3938850733646,1389.4996458180067,149.8942392553579,0.7638948442328449,0.7649741697416974,-650
1344,2020-09-06,2020,268949,268949,417120508.0666668,4129140.0666666683,206664,0,150,0.8283466382102171,44357207,6175775627,269457,269457,86736,356193,377380575.1166761,4124523.566666482,207399,0,150,0.6282605216834706,5485303446,-508,-508,39739932.94999069,4616.5000001862645,-735,0,0,0.20008611652674657,-5440946239,1550.9279010766606,1400.5224400059233,150.40546107073737,0.7684133423065339,0.7696923813447043,-735
1345,2020-09-07,2020,267581,267581,417564157.70000035,4052377.4666666687,205012,0,80,0.8218782350017387,45018209,6185116251,268210,268210,91109,359319,377911694.4166787,4047749.149999629,205778,0,79,0.6151720337638735,5497499758,-629,-629,39652463.28332162,4628.316667039879,-766,0,1,0.2067062012378652,-5452481549,1560.5149756522337,1409.0141844699256,151.50079118230815,0.766168001464977,0.7672271727377801,-766
1346,2020-09-08,2020,259682,259682,417627826.6166668,4014474.0499999984,196369,0,84,0.8132215555949202,45035099,6189408333,260247,260247,89985,350232,378117037.4666798,4009481.833332931,197090,0,84,0.6059469151876484,5502546952,-565,-565,39510789.14998698,4992.21666706726,-721,0,0,0.20727464040727173,-5457511853,1608.2278579827127,1452.916027722432,155.31183026028066,0.7561902634760976,0.7573190084804051,-721
1347,2020-09-09,2020,261137,261137,418259644.9666663,4034282.76666667,198758,0,33,0.8175976594661044,44460015,6195046772,261572,261572,81480,343052,378805997.46667814,4030007.566666416,199315,0,26,0.6247944917971673,5507784281,-435,-435,39453647.49998814,4275.200000253972,-557,0,7,0.19280316766893713,-5463324266,1601.6866432817496,1448.1901635751462,153.4964797066034,0.7611253862914868,0.7619890508158366,-557
1348,2020-09-10,2020,259324,259324,418933864.20000005,4013825.8833333342,196041,0,40,0.8103569280128333,45262181,6203016381,260413,260413,81525,341938,379625591.7000109,4010069.8333329023,196693,0,40,0.6170650819739235,5516202593,-1089,-1089,39308272.49998915,3756.0500004319474,-652,0,0,0.1932918460389098,-5470940412,1615.4843523931454,1457.7827977098336,157.70155468331177,0.7559693665067637,0.7553117547895074,-652
1349,2020-09-11,2020,255748,255748,419045562.183333,3959396.4,197130,0,38,0.8301374790809705,46226386,6210135380,256449,256449,84385,340834,379775588.1666749,3955015.9333328456,197905,0,33,0.62646038834154,5522453117,-701,-701,39269974.01665807,4380.466667154338,-775,0,5,0.2036770907394304,-5476226731,1638.5096352007952,1480.9010297044438,157.6086054963514,0.7707978166007163,0.7717128941816892,-775
1350,2020-09-12,2020,253486,253486,418869971.2000002,3945206.833333331,196517,0,44,0.8303141001869928,46342960,6208637904,254097,254097,83986,338083,379748586.9000139,3939945.3166662324,197310,0,33,0.6258788522344991,5528637076,-611,-611,39121384.2999863,5261.516667098738,-793,0,11,0.20443524795249368,-5482294116,1652.4382853490931,1494.5024415873227,157.93584376177046,0.7752578051647823,0.776514480690445,-793
1351,2020-09-13,2020,252692,252692,419290405.01666707,3927469.1000000015,195178,0,35,0.8277863960869362,46306071,6220804134,253456,253456,81062,334518,380221025.56667423,3923137.949999485,196066,0,35,0.6291948415332006,5536335510,-764,-764,39069379.449992836,4331.150000516325,-888,0,0,0.19859155455373556,-5490029439,1659.2943386283184,1500.1460828178233,159.14825581049513,0.7723948522311747,0.7735701660248722,-888
1352,2020-09-14,2020,257956,257956,419958364.2999996,3988588.5000000023,196325,0,27,0.8176743320566301,46243513,6233553286,265153,265153,81708,346861,380973591.3500196,3989332.8499994827,199595,0,25,0.6187608292658956,5548614437,-7197,-7197,38984772.94998002,-744.3499994804151,-3270,0,2,0.1989135027907345,-5502370924,1628.0232454372049,1436.8066412600256,191.2166041771793,0.7610794088914389,0.7527540702914921,-3270
1353,2020-09-15,2020,260448,260448,420390382.4666672,3992888.200000002,196635,0,30,0.8154871605848387,46565974,6240239787,261016,261016,86855,347871,379888060.51667655,3988587.699999565,197335,0,30,0.6133969201226903,5507711413,-568,-568,40502321.94999063,4300.500000437256,-700,0,0,0.2020902404621484,-5461145439,1614.104859575298,1455.4205892231762,158.68427035212176,0.7549875598967932,0.756026450485794,-700
1354,2020-09-16,2020,262362,262362,421040035.7000006,3992684.916666666,199951,0,29,0.820644758006114,46335024,6251976958,262852,262852,84018,346870,380558214.9166775,3988100.4499995233,200594,0,31,0.6233026782368075,5510119014,-490,-490,40481820.78332311,4584.466667142697,-643,0,-2,0.1973420797693065,-5463783990,1604.805710049476,1447.8041442206165,157.00156582885938,0.7621187519534078,0.7631442789098047,-643
1355,2020-09-17,2020,254798,254798,421401074.1499999,3981613.566666664,195291,0,101,0.8254421149302585,46882858,6259342728,255248,255248,87021,342269,381045568.66667736,3977349.1166661372,195851,0,101,0.6167634229217354,5520271331,-450,-450,40355505.48332256,4264.450000526849,-560,0,0,0.20867869200852318,-5473388473,1653.8633511644516,1492.8444832738253,161.01886789062632,0.7664542107865839,0.7672969034037486,-560
1356,2020-09-18,2020,253834,253834,421637850.9333332,3969218.41666667,195194,0,29,0.8251179904977263,47243212,6267558962,254429,254429,82094,336523,381400468.35001004,3964955.7999994582,195924,0,31,0.6253539876917797,5530549661,-595,-595,40237382.58332318,4262.616667211521,-730,0,-2,0.19976400280594653,-5483306449,1661.0771249451736,1499.0447957976883,162.03232914748537,0.7689828785741862,0.7700537281520582,-730
1357,2020-09-19,2020,257564,257564,422072414.8166672,4031454.733333336,197010,0,32,0.8193109285459149,47269975,6275662014,258077,258077,79358,337435,381942316.26667595,4026484.0999994054,197676,0,32,0.6280765184405886,5539714765,-513,-513,40130098.54999125,4970.633333930746,-666,0,0,0.19123441010532627,-5492444790,1638.7088832937336,1479.9548827159178,158.75400057781576,0.7648972682517743,0.7659574468085106,-666
1358,2020-09-20,2020,255154,255154,422559454.71666616,3941337.8833333314,195606,0,133,0.8203359539728946,47207424,6285904872,255538,255538,81111,336649,382517773.71667767,3937225.299999469,196155,0,133,0.624190180276789,5550663588,-384,-384,40041680.9999885,4112.58333386248,-549,0,0,0.19614577369610564,-5503456164,1656.0957489071939,1496.9115110734124,159.18423783378148,0.766619374965707,0.7676157753445672,-549
1359,2020-09-21,2020,254103,254103,423158884.71666616,3940057.25,193124,0,219,0.8225444012860931,47019877,6299065036,254481,254481,86474,340955,383143973.0166798,3935731.049999778,193677,0,219,0.6151750230968953,5561548313,-378,-378,40014911.69998634,4326.200000221841,-553,0,0,0.20736937818919776,-5514528436,1665.3045604210347,1505.5897022437032,159.7148581773315,0.7600225105567427,0.7610666415174414,-553
1360,2020-09-22,2020,257370,257370,423868514.9999998,3971738.6833333336,195724,0,48,0.8220305396899401,47728715,6310324612,257928,257928,79894,337822,384014200.3000171,3967181.2833330836,196262,0,48,0.6284789030909796,5576258318,-558,-558,39854314.6999827,4557.400000249967,-538,0,0,0.19355163659896046,-5528529603,1646.9227765473825,1488.842623910615,158.08015263676748,0.7604771340871119,0.7609177755032412,-538
1361,2020-09-23,2020,252524,252524,424529989.1999998,3969348.3166666655,194168,0,32,0.8294459140517348,48324942,6320251074,252986,252986,81115,334101,384656211.6833401,3965927.7833328415,194600,0,32,0.6287230508139796,5586004440,-462,-462,39873777.51665974,3420.533333824016,-432,0,0,0.20072286323775523,-5537679498,1681.147095721594,1520.4644197044108,160.6826760171832,0.7689090937891052,0.7692125255943016,-432
1362,2020-09-24,2020,252014,252014,424860338.8833333,3959741.7666666657,195403,0,27,0.8382232733102133,47798493,6326717063,252473,252473,79212,331685,385132974.4333449,3955958.766666272,195939,0,27,0.6392299923119863,5599236365,-459,-459,39727364.449988425,3783.000000393484,-536,0,0,0.198993280998227,-5551437872,1685.8600668349113,1525.4422232608829,160.41784357402844,0.7753656542890475,0.7760790262721162,-536
1363,2020-09-25,2020,249174,249174,425412340.2833331,3922613.549999999,192755,0,130,0.8342764493887799,47236681,6336940306,249548,249548,79247,328795,385832844.7500139,3918470.3666662117,193271,0,130,0.6346629358718918,5611192003,-374,-374,39579495.533319235,4143.183333787136,-516,0,0,0.19961351351688805,-5563955322,1707.2902481130982,1546.1267762114458,161.16347190165243,0.7735758947562748,0.7744842675557407,-516
1364,2020-09-26,2020,246688,246688,425311203.34999985,3901247.0666666664,191145,0,36,0.8322496432740955,47608983,6340075567,247138,247138,78987,326125,385794514.86667717,3896358.816666135,191726,0,36,0.6322177079340753,5620709904,-450,-450,39516688.48332268,4888.2500005313195,-581,0,0,0.20003193534002017,-5573100921,1724.0854980785439,1561.0489478213676,163.03655025717626,0.7748451485276949,0.7757851888418617,-581
1365,2020-09-27,2020,247608,247608,425837399.6500003,3889786.1499999985,191291,0,32,0.8292300733417339,47437000,6352152081,248091,248091,78119,326210,386472741.7666811,3885658.3333328036,191898,0,30,0.6319947273228816,5627548134,-483,-483,39364657.8833192,4127.816667194944,-607,0,2,0.1972353460188523,-5580111134,1719.8046898727032,1557.7862226629788,162.01846720972435,0.7725558140286259,0.7734984340423474,-607
1366,2020-09-28,2020,251848,251848,426545918.5500005,3933707.5999999987,193329,0,39,0.8262602839808123,47444063,6365843557,252303,252303,78291,330594,387270818.5500108,3928990.8999997526,193997,0,41,0.6322256302292226,5641547043,-455,-455,39275099.99998969,4716.700000246055,-668,0,-2,0.19403465375158968,-5594102980,1693.6641091054942,1534.9433758219711,158.72073328352303,0.7676415933420159,0.7689048485352928,-668
1367,2020-09-29,2020,249810,249810,426656866.7666665,3905638.25,193647,0,39,0.8358072134822455,47217176,6372563549,250418,250418,78889,329307,387469360.8333424,3900839.816666212,194351,0,39,0.6369983024958414,5652587271,-608,-608,39187505.9333241,4798.433333788067,-704,0,0,0.19880891098640407,-5605370095,1707.9254904394,1547.2903738283285,160.63511661107145,0.775177134622313,0.7761063501824949,-704
1368,2020-09-30,2020,244628,244628,426556655.4166667,3837067.45,190259,0,26,0.8414531451837074,47465341,6379018253,245283,245283,80892,326175,387489496.4000147,3832503.3999994583,191071,0,26,0.6347819422089355,5663694176,-655,-655,39067159.01665199,4564.0500005418435,-812,0,0,0.20667120297477193,-5616228835,1743.6951428972427,1579.7649914589053,163.93015143833736,0.7777482544925356,0.7789818291524484,-812
1369,2020-10-01,2020,237785,237785,426566758.88333374,3777975.599999996,184684,0,40,0.8376768929915687,47798015,6387845271,238275,238275,79241,317516,387569716.5166839,3773545.2999995025,185306,0,40,0.6302013126897563,5671105609,-490,-490,38997042.366649866,4430.300000493415,-622,0,0,0.20747558030181235,-5623307594,1793.9178622845584,1626.5647529815712,167.35310930298715,0.7766848203208782,0.7776980379813241,-622
1370,2020-10-02,2020,246511,246511,426866016.08333284,3859004.499999996,189541,0,33,0.8336382554936689,48166117,6396567297,247071,247071,74706,321777,388019990.71667695,3854895.8499994967,190227,0,33,0.6418793139348137,5680350871,-560,-560,38846025.366655886,4108.650000499096,-686,0,0,0.1917589415588552,-5632184754,1731.6307024162525,1570.4797030678508,161.15099934840168,0.7688946943544102,0.7699284820962395,-686
1371,2020-10-03,2020,250609,250609,427229263.13333327,3900206.6833333285,191077,0,32,0.8288449337414068,48982865,6408814750,251147,251147,75862,327009,388390643.5500116,3895027.266666177,191733,0,33,0.6380344271870279,5689069943,-538,-538,38838619.58332169,5179.416667151265,-656,0,-1,0.19081050655437892,-5640087078,1704.7642468280599,1546.467381852109,158.29686497595094,0.762450670167472,0.7634293859771369,-656
1372,2020-10-04,2020,248922,248922,427408192.9833334,3839366.48333333,190174,0,255,0.8308626798756239,49728174,6417425969,249448,249448,81443,330891,388690182.2500117,3833684.6999997026,190900,0,255,0.628282425330406,5703636009,-526,-526,38718010.73332173,5681.783333627507,-726,0,0,0.20258025454521789,-5653907835,1717.0366338987048,1558.201237332076,158.8353965666288,0.7639903262869493,0.7652897597896154,-726
1373,2020-10-05,2020,244774,244774,427624793.9666668,3835706.1166666667,189103,0,77,0.8338794152973763,49472376,6431522539,245481,245481,87469,332950,388959006.5333413,3830908.4999995716,189829,0,77,0.6162486859888909,5717726374,-707,-707,38665787.43332553,4797.616667095106,-726,0,0,0.21763072930848537,-5668253998,1747.0188580758856,1584.4770329815394,162.54182509434622,0.7725616282775132,0.7732940634916755,-726
1374,2020-10-06,2020,241809,241809,428076715.6833334,3870662.8000000026,186227,0,80,0.831292466368084,49778589,6439507695,242362,242362,75827,318189,389577707.1833435,3866319.249999516,186966,0,81,0.6349245259892682,5731456058,-553,-553,38499008.49998987,4343.55000048643,-739,0,-1,0.19636794037881578,-5681677469,1770.309275847191,1607.420747408189,162.8885284390019,0.7701408963272666,0.7714328153753476,-739
1375,2020-10-07,2020,246697,246697,428942025.216667,3906336.2333333376,191143,0,88,0.8419599751922405,49710588,6453971112,247358,247358,73110,320468,390449815.916677,3901526.0999996504,191904,0,88,0.651634484566326,5739675380,-661,-661,38492209.29999,4810.133333687205,-761,0,0,0.19032549062591453,-5689964792,1738.7403382151667,1578.4806471457441,160.25969106942262,0.7748087735156893,0.7758148109218218,-761
1376,2020-10-08,2020,243374,243374,429532937.3000002,3908079.7666666727,188245,0,107,0.8395391455126676,49696247,6465436759,243992,243992,75376,319368,391157773.0000155,3903061.749999502,188982,0,108,0.6434865108589403,5753781731,-618,-618,38375164.29998469,5018.01666717045,-737,0,-1,0.19605263465372735,-5704085484,1764.908894540913,1603.1581896128378,161.75070492807527,0.7734803224666562,0.7745417882553526,-737
1377,2020-10-09,2020,253948,253948,429891563.70000005,3922791.283333329,196538,0,252,0.8400263045977913,49763625,6473867725,254593,254593,75287,329880,391652723.56667805,3917749.349999548,197304,0,254,0.6503182975627438,5767005816,-645,-645,38238840.133322,5041.933333781082,-766,0,-2,0.18970800703504742,-5717242191,1692.8330355033315,1538.3483582293231,154.4846772740084,0.77393009592515,0.7749781023044624,-766
1378,2020-10-10,2020,245908,245908,429701440.3500004,3862197.116666672,189805,0,187,0.8328602566813597,48378359,6476564858,246368,246368,84128,330496,391427555.03334427,3858725.5999995586,190479,0,187,0.6226338594113111,5776099624,-460,-460,38273885.31665611,3471.5166671131738,-674,0,0,0.21022639727004855,-5727721265,1747.4073244872081,1588.792193114951,158.6151313722571,0.7718537013842576,0.7731482984803221,-674
1379,2020-10-11,2020,248804,248804,429829190.53333306,3810419.699999995,191596,0,77,0.8322052700117363,49886156,6488470231,249212,249212,78624,327836,391600495.9500128,3805629.6999995005,192163,0,77,0.6344666235556794,5783307700,-408,-408,38228694.58332026,4790.000000494532,-567,0,0,0.19773864645605688,-5733421544,1727.5815120871573,1571.3548944272861,156.22661765987118,0.7700680053375347,0.7710824518883521,-567
1380,2020-10-12,2020,242814,242814,429430060.30000085,3780000.0166666606,186337,0,52,0.8309982126236544,49721445,6472885028,243582,243582,83785,327367,391543385.36667395,3776396.8333328785,187218,0,52,0.6203252007685549,5773005801,-768,-768,37886674.9333269,3603.1833337820135,-881,0,0,0.21067301185509946,-5723284356,1768.555603466031,1607.439734326321,161.11586913970996,0.7674063274769989,0.7686035913983792,-881
1381,2020-10-13,2020,239210,239210,429556017.83333343,3756789.433333327,183833,0,61,0.8347142677981688,50223615,6484630899,239921,239921,78248,318169,391709512.98334455,3752567.1333328937,184564,0,61,0.6310011346171436,5783489660,-711,-711,37846504.84998888,4222.300000433344,-731,0,0,0.20371313318102524,-5733266045,1795.7276779120164,1632.660388141699,163.0672897703173,0.7685004807491326,0.7692698846703707,-731
1382,2020-10-14,2020,241439,241439,430019255.6666663,3788435.383333342,186349,0,77,0.8368780520131376,50707738,6497058692,242137,242137,76131,318268,392224011.6333431,3783577.833332918,187201,0,78,0.6385216232860396,5795706514,-698,-698,37795244.03332323,4857.550000424031,-852,0,-1,0.19835642872709802,-5744998776,1781.0679122538875,1619.8433598885883,161.22455236529913,0.771826424065706,0.7731201757682634,-852
1383,2020-10-15,2020,244717,244717,430673104.86666685,3828230.366666668,189410,0,86,0.8391407217316338,50404415,6511220748,245570,245570,75869,321439,392886105.8500146,3824024.966666205,190219,0,86,0.6425200426830687,5809097676,-853,-853,37786999.01665223,4205.40000046324,-809,0,0,0.19662067904856506,-5758693261,1759.8822511990047,1599.894554913119,159.9876962858857,0.7739960852740104,0.7746019464918353,-809
1384,2020-10-16,2020,247249,247249,431070785.43333375,3847432.03333333,191508,0,77,0.8404078479589394,50673803,6519801141,247960,247960,76729,324689,393318326.6833389,3842347.0166662266,192354,0,77,0.6438099227260542,5818107582,-711,-711,37752458.749994874,5085.016667103395,-846,0,0,0.19659792523288522,-5767433779,1743.4682665383227,1586.2168361160625,157.25143042226023,0.7745552054811142,0.7757460880787224,-846
1385,2020-10-17,2020,243647,243647,431252151.05000037,3836987.3833333366,188800,0,73,0.8381510956424665,51172322,6531318944,243988,243988,79702,323690,393628680.8666754,3830986.9333328176,189430,0,73,0.6337792332169623,5830885687,-341,-341,37623470.18332499,6000.450000518933,-630,0,0,0.2043718624255042,-5779713365,1769.9875272422823,1613.3116418294153,156.67588541286705,0.7748915439139411,0.7763906421627293,-630
1386,2020-10-18,2020,241395,241395,431443712.8499998,3808289.6833333313,187476,0,219,0.8394912902089945,50939992,6538170113,242013,242013,77058,319071,393955799.3666768,3804674.9999995106,188270,0,221,0.6392370350172814,5843603156,-618,-618,37487913.48332298,3614.6833338206634,-794,0,-2,0.20025425519171314,-5792663164,1787.2934934443538,1627.8290809447294,159.46441249962436,0.7766358043870005,0.777933416799924,-794
1387,2020-10-19,2020,244564,244564,432092106.84999967,3841481.4833333325,188222,0,105,0.8316350730279185,51315360,6550650296,248645,248645,76360,325005,394719001.383348,3838794.549999523,189585,0,109,0.6313041337825619,5853694629,-4081,-4081,37373105.46665168,2686.9333338094875,-1363,0,-4,0.2003309392453566,-5802379269,1766.785409340703,1587.4801479352006,179.30526140550228,0.7696226754550956,0.7624726015001307,-1363
1388,2020-10-20,2020,246103,246103,432536684.03333354,3833994.783333337,188755,0,37,0.8295307249403711,51130472,6562873884,246898,246898,78781,325679,395175040.5333462,3829109.399999504,189628,0,37,0.6304981285253172,5863564063,-795,-795,37361643.499987364,4885.383333832957,-873,0,0,0.1990325964150539,-5812433591,1757.54332142775,1600.559909490341,156.98341193740907,0.7669756159006594,0.7680418634415832,-873
1389,2020-10-21,2020,245467,245467,432734433.6833335,3835132.5166666647,188565,0,61,0.8323970228177312,50786092,6573740789,246034,246034,78773,324807,395418964.3166821,3830330.9666662556,189308,0,61,0.6324740538227333,5874526428,-567,-567,37315469.366651416,4801.55000040913,-743,0,0,0.19992296899499795,-5823740336,1762.9026862402422,1607.1720344207797,155.73065181946254,0.7681887993090721,0.769438370306543,-743
1390,2020-10-22,2020,240306,240306,432882504.39999956,3804346.483333331,185618,0,126,0.8325842883656673,51069163,6583367293,240914,240914,79104,320018,395684327.6333437,3800083.866666235,186347,0,125,0.6283677793124152,5887220218,-608,-608,37198176.76665586,4262.616667096037,-729,0,1,0.20421650905325217,-5836151055,1801.3803417309578,1642.429778399527,158.95056333143066,0.7724234933792747,0.7735000871680351,-729
1391,2020-10-23,2020,245377,245377,433140841.5666668,3817777.266666671,189993,0,134,0.8359748468682889,50556955,6593427168,246054,246054,77351,323405,396039470.90001523,3813516.9666661704,190734,0,136,0.6375473477528099,5897865212,-677,-677,37101370.66665155,4260.3000005004,-741,0,-2,0.19842749911547908,-5847308257,1765.2055472463467,1609.563229616325,155.64231763002158,0.7742901738956789,0.7751713038601282,-741
1392,2020-10-24,2020,246281,246281,433146196.86666596,3827193.0500000026,189562,0,61,0.8281109789224517,50354298,6600239331,246880,246880,79906,326786,396049044.8666793,3823174.016666171,190349,0,61,0.6275789048490442,5906826026,-599,-599,37097151.99998665,4019.0333338314667,-787,0,0,0.20053207407340745,-5856471728,1758.747921547606,1604.2168051955578,154.53111635204823,0.7696980278624823,0.7710183084899547,-787
1393,2020-10-25,2020,247693,247693,433776604.2833327,3872216.633333331,189926,0,86,0.8244480062012246,50708152,6614800325,248414,248414,78774,327188,396694544.9666765,3867303.1333328616,190743,0,87,0.6275046762106182,5912286283,-721,-721,37082059.31665623,4913.500000469387,-817,0,-1,0.19694332999060638,-5861578131,1751.2671100246382,1596.9089703747634,154.35813964987483,0.7667798444041616,0.7678431972433115,-817
1394,2020-10-26,2020,251649,251649,434787073.533333,3904222.5999999996,192168,0,87,0.8244578758508869,50451073,6631014261,252571,252571,77558,330129,397756797.0666784,3902805.366666163,193262,0,88,0.6327465929985036,5927220944,-922,-922,37030276.4666546,1417.2333338367753,-1094,0,-1,0.19171128285238337,-5876769871,1727.7520416664997,1574.8316198877876,152.92042177871213,0.7636350631236365,0.7651789001904415,-1094
1395,2020-10-27,2020,250881,250881,435496179.53333265,3853192.7333333353,190965,0,114,0.8228323388379355,50096189,6645931231,251369,251369,80513,331882,398469540.4666804,3848967.0166661595,191583,0,114,0.624468937754976,5937358798,-488,-488,37026639.06665224,4225.716667175759,-618,0,0,0.19836340108295947,-5887262609,1735.867520989364,1585.1976197012377,150.6699012881263,0.7611776101020006,0.7621584204894001,-618
1396,2020-10-28,2020,244863,244863,435545233.2666666,3817340.716666669,187626,0,78,0.8270543120030386,49296369,6651905756,245394,245394,82163,327557,398573645.0166818,3812952.666666221,188294,0,78,0.6209789441227073,5951118247,-531,-531,36971588.2499848,4388.050000448246,-668,0,0,0.20607536788033132,-5901821878,1778.7302829201087,1624.2191945063114,154.51108841379732,0.7662488820279095,0.7673129742373489,-668
1397,2020-10-29,2020,247005,247005,436170126.3999997,3863570.466666666,189750,0,88,0.82825448877553,49833543,6664778695,247546,247546,77641,325187,399222975.10001093,3859528.9499995233,190408,0,88,0.6321900936999373,5957312356,-541,-541,36947151.29998875,4041.5166671425104,-658,0,0,0.1960643950755927,-5907478813,1765.8352114329657,1612.7223833146604,153.1128281183053,0.7682030728122913,0.7691822933919352,-658
1398,2020-10-30,2020,250896,250896,436438166.1999998,3860495.2833333355,193270,0,143,0.8372313627957391,50948365,6671804865,251444,251444,77643,329087,399549867.1166805,3856307.649999546,193927,0,145,0.6414473984083264,5972239607,-548,-548,36888299.08331931,4187.63333378965,-657,0,-2,0.19578396438741263,-5921291242,1739.5182314584522,1589.021281544521,150.4969499139313,0.7703191760729545,0.7712532412783761,-657
1399,2020-10-31,2020,248316,248316,435094162.2500004,3793438.666666668,188582,0,49,0.8187833244736548,50990859,6670900139,248919,248919,85146,334065,398455986.3333411,3788442.3833328965,189375,0,50,0.6119437833954411,5981791305,-603,-603,36638175.916659296,4996.283333771396,-793,0,-1,0.20683954107821367,-5930800446,1752.1793289598754,1600.745569174475,151.43375978540053,0.7594436121715878,0.7607896544659106,-793
1400,2020-11-01,2020,245979,245979,434582828.7499993,3789402.649999996,184715,0,43,0.812028669114031,51142939,6673147603,246740,246740,83433,330173,398115488.8833451,3785880.6166661736,185657,0,44,0.6091352109348734,5983825036,-761,-761,36467339.86665416,3522.033333822619,-942,0,-1,0.2028934581791576,-5932682097,1766.7476847617045,1613.5020218989428,153.24566286276172,0.7509380882107822,0.7524398151900786,-942
1401,2020-11-02,2020,244889,244889,434643530.63333255,3733008.400000001,183071,0,105,0.8097015382479404,50888379,6686963492,245456,245456,83270,328726,398267837.48334086,3729101.483332929,183833,0,105,0.6066663421816371,5987176334,-567,-567,36375693.14999169,3906.9166670716368,-762,0,0,0.20303519606630338,-5936287955,1774.8593470238866,1622.5630560399454,152.29629098394116,0.7475672651691174,0.748944821067727,-762
1402,2020-11-03,2020,239489,239489,433929753.00000024,3712600.8000000035,179470,0,246,0.8086676214773958,49710404,6687614853,240163,240163,84560,324723,397666555.8833456,3707989.2833328815,180198,0,248,0.5995602405742702,5997059692,-674,-674,36263197.116654634,4611.516667122021,-728,0,-2,0.20910738090312564,-5947349288,1811.898471328538,1655.8194055010372,156.07906582750093,0.7493872369920956,0.7503154107835095,-728
1403,2020-11-04,2020,245911,245911,434104213.8166676,3742992.9500000044,182210,0,232,0.7955154507118433,49807265,6695332477,246643,246643,78551,325194,397907735.43334985,3738403.4666661043,183029,0,228,0.6051649169418838,5999490532,-732,-732,36196478.38331777,4589.483333900105,-819,0,4,0.19035053376995947,-5949683267,1765.2899374841613,1613.2942570166185,151.9956804675428,0.7409591274892136,0.7420806590902641,-819
1404,2020-11-05,2020,243323,243323,434134841.73333335,3740636.5999999978,179706,0,226,0.7946186755875935,49825431,6702460280,243944,243944,80975,324919,398014471.3666795,3736924.8333328334,180440,0,226,0.5983614377737241,6006676389,-621,-621,36120370.36665386,3711.7666671643965,-734,0,0,0.1962572378138694,-5956850958,1784.1915549838418,1631.5813111479663,152.6102438358755,0.738549171266177,0.7396779588758076,-734
1405,2020-11-06,2020,248679,248679,434386443.23333395,3766156.399999996,181430,0,99,0.7837412889709223,49857111,6713156493,249340,249340,80775,330115,398230413.6500102,3762024.099999558,182225,0,100,0.5941384063129602,6017957286,-661,-661,36156029.58332372,4132.300000438001,-795,0,-1,0.1896028826579621,-5968100175,1746.7757359219474,1597.138099181881,149.63763674006645,0.7295750746946867,0.7308293895885136,-795
1406,2020-11-07,2020,236291,236291,434218130.08333343,3654254.566666668,174732,0,27,0.7929967709307587,49224068,6721029079,236733,236733,85956,322689,398146095.23334247,3650459.1833328633,175377,0,27,0.5837974024525161,6024592397,-442,-442,36072034.849990964,3795.3833338045515,-645,0,0,0.2091993684782426,-5975368329,1837.6414255444915,1681.8360567953875,155.805368749104,0.7394780165135363,0.7408219386397333,-645
1407,2020-11-08,2020,233345,233345,434055574.783334,3613956.0166666713,172355,0,29,0.7914632839786585,49084002,6727271309,233778,233778,82514,316292,398106475.3333417,3609160.749999525,173002,0,30,0.5868817421875987,6034474368,-433,-433,35949099.4499923,4795.266667146236,-647,0,-1,0.2045815417910598,-5985390366,1860.1451703843409,1702.92531946266,157.21985092168097,0.7386273543465683,0.7400268630923355,-647
1408,2020-11-09,2020,237664,237664,434739472.2999998,3697007.6833333354,175704,0,61,0.7900523428032856,49597087,6743185295,238198,238198,77641,315839,398825717.5500081,3693280.899999514,176374,0,61,0.5975766134011419,6046034710,-534,-534,35913754.749991655,3726.783333821222,-670,0,0,0.19247572940214375,-5996437623,1829.218864868048,1674.3453662499605,154.87349861808752,0.7392958125757372,0.7404512212529073,-670
1409,2020-11-10,2020,245371,245371,435301359.3166664,3820357.9499999974,187551,0,56,0.8176434868016189,50206141,6750704621,245856,245856,74557,320413,399435523.76668334,3816185.983332889,188170,0,57,0.6289632443128108,6058324482,-485,-485,35865835.549983084,4171.966667108238,-619,0,-1,0.1886802424888081,-6008118341,1774.0538177562403,1624.6726692319216,149.38114852431863,0.7643568310843579,0.7653667187296629,-619
1410,2020-11-11,2020,244775,244775,435915555.84999996,3813636.2999999993,185444,0,52,0.811414564395874,50225443,6757489762,245358,245358,75602,320960,400138689.4666784,3809487.4333328735,186205,0,52,0.6218936939182432,6069527274,-583,-583,35776866.38332158,4148.86666712584,-761,0,0,0.18952087047763078,-6019301831,1780.8826712286793,1630.8361229985505,150.0465482301288,0.7576100500459606,0.7589114681404315,-761
1411,2020-11-12,2020,244607,244607,436267776.8166674,3793248.9666666654,183345,0,27,0.805389870281717,50270780,6769889291,245203,245203,78316,323519,400634544.6500106,3788757.6666661967,184068,0,28,0.6121804283519714,6077797094,-596,-596,35633232.16665679,4491.300000468735,-723,0,-1,0.19320944192974565,-6027526314,1783.5457563220486,1633.8892454415752,149.65651088047343,0.7495492770035199,0.7506759705223834,-723
1412,2020-11-13,2020,244160,244160,436463015.9666667,3764848.183333334,181905,0,34,0.7991726736566183,51270961,6781228505,244705,244705,79373,324078,400928459.83334386,3760359.3999995347,182574,0,34,0.6049778139830491,6090718960,-545,-545,35534556.133322835,4488.783333799336,-669,0,0,0.1941948596735692,-6039447999,1787.6106486183924,1638.4154791824599,149.19516943593248,0.74502375491481,0.7460983633354448,-669
1413,2020-11-14,2020,243981,243981,436231577.2833335,3742832.4000000004,178941,0,33,0.7888892987568711,51903006,6787683430,244734,244733,80927,325661,400800536.7333467,3738620.1166661265,179847,0,33,0.5949990941500459,6101184405,-753,-752,35431040.54998678,4212.283333873842,-906,0,0,0.19389020460682516,-6049281399,1787.973560577805,1637.7053226714283,150.26823790637673,0.7334218648173423,0.7348672436196033,-906
1414,2020-11-15,2020,246366,246366,436627969.94999987,3764534.8999999966,180453,0,42,0.7912008962275635,51840647,6801737330,247051,247051,80926,327977,401170867.5500145,3761881.549999491,181231,0,43,0.5986273427709888,6110008825,-685,-685,35457102.39998537,2653.3500005058013,-778,0,-1,0.19257355345657468,-6058168178,1772.2736495701513,1623.8382663903992,148.43538317975208,0.7324590243783639,0.7335772775661705,-778
1415,2020-11-16,2020,250015,250015,436914971.2666665,3779502.9000000046,182137,0,31,0.7871567705937643,51457326,6810838524,250645,250645,82092,332737,401454632.2000117,3774827.2166661266,182894,0,30,0.5955033555030002,6118646183,-630,-630,35460339.0666548,4675.68333387794,-757,0,1,0.19165341509076417,-6067188857,1747.55503176476,1601.6861784596208,145.86885330513928,0.7285042897426155,0.7296933910510882,-757
1416,2020-11-17,2020,247323,247323,436999237.9333339,3773187.566666668,182130,0,35,0.795607363649964,51147029,6819357961,247710,247710,83814,331524,401564891.9166794,3767713.2333327993,182631,0,35,0.596412326106104,6127199554,-387,-387,35434346.01665449,5474.333333868533,-501,0,0,0.19919503754386003,-6076052525,1766.91710004057,1621.1089254235976,145.80817461697234,0.7364054293373443,0.7372774615477776,-501
1417,2020-11-18,2020,242615,242615,437150752.3333328,3737336.350000002,178258,0,59,0.7951280835892258,51441461,6830260398,243074,243074,82162,325236,401780548.5500102,3732641.2333328743,178911,0,59,0.5972524566776135,6134633811,-459,-459,35370203.78332257,4695.116667127702,-653,0,0,0.1978756269116123,-6083192350,1801.8290391498167,1652.9145385767717,148.91450057304496,0.7347361045277497,0.7360351168779877,-653
1418,2020-11-19,2020,241928,241928,437062222.1166664,3709797.333333332,176635,0,83,0.7948025858933224,50749823,6834004766,242532,242532,79701,322233,401756645.8500101,3705748.8999994732,177416,0,83,0.6011674781912517,6147404037,-604,-604,35305576.26665628,4048.4333338588476,-781,0,0,0.1936351077020707,-6096654214,1806.5797349486888,1656.5098455049647,150.06988944372415,0.7301139181905361,0.7315158412085828,-781
1419,2020-11-20,2020,242501,242501,437249021.8333332,3654485.950000001,177446,0,79,0.7895018989612419,50480982,6844978977,248982,248982,82006,330988,402028647.3666799,3657527.649999608,180309,0,79,0.5896739458832356,6156721509,-6481,-6481,35220374.46665329,-3041.6999996067025,-2863,0,0,0.19982795307800627,-6106240527,1803.0813144413144,1614.6896055404804,188.39170890083392,0.7317330650182886,0.7241848808347592,-2863
1420,2020-11-21,2020,238723,238723,437114345.8999999,3643909.9500000034,173451,0,47,0.7859192453177946,51228121,6848012988,248120,248120,87210,335330,401180206.75001997,3651356.9166661887,179281,0,48,0.5791250410043794,6137302729,-9397,-9397,35934139.14997995,-7446.966666185297,-5830,0,-1,0.2067942043134151,-6086074608,1831.0524997591347,1616.8797628164596,214.1727369426751,0.7265785031186773,0.722557633403192,-5830
1421,2020-11-22,2020,234568,234568,437159270.8333339,3602369.633333336,170985,0,81,0.7949805600081837,52088904,6856827423,235271,235271,89432,324703,398289570.83334494,3597740.4666661303,171909,0,81,0.5799884817818144,6045599082,-703,-703,38869699.99998897,4629.166667205747,-924,0,0,0.21499207822636934,-5993510178,1863.6782120039131,1692.8970031722777,170.78120883163547,0.728935745711265,0.7306850398051609,-924
1422,2020-11-23,2020,238540,238540,437454799.94999945,3622264.3999999934,172311,0,176,0.7819988261926732,51995768,6873812708,239060,239060,82024,321084,398589714.050009,3618277.5833328045,172992,0,176,0.5851833165153061,6052379586,-520,-520,38865085.89999044,3986.8166671888903,-681,0,0,0.19681550967736716,-6000383818,1833.8844636119704,1667.3208150673847,166.5636485445857,0.7223568374276851,0.7236342340834937,-681
1423,2020-11-24,2020,237368,237368,438048938.1166666,3658984.833333339,172496,0,201,0.7825738937009202,50404538,6888398843,238889,238889,80358,319247,399205659.45001614,3653936.099999503,173314,0,204,0.5861762209198551,6063948343,-1521,-1521,38843278.666650474,5048.733333835844,-818,0,-3,0.19639767278106512,-6013543805,1845.4422589256624,1671.0926809104485,174.34957801521387,0.7267028411580331,0.7255001276743592,-818
1424,2020-11-25,2020,238916,238916,438541275.51666594,3678865.866666668,173775,0,204,0.7866070083209161,52680110,6899911661,239636,239636,78044,317680,399761365.7666773,3674157.2499995376,174731,0,204,0.5978217073784957,6078927939,-720,-720,38779909.749988616,4708.616667130496,-956,0,0,0.1887853009424204,-6026247829,1835.545863469445,1668.202464432211,167.34339903723412,0.7273476870531902,0.7291517134320386,-956
1425,2020-11-26,2020,243667,243667,439082073.41666687,3682651.1333333324,175567,0,136,0.7831425675204272,53548163,6916383065,244345,244345,77930,322275,400285140.43333876,3677325.633332778,176437,0,136,0.5973376774493871,6092643572,-678,-678,38796932.983328104,5325.500000554603,-870,0,0,0.18580489007104006,-6039095409,1801.9759483913163,1638.1965681038644,163.7793802874519,0.7205202181665962,0.7220814831488265,-870
1426,2020-11-27,2020,232980,232980,439142387.4999999,3597878.1500000013,169373,0,39,0.7874366898446223,52103768,6924996897,233710,233710,85081,318791,400378685.4500128,3593743.9499994586,170280,0,41,0.5805465022538293,6106402804,-730,-730,38763702.04998708,4134.200000542682,-907,0,-2,0.20689018759079303,-6054299036,1884.8930702206194,1713.1431494159976,171.74992080462175,0.7269851489398231,0.7285952676393821,-907
1427,2020-11-28,2020,228891,228891,438803919.83333343,3556747.7833333355,165730,0,91,0.7775578768933683,51179567,6928120827,229475,229475,81137,310612,400137178.266681,3552890.1999995443,166476,0,91,0.5774374460742017,6109634396,-584,-584,38666741.56665242,3857.5833337912336,-746,0,0,0.20012043081916664,-6058454829,1917.086822257465,1743.7070629335701,173.37975932389486,0.7240564286057556,0.7254646475650942,-746
1428,2020-11-29,2020,222078,222078,439284125.0666667,3521911.6000000024,162472,0,124,0.7843100172011638,50754310,6943770247,222623,222622,75985,298608,400715656.1833341,3517708.8166661304,163246,0,127,0.5880251031452668,6115142158,-545,-544,38568468.88333261,4202.783333871979,-774,0,-3,0.196284914055897,-6064387848,1978.0623252490868,1799.9822846948375,178.0800405542493,0.7315988076261494,0.733284521365717,-774
1429,2020-11-30,2020,235850,235850,440259482.8500003,3678714.9999999935,180019,0,134,0.8236294254822982,52343015,6963410513,236516,236516,71604,308120,401744914.7666808,3674401.049999561,180807,0,137,0.6353888095547141,6136133002,-666,-666,38514568.083319545,4313.95000043232,-788,0,-3,0.18824061592758412,-6083789987,1866.6927405130393,1698.5950834898306,168.09765702320874,0.7632775068899724,0.7644599096889851,-788
1430,2020-12-01,2020,240611,240611,441070793.1833326,3746512.9499999997,183640,0,129,0.8253446434286049,52979816,6980149731,241358,241358,71920,313278,402610672.18334323,3741970.316666216,184491,0,130,0.6391192487183885,6151348053,-747,-747,38460120.99998939,4542.633333783597,-851,0,-1,0.18622539471021637,-6098368237,1833.1281328922312,1668.1057689545953,165.02236393763587,0.7632236265174909,0.7643873416253035,-851
1431,2020-12-02,2020,236125,236125,441667963.9999999,3687420.200000001,178449,0,89,0.8143779777660136,52797497,6994935264,236855,236855,77339,314194,403309981.7500105,3683634.2166662146,179274,0,89,0.6171155400803329,6165207379,-730,-730,38357982.24998939,3785.983333786484,-825,0,0,0.19726243768568075,-6112409882,1870.483701429327,1702.771660931838,167.71204049748917,0.7557395447326628,0.756893458022841,-825
1432,2020-12-03,2020,230978,230978,442033637.9000006,3650522.683333338,174296,0,86,0.8145624258587395,52738885,7010770848,231692,231692,77569,309261,403667652.8833414,3645775.5499994736,175155,0,86,0.6139894781430576,6183168402,-714,-714,38365985.0166592,4747.133333864156,-859,0,0,0.2005729477156819,-6130429517,1913.7477937292754,1742.2597797219644,171.488014007311,0.7546000051953,0.7559820796574763,-859
1433,2020-12-04,2020,234549,234549,442513157.55000013,3644944.0833333367,176390,0,89,0.8107474344380069,52068551,7021306463,235103,235103,74596,309699,404225224.71667945,3639546.1166662215,177130,0,90,0.6182325419197374,6192532338,-554,-554,38287932.83332068,5397.966667115223,-740,0,-1,0.19251489251826948,-6140463787,1886.6554858473075,1719.3537501294304,167.30173571787714,0.7520390195652081,0.7534144608958626,-740
1434,2020-12-05,2020,237364,237364,442744434.04999983,3647242.083333337,175898,0,69,0.7953902023895801,52098514,7029624156,238140,238140,76896,315036,404513515.9666699,3642241.1499995077,176844,0,69,0.604219835193435,6208074720,-776,-776,38230918.083329916,5000.933333829511,-946,0,0,0.1911703671961451,-6155976206,1865.255194764159,1698.6374232244475,166.61777153971138,0.7410475050976559,0.7426051902242379,-946
1435,2020-12-06,2020,231212,231212,442671031.69999987,3599249.8333333326,172260,0,27,0.8014246665397993,52208152,7036658149,232034,232034,79686,311720,404535302.3000136,3595120.666666416,173238,0,29,0.600359296804816,6218717087,-822,-822,38135729.39998627,4129.166666916572,-978,0,-2,0.20106536973498323,-6166508935,1914.5677201010324,1743.43114500467,171.13657509636232,0.7450305347473315,0.7466061008300507,-978
1436,2020-12-07,2020,230796,230796,443378029.5000002,3588288.2500000033,170923,0,49,0.7975224873914626,51567444,7055008283,231666,231666,77344,309010,405317395.3166769,3584031.5333328694,171928,0,49,0.6020646581016796,6229895939,-870,-870,38060634.183323264,4256.716667133849,-1005,0,0,0.19545782928978295,-6178328495,1921.0819489939174,1749.5765253281747,171.50542366574268,0.7405804260039168,0.7421373874457192,-1005
1437,2020-12-08,2020,230538,230538,443576888.41666704,3536338.466666663,170139,0,29,0.7951574143958902,51704372,7064948323,231345,231345,75274,306619,405599090.38334614,3532521.099999568,171107,0,29,0.6037558011734374,6242109934,-807,-807,37977798.033320904,3817.366667095106,-968,0,0,0.19140161322245275,-6190405562,1924.0944591202624,1753.2217700116541,170.87268910860826,0.7380084845014705,0.7396183189608593,-968
1438,2020-12-09,2020,247230,247230,444551923.2000004,3774965.0833333344,188107,0,30,0.8269789265056833,53648077,7081920293,248213,248213,74381,322594,406520755.5333463,3771865.0666662804,189200,0,31,0.6400615014538421,6254956107,-983,-983,38031167.66665411,3100.0166670540348,-1093,0,-1,0.18691742505184117,-6201308030,1798.1309841038726,1637.7899446577992,160.3410394460734,0.7608583100756381,0.7622485526543734,-1093
1439,2020-12-10,2020,244160,244160,445363095.6333339,3802939.350000002,184182,0,93,0.8202408256880731,54057664,7096352884,245065,245065,76849,321914,407406027.9500104,3798671.5833328133,185233,0,93,0.6286306280559353,6267839013,-905,-905,37957067.6833235,4267.766667188611,-1051,0,0,0.19161019763213782,-6213781349,1824.062482115555,1662.440691041195,161.6217910743601,0.7543496068152031,0.7558525289208985,-1051
1440,2020-12-11,2020,242425,242425,446038972.08333373,3735737.133333331,181281,0,235,0.813055584201299,54221294,7106118618,244380,244380,77562,321942,408055216.80000424,3731741.483332843,182628,0,235,0.6192854613563942,6283906784,-1955,-1955,37983755.28332949,3995.65000048792,-1347,0,0,0.1937701228449048,-6229685490,1839.9050101405949,1669.7570046648837,170.14800547571122,0.7477817881819119,0.7473115639577707,-1347
1441,2020-12-12,2020,240077,240077,446147472.2000006,3663281.9833333343,179570,0,147,0.8116937482557675,52976824,7118212843,240722,240722,82126,322848,408160122.63334143,3658446.366666189,180429,0,147,0.608509267519085,6293251131,-645,-645,37987349.56665915,4835.6166671453975,-859,0,0,0.2031844807366825,-6240274307,1858.3515797015148,1695.5663488727305,162.78523082878428,0.7479683601511182,0.7495326559267537,-859
1442,2020-12-13,2020,229580,229580,446139880.71666676,3582246.8000000026,171622,0,47,0.8105322763306902,52117949,7130561261,230098,230098,82447,312545,408154723.90001273,3577674.4666661834,172407,0,48,0.5999648050680731,6304713276,-518,-518,37985156.81665403,4572.333333819173,-785,0,-1,0.2105674712626171,-6252595327,1943.28722326277,1773.8299502821092,169.45727298066095,0.7475476957923164,0.7492763952750567,-785
1443,2020-12-14,2020,225443,225443,446231326.166667,3550963.4666666696,169097,0,45,0.8085192265894253,51883869,7145669427,225864,225864,78999,304863,408244199.4500097,3546569.54999952,169747,0,47,0.6015095305104267,6318832764,-421,-421,37987126.71665728,4393.916667149402,-650,0,-2,0.20700969607899866,-6266948895,1979.353211972281,1807.477948898495,171.87526307378607,0.7500654267375789,0.7515451776290157,-650
1444,2020-12-15,2020,227368,227368,446481631.6,3565590.8166666655,169315,0,60,0.7993737025438934,51902897,7158266696,227433,227433,71030,298463,408602812.03332883,3560905.3499998627,169845,0,59,0.6120457142091306,6329239967,-65,-65,37878819.56667119,4685.466666802764,-530,0,1,0.18732798833476283,-6277337070,1963.6959976777737,1796.5854209078227,167.11057676995097,0.7446738327293199,0.7467913627310021,-530
1445,2020-12-16,2020,229396,229396,446917299.2666666,3573540.6500000055,170168,0,52,0.797045284137474,52355249,7169622284,229936,229936,72311,302247,409069552.4500102,3570011.849999511,170961,0,51,0.6093294557100711,6342279212,-540,-540,37847746.81665641,3528.800000494346,-793,0,1,0.18771582842740286,-6289923963,1948.2349267932595,1779.0583138351983,169.17661295806124,0.7418089243055677,0.7435155869459328,-793
1446,2020-12-17,2020,231559,231559,447300098.7666665,3600025.2499999995,171342,0,112,0.7940524877029177,52738676,7183622966,233739,233739,72817,306556,409600210.2333419,3595912.649999506,172146,0,112,0.6043985438223304,6356585214,-2180,-2180,37699888.5333246,4112.600000493694,-804,0,0,0.18965394388058732,-6303846538,1931.6895424780141,1752.382829708957,179.30671276905719,0.7399496456626605,0.7364881342009677,-804
1447,2020-12-18,2020,227515,227515,447507263.2166671,3539012.816666667,168828,0,183,0.8020921697470503,51727754,7193854746,227969,227969,76767,304736,409858492.15000933,3534529.849999577,169486,0,182,0.6025149637719162,6368328257,-454,-454,37648771.06665778,4482.966667090077,-658,0,1,0.19957720597513418,-6316600503,1966.9352052245658,1797.86941272721,169.06579249735591,0.7420521723842384,0.7434607336962482,-658
1448,2020-12-19,2020,219710,219710,447460574.51666653,3490600.716666668,162995,0,205,0.7992854216922304,50837977,7201862521,220096,220096,77001,297097,409804671.63332856,3486542.666666464,163661,0,196,0.5949605684338837,6378596517,-386,-386,37655902.883337975,4058.050000204239,-666,0,9,0.2043248532583467,-6327758540,2036.5963065707822,1861.9360262491302,174.66028032165195,0.7418642756360657,0.7435891610933411,-666
1449,2020-12-20,2020,218999,218999,447808832.90000004,3507025.2000000007,161722,0,89,0.7941451787451079,51162207,7215093768,219651,219651,69503,289154,410201182.56667626,3503305.083332793,162565,0,86,0.6065591345788046,6384479101,-652,-652,37607650.33332378,3720.116667207796,-843,0,3,0.1875860441663033,-6333316894,2044.7985283037824,1867.5133851731896,177.28514313059281,0.7384599929680045,0.7401058952611188,-843
1450,2020-12-21,2020,226222,226222,448536584.1833332,3556750.8000000007,167276,0,25,0.793158932376161,51223244,7231345954,226087,226087,68100,294187,410956032.86666137,3551601.7833330464,167901,0,25,0.6141127922035949,6397681065,135,135,37580551.31667185,5149.016666954383,-625,0,0,0.17904614017256604,-6346457821,1982.7275162598387,1817.6897958160414,165.0377204437973,0.7394329463977862,0.7426388956463662,-625
1451,2020-12-22,2020,232902,232902,448995696.2833341,3610574.9499999974,171015,0,38,0.7860001202222391,51993107,7241859858,233700,233700,69310,303010,411434638.75001186,3606725.683332828,171843,0,38,0.6093132239860061,6412934592,-798,-798,37561057.533322215,3849.2666671695188,-828,0,0,0.17668689623623302,-6360941485,1927.831003097157,1760.5247700043296,167.30623309282737,0.7342787953731612,0.7353145057766367,-828
1452,2020-12-23,2020,232121,232121,449497531.0333328,3611792.8666666667,170626,0,70,0.7923582958887819,53537595,7255181201,232770,232770,74033,306803,411967456.5000106,3609121.3333328534,171315,0,70,0.6035469014318545,6425767748,-649,-649,37530074.533322215,2671.533333813306,-689,0,0,0.1888113944569274,-6372230153,1936.479383740949,1769.8477316664973,166.63165207445172,0.7350735176912041,0.7359840185590927,-689
1453,2020-12-24,2020,221429,221429,449617756.76666677,3518488.9666666696,162653,0,45,0.792235885995059,53336428,7260883007,222150,222150,77836,299986,412218073.9666779,3515482.2999994904,163548,0,45,0.5901742081297111,6437865213,-721,-721,37399682.799988866,3006.6666671792045,-895,0,0,0.2020616778653479,-6384528785,2030.5278746987376,1855.5843977793288,174.9434769194088,0.7345605137538443,0.7362052667116813,-895
1454,2020-12-25,2020,219693,219693,449335108.16666687,3468990.350000002,159510,0,53,0.7828606282403161,52598851,7264707773,220353,220353,73959,294312,411998708.38333726,3465607.1499994327,160394,0,54,0.5911175894968658,6447893931,-660,-660,37336399.783329606,3383.2000005692244,-884,0,-1,0.19174303874345033,-6395295080,2045.2864140717586,1869.721348850877,175.5650652208817,0.7260586363698434,0.7278956946354259,-884
1455,2020-12-26,2020,223553,223553,450107970.35000056,3544841.300000003,162160,0,26,0.7814567462749319,52680809,7283600730,224422,224422,69299,293721,412807526.19999605,3539562.516666407,163126,0,25,0.602360743698949,6459073903,-869,-869,37300444.150004506,5278.783333595842,-966,0,1,0.1790960025759829,-6406393094,2013.4284503003787,1839.4253959059097,174.00305439446902,0.7253760853131025,0.7268716970706972,-966
1456,2020-12-27,2020,229660,229660,450754494.8,3573985.8500000034,165995,0,22,0.778781677262039,53465370,7300381869,230242,230242,69245,299487,413439624.5499971,3566247.299999815,166881,0,22,0.6044035300363678,6471815063,-582,-582,37314870.25000292,7738.550000188407,-886,0,0,0.17437814722567113,-6418349693,1962.7035391448228,1795.6742234257742,167.02931571904855,0.7227858573543499,0.7248069422607517,-886
1457,2020-12-28,2020,234247,234247,451748725.8833328,3575686.966666665,169601,0,221,0.7835319128953627,53263696,7323455043,235101,235101,73759,308860,414387413.1333419,3571041.4499994842,170604,0,221,0.601447257657192,6489502302,-854,-854,37361312.74999088,4645.516667180695,-1003,0,0,0.18208465523817075,-6436238606,1928.5144564640434,1762.5931541479702,165.92130231607325,0.7240263482563277,0.725662587568747,-1003
1458,2020-12-29,2020,220832,220832,452039054.9666669,3481072.3666666616,161330,0,257,0.7951972540211565,52886297,7340578918,221707,221707,76752,298459,414768575.61666507,3477082.199999647,162418,0,258,0.5962963087057208,6502720420,-875,-875,37270479.35000181,3990.1666670143604,-1088,0,-1,0.19890094531543567,-6449834123,2046.9816646440138,1870.7960308725708,176.185633771443,0.7305553542964788,0.7325794855372181,-1088
1459,2020-12-30,2020,204743,204743,451401677.36666673,3390644.8833333324,150765,0,187,0.7989577177241709,53024528,7351177016,205664,205664,74085,279749,414159878.70000577,3386409.8166661295,151777,0,188,0.5928135578679478,6520330418,-921,-921,37241798.666660964,4235.06666720286,-1012,0,-1,0.20614415985622314,-6467305890,2204.7233720648164,2013.7694428777315,190.9539291870849,0.7363621711120771,0.7379852575073907,-1012
1460,2020-12-31,2020,213261,213261,451725748.21666616,3438632.4499999993,154630,0,143,0.781910429004835,53287446,7368546567,214094,214094,63625,277719,414514853.93334126,3434699.2166661574,155640,0,144,0.6076249734443872,6533528899,-833,-833,37210894.2833249,3933.2333338418975,-1010,0,-1,0.17428545556044783,-6480241453,2118.1826410673593,1936.1348469987074,182.0477940686519,0.7250739703930864,0.7269703961811167,-1010
1461,2021-01-01,2021,221597,221597,451727181.4833334,3414480.2499999995,158426,0,146,0.7670591208364744,50661817,7373723730,222260,222260,64742,287002,414504785.4166758,3410447.499999448,159302,0,148,0.5976752775242001,6542448520,-663,-663,37222396.0666576,4032.750000551343,-876,0,-2,0.1693838433122743,-6491786703,2038.5076579707008,1864.9544921113823,173.5531658593186,0.714928451197444,0.7167371546837038,-876
1462,2021-01-02,2021,217606,217606,452015329.766667,3432008.3500000034,158254,0,185,0.7830896206906057,52829969,7389491135,223569,223569,74296,297865,414873880.4666581,3434666.233333211,162042,0,188,0.5872660433417813,6553171649,-5963,-5963,37141449.30000889,-2657.8833332075737,-3788,0,-3,0.19582357734882438,-6500341680,2077.2190553875676,1855.68607663253,221.53297875503745,0.7272501677343456,0.7247963715899789,-3788
1463,2021-01-03,2021,215365,215365,452564215.18333316,3419412.8666666704,156888,0,153,0.784937199637824,52736751,7406430949,220140,220140,72877,293017,415154798.1333426,3419235.0999994697,159882,0,154,0.5894913946972288,6558512496,-4775,-4775,37409417.049990535,177.76666720071808,-2994,0,-1,0.19544580494059527,-6505775745,2101.382374960338,1885.8671669544046,215.51520800593335,0.7284749146797298,0.7262741891523576,-2994
1464,2021-01-04,2021,222157,222157,453455827.18333364,3491109.5000000023,162680,0,97,0.788298365570294,53524329,7427135089,222699,222699,70474,293173,415304422.816666,3487487.483333063,163435,0,97,0.6022723784250129,6550494649,-542,-542,38151404.36666763,3622.016666939482,-755,0,0,0.18602598714528107,-6496970320,2041.1502999380332,1864.8688266075105,176.28147333052266,0.7322749226898094,0.7338829541219314,-755
1465,2021-01-05,2021,222266,222266,453944329.86666703,3484121.416666665,161502,0,113,0.784856883194011,53590342,7439521295,225056,225056,68996,294052,415837343.56667703,3480845.733332806,162905,0,113,0.6008563111286408,6561109043,-2790,-2790,38106986.29999,3275.6833338593133,-1403,0,0,0.18400057206537024,-6507518701,2042.3471420130252,1847.7060978897564,194.64104412326878,0.7266158566762347,0.7238420659746907,-1403
1466,2021-01-06,2021,213372,213372,454234254.7833331,3416394.3833333324,156908,0,110,0.7954792568846902,53050378,7451553700,214144,214144,72381,286525,416133483.4000101,3412536.9333328274,157855,0,110,0.5991728470465054,6571628319,-772,-772,38100771.383323014,3857.450000504963,-947,0,0,0.19630640983818481,-6518577941,2128.8372175511927,1943.241386170101,185.59583138109178,0.7353729636503383,0.7371441646742379,-947
1467,2021-01-07,2021,213455,213455,454577250.3166665,3475953.299999999,166188,0,120,0.8431378979175937,53061060,7463773235,214077,214077,67979,282056,416533696.916676,3471154.099999545,166929,0,121,0.6433686927418703,6585279264,-622,-622,38043553.3999905,4799.20000045374,-741,0,-1,0.1997692051757235,-6532218204,2129.6163140552644,1945.7190492985046,183.8972647567598,0.778562226230353,0.7797614876890091,-741
1468,2021-01-08,2021,220607,220607,455768203.516667,3577172.833333331,171125,0,105,0.8379924481090812,54383149,7483797487,221195,221195,60275,281470,417726941.7833425,3572727.5333328573,171829,0,105,0.6608341919209898,6596802922,-588,-588,38041261.73332453,4445.300000473857,-704,0,0,0.17715825618809145,-6542419773,2065.973443801271,1888.500833126167,177.47261067510408,0.7757006803954544,0.7768213567214449,-704
1469,2021-01-09,2021,225252,225252,456289906.3333331,3520919.8166666734,172459,0,102,0.8249338518636911,54335341,7497000972,225811,225811,65115,290926,418277624.0166635,3517063.0333331497,173199,0,102,0.6435347820407963,6613944705,-559,-559,38012282.31666958,3856.7833335236646,-740,0,0,0.18139906982289478,-6559609364,2025.6863705242708,1852.3350236111771,173.35134691309372,0.765626942269103,0.7670086931106102,-740
1470,2021-01-10,2021,220044,220044,456693030.33333397,3489525.866666662,166835,0,118,0.8115422370071439,53346967,7510590935,220608,220608,73368,293976,418687961.83334494,3486065.6999995094,167634,0,118,0.6118322584156504,6624992302,-564,-564,38005068.49998903,3460.166667152662,-799,0,0,0.19970997859149353,-6571645335,2075.462318142435,1897.8820434134072,177.58027472902768,0.7581892712366618,0.7598727154046997,-799
1471,2021-01-11,2021,224419,224419,457697253.93333364,3544716.766666669,169615,0,110,0.8096105944683817,52815687,7535715428,224921,224921,69644,294565,419643137.3999924,3540716.3166663833,170287,0,110,0.6210140376487372,6639354699,-502,-502,38054116.53334123,4000.4500002856366,-672,0,0,0.1885965568196445,-6586539012,2039.4763987600588,1865.7356911982092,173.7407075618496,0.7557960778721944,0.7570969362576193,-672
1472,2021-01-12,2021,236674,236674,458283154.45000017,3668567.5500000035,181892,0,115,0.8318826740579873,54986947,7543688299,245215,245215,68924,314139,420353566.7166905,3676587.2499995716,186636,0,115,0.6441352394958937,6658341761,-8541,-8541,37929587.733309686,-8019.699999568053,-4744,0,0,0.18774743456209364,-6603354814,1936.3476953531024,1714.2245242611198,222.1231710919826,0.7685339327513795,0.7611116775074934,-4744
1473,2021-01-13,2021,237122,237122,459028768.8666668,3709782.433333335,179139,0,93,0.811675002741205,54665996,7555632864,247773,247773,75853,323626,420018118.8166782,3718842.5666662464,183958,0,93,0.610448480653589,6627628300,-10651,-10651,39010650.04998857,-9060.133332911413,-4819,0,0,0.20122652208761593,-6572962304,1935.8337432489047,1695.1730770369581,240.6606662119466,0.7554718668027429,0.7424457063521853,-4819
1474,2021-01-14,2021,236941,236941,459858461.63333255,3682679.266666661,177540,0,180,0.8060361018143753,55449223,7574824808,238706,238706,82037,320743,418403647.9666747,3678925.8999994686,178370,0,181,0.5989218782639004,6549223829,-1765,-1765,41454813.666657865,3753.3666671924293,-830,0,-1,0.20711422355047493,-6493774606,1940.8142180261439,1752.7990413591392,188.01517666700465,0.7493004587639961,0.747237187167478,-830
1475,2021-01-15,2021,238501,238501,460380608.53333366,3648393.950000002,178802,0,240,0.8127261520916058,55093780,7593342227,239158,239158,76763,315921,418717716.0333396,3644556.2499994845,179470,0,247,0.6170624934714681,6557392491,-657,-657,41662892.49999404,3837.700000517536,-668,0,-7,0.19566365862013768,-6502298711,1930.3089233727894,1750.799538519889,179.50938485290044,0.7496907769778743,0.7504244056230609,-668
1476,2021-01-16,2021,219481,219481,460030179.266666,3507747.9666666673,165947,0,66,0.8151138367330202,54158017,7599204359,219939,219939,82512,302451,418477374.04999727,3503089.566666443,166513,0,66,0.5947409663052688,6573291349,-458,-458,41552805.216668725,4658.400000224356,-566,0,0,0.22037287042775133,-6519133332,2095.9909024775084,1902.6974481560671,193.29345432144123,0.7560882263157175,0.757087192357881,-566
1477,2021-01-17,2021,215917,215917,459993492.2500003,3457367.6500000022,162286,0,61,0.8048879893662837,53439638,7606847408,216374,216374,72597,288971,418566608.8333434,3454417.3499995223,162743,0,61,0.603673032934095,6583773777,-457,-457,41426883.41665691,2950.3000004799105,-457,0,0,0.20121495643218867,-6530334139,2130.418134051512,1934.4588944759694,195.9592395755426,0.7516128882857764,0.7521375026574357,-457
1478,2021-01-18,2021,224567,224567,460721694.51666653,3507837.733333334,167723,0,36,0.8026201534508625,53809128,7624836960,225020,225020,68880,293900,419362547.5666783,3503703.533332834,168239,0,36,0.6157298400816661,6599558075,-453,-453,41359146.949988246,4134.200000499841,-516,0,0,0.18689031336919637,-6545748947,2051.6001661716396,1863.6678853732037,187.93228079843584,0.7468728709026705,0.7476624300062217,-516
1479,2021-01-19,2021,226733,226733,460950638.0333333,3525879.4833333353,168068,0,79,0.8061376156095498,53543681,7631376352,227246,227246,70536,297782,419681833.6833292,3521913.5333330957,168665,0,79,0.616941252325525,6612301314,-513,-513,41268804.35000408,3965.950000239536,-597,0,0,0.18919636328402478,-6558757633,2033.010801397826,1846.817253915709,186.19354748211708,0.7412595431631037,0.7422132842822315,-597
1480,2021-01-20,2021,225525,225525,461117899.2000006,3553942.666666667,168239,0,86,0.8175368584414145,53427955,7641654019,226038,226038,71341,297379,419943999.35000646,3550286.233332849,168877,0,86,0.6231475659007523,6622208793,-513,-513,41173899.84999412,3656.4333338178694,-638,0,0,0.19438929254066228,-6568780838,2044.642053874296,1857.8469078208375,186.79514605345844,0.7459882496397295,0.7471177412647431,-638
1481,2021-01-21,2021,224491,224491,461552959.40000045,3552141.416666669,166486,0,109,0.8184470646930155,53455061,7654659667,227703,227703,70035,297738,420551357.24999714,3549000.5333331716,168076,0,109,0.6242804076066814,6633973161,-3212,-3212,41001602.150003314,3140.883333497215,-1590,0,0,0.19416665708633418,-6580518100,2055.997609703732,1846.929365225742,209.06824447799,0.7416154767897154,0.7381369591090148,-1590
1482,2021-01-22,2021,221676,221676,461937494.80000013,3491777.799999999,164068,0,35,0.8219428354896323,53678309,7670340400,222111,222111,73389,295500,420764085.6666599,3487473.4166665045,164681,0,35,0.620209813874778,6646036526,-435,-435,41173409.13334024,4304.383333494421,-613,0,0,0.2017330216148543,-6592358217,2083.8408073043547,1894.3865259562106,189.45428134814415,0.7401252278099568,0.7414355885120503,-613
1483,2021-01-23,2021,216334,216334,461843729.4999998,3460388.8999999966,160653,0,40,0.8221176514093945,54042343,7679547239,216773,216773,70219,286992,420889876.00000954,3457233.933332829,161258,0,40,0.6229825221608967,6660790416,-439,-439,40953853.499990284,3154.9666671678424,-605,0,0,0.19913512924849786,-6606748073,2134.864281620087,1941.6157731821286,193.2485084379582,0.742615585159984,0.7439026077970965,-605
1484,2021-01-24,2021,214155,214155,462001363.5333324,3395685.733333334,159089,0,31,0.8205645443720664,54109763,7694898102,214807,214807,68608,283415,421086261.8333248,3392678.149999666,159841,0,32,0.6237108127657441,6676970036,-652,-652,40915101.70000762,3007.5833336678334,-752,0,-1,0.19685373160632225,-6622860273,2157.322329776715,1960.300464292713,197.02186548400186,0.7428684831080292,0.7441144841648549,-752
1485,2021-01-25,2021,218002,218002,462464459.70000046,3446244.1833333364,162961,0,85,0.8259878349739902,54609003,7713739144,218877,218877,67735,286612,421619209.26667297,3443318.099999475,163842,0,85,0.6326706488214003,6695876467,-875,-875,40845250.433327496,2926.0833338615485,-881,0,0,0.19331718615258986,-6641267464,2121.3771419528284,1926.2837541937845,195.09338775904394,0.747520664948028,0.7485574089557149,-881
1486,2021-01-26,2021,218952,218952,462619725.7166668,3431417.8500000006,163473,0,99,0.8286565091892283,54624902,7726484692,219500,219500,66888,286388,421884378.46667814,3428037.3499994874,164119,0,97,0.6370797659119802,6711061122,-548,-548,40735347.249988675,3380.5000005131587,-646,0,2,0.19157674327724805,-6656436220,2112.8819362995855,1922.0245032650485,190.85743303453705,0.7466156965910337,0.7476947608200456,-646
1487,2021-01-27,2021,219913,219913,462949009.45000005,3442511.63333333,164497,0,58,0.8403686912551783,54882496,7739488852,220455,220455,68765,289220,422311397.83332604,3438263.533333059,165139,0,58,0.6422930641034579,6729315464,-542,-542,40637611.616674006,4248.100000271108,-642,0,0,0.19807562715172045,-6674432968,2105.1461689395355,1915.6353806143024,189.51078832523308,0.7480094400967655,0.7490825792111769,-642
1488,2021-01-28,2021,209931,209931,463048387.9999998,3409640.283333332,158117,0,188,0.845396820860188,54877005,7752182978,210471,210471,68967,279438,422514884.3833406,3405488.0999994995,158784,0,189,0.6388859067127552,6744052608,-540,-540,40533503.616659224,4152.183333832305,-667,0,-1,0.20651091414743272,-6689175603,2205.717059414759,2007.4731643948126,198.24389501994665,0.7531855704969728,0.7544222244394715,-667
1489,2021-01-29,2021,211142,211142,463426352.56666654,3363898.1333333356,159231,0,142,0.8486042568508394,54709581,7770244493,211777,211777,65614,277391,422972539.60000485,3359629.099999452,160007,0,145,0.650814193683282,6761482573,-635,-635,40453812.96666169,4269.033333883621,-776,0,-3,0.19779006316755743,-6706772992,2194.856317391455,1997.2543741766333,197.60194321482163,0.754141762415815,0.7555447475410455,-776
1490,2021-01-30,2021,208620,208620,463518055.84999907,3361132.9333333303,156926,0,151,0.8441616335921779,54321897,7782796815,209227,209227,66864,276091,423109358.55000675,3358524.933332744,157633,0,151,0.6423824029034009,6778501900,-607,-607,40408697.29999232,2608.0000005862676,-707,0,0,0.201779230688777,-6724180003,2221.829430783238,2022.2502762550089,199.57915452822908,0.7522097593711053,0.7534065871039589,-707
1491,2021-01-31,2021,207033,207033,463948180.1999997,3360987.65,155625,0,110,0.8434838890418437,54218171,7795510719,207589,207589,63079,270668,423611268.41667277,3356656.6666661324,156344,0,111,0.6498071438071777,6796625591,-556,-556,40336911.783326924,4330.983333867509,-719,0,-1,0.19367674523466594,-6742407420,2240.9383054875293,2040.6248328026666,200.31347268486275,0.7516917592847517,0.753142025829885,-719
1492,2021-02-01,2021,210688,210688,464437496.4666669,3365726.6999999997,157747,0,107,0.8419843560145808,53873898,7807077218,211291,211291,61181,272472,424218306.3499909,3362203.016666384,158461,0,107,0.6558031650958694,6813577551,-603,-603,40219190.11667597,3523.6833336157724,-714,0,0,0.18618119091871133,-6759703653,2204.3851404288184,2007.7443258349429,196.64081459387558,0.7487232305589308,0.7499656871329115,-714
1493,2021-02-02,2021,204621,204621,464404417.1333337,3300579.716666665,154623,0,143,0.849800362621627,53559473,7817611054,205162,205162,66252,271414,424256178.03333765,3296152.43333286,155339,0,145,0.6452062163337079,6827432812,-541,-541,40148239.09999603,4427.283333804924,-716,0,-2,0.20459414628791905,-6773873339,2269.583362085679,2067.9081800398594,201.67518204581938,0.7556555778732388,0.7571528840623507,-716
1494,2021-02-03,2021,206006,206006,464215529.8166664,3344529.750000001,157674,0,52,0.8632661184625686,53717966,7824946937,206677,206677,62669,269346,424031088.68333834,3340105.6666661757,158402,0,54,0.6649922404639331,6838035059,-671,-671,40184441.13332808,4424.083333825227,-728,0,-2,0.1982738779986355,-6784317093,2253.4078124747166,2051.660749301269,201.7470631734477,0.765385474209489,0.7664229691741219,-728
1495,2021-02-04,2021,206769,206769,464415259.78333277,3366180.016666667,157387,0,73,0.857410927169934,53139449,7835928418,207248,207248,58894,266142,424310795.0500071,3362178.5499994243,157980,0,73,0.6696725808027238,6847100038,-479,-479,40104464.73332566,4001.466667242814,-593,0,0,0.1877383463672101,-6793960589,2246.05845065427,2047.357731075847,198.7007195784231,0.7611730965473548,0.7622751486142206,-593
1496,2021-02-05,2021,205202,205202,464716565.716667,3337648.7999999966,155982,0,36,0.8555179774076282,53202361,7851699706,205640,205640,60665,266305,424677251.2833354,3334097.3333328217,156496,0,36,0.6627626218058211,6859439834,-438,-438,40039314.43333161,3551.4666671748273,-514,0,0,0.19275535560180712,-6806237473,2264.6785397640715,2065.1490531187287,199.52948664534279,0.7601387900702722,0.7610192569539,-514
1497,2021-02-06,2021,200897,200897,464836834.41666704,3312361.183333326,151878,0,76,0.8523870441071791,53814528,7864557924,201541,201541,60777,262318,424851300.6166599,3308786.7333331564,152622,0,76,0.6579571359952421,6877450618,-644,-644,39985533.800007164,3574.450000169687,-744,0,0,0.19442990811193706,-6823636090,2313.8067488149004,2108.014253261916,205.7924955529843,0.7559993429468832,0.7572751946254112,-744
1498,2021-02-07,2021,192992,192992,464929828.2999995,3202248.2833333337,147127,0,39,0.8595434007627252,53097620,7876069007,193775,193774,59556,253331,425074811.7166686,3200522.599999488,147990,0,39,0.6606534533870698,6889567178,-783,-782,39855016.58333087,1725.683333845809,-863,0,0,0.19888994737565535,-6836469558,2409.0626984538194,2193.6627809544552,215.39991749936416,0.7623476620792572,0.7637208102180364,-863
1499,2021-02-08,2021,183363,183363,464927202.7166666,3133273.116666665,140989,0,43,0.8622841031178601,52960516,7889438985,183980,183980,58554,242534,425100632.93333125,3131478.2999997903,141683,0,44,0.6564316755588913,6909401970,-617,-617,39826569.78333533,1794.816666874569,-694,0,-1,0.20585242755896882,-6856441454,2535.556261168647,2310.5806768851576,224.9755842834893,0.7689064860413497,0.7701000108707469,-694
1500,2021-02-09,2021,179430,179430,464637585.96666723,3105831.566666661,139135,0,59,0.8678258931059468,53230410,7896854320,180011,180011,48770,228781,424971266.8500019,3102329.499999549,139803,0,61,0.6858174411336789,6924371444,-581,-581,39666319.11666536,3502.066667112056,-668,0,-2,0.1820084519722679,-6871141034,2589.5200689219596,2360.80721094823,228.71285797372957,0.7754277434096862,0.7766358722522513,-668
1501,2021-02-10,2021,176093,176093,464528992.2666666,3070446.25,137992,0,82,0.8690521485805796,52610061,7908048336,176679,176679,45615,222294,424961870.11666995,3067736.6499995594,138637,0,83,0.6933610443826697,6931613205,-586,-586,39567122.14999664,2709.6000004406087,-645,0,-1,0.1756911041979099,-6879003144,2637.975344089013,2405.2766322917264,232.6987117972867,0.7836313766021363,0.7846829560955179,-645
1502,2021-02-11,2021,170169,170169,464058629.8000006,3017194.1166666644,133991,0,77,0.8699469351056894,53005587,7914800777,170823,170823,44539,215362,424627435.7333416,3014296.6166662583,134673,0,77,0.6924480641895929,6945346384,-654,-654,39431194.06665903,2897.5000004060566,-682,0,0,0.1774988709160965,-6892340797,2727.045641685622,2485.774373084079,241.27126860154294,0.7873995851183235,0.7883774433185227,-682
1503,2021-02-12,2021,172047,172047,464087481.8666666,3033490.950000003,135099,0,119,0.8727092015553891,53169459,7925934720,172679,172679,41433,214112,424718866.0500003,3030565.5999996923,135704,0,119,0.7065881407861243,6959355076,-632,-632,39368615.816666305,2925.350000310689,-605,0,0,0.1661210607692648,-6906185617,2697.4459413222353,2459.586087769794,237.8598535524411,0.7852447296378315,0.78587436804707,-605
1504,2021-02-13,2021,178982,178982,464452611.83333355,3084283.9000000036,139069,0,198,0.8686013118637629,54567998,7939020981,190154,190154,40711,230865,425154183.3333229,3108294.233332986,146011,0,198,0.7064561540294237,6972958241,-11172,-11172,39298428.50001067,-24010.33333298238,-6942,0,0,0.16214515783433914,-6918390243,2594.968275208309,2235.841388208099,359.12688700021,0.7769999217798438,0.7678565794040619,-6942
1505,2021-02-14,2021,184270,184270,464863656.5999994,3140283.4333333313,141418,0,132,0.8614533022195692,54272725,7951021825,185173,185173,49409,234582,418582415.0333305,3137669.9333329964,142302,0,118,0.6827633833797878,6756553806,-903,-903,46281241.56666893,2613.5000003348105,-884,0,14,0.17868991883978136,-6702281081,2522.7310826504554,2260.493781670819,262.23730097963653,0.7674499375915775,0.7684813660738876,-884
1506,2021-02-15,2021,188414,188414,465641172.4500008,3154342.133333328,144202,0,47,0.8575212033076103,52180839,7969958773,189104,189104,48495,237599,419357451.4999929,3150490.9666663054,144910,0,47,0.6850155093245325,6752094856,-690,-690,46283720.950007915,3851.1666670227423,-708,0,0,0.1725056939830778,-6699914017,2471.3724694024904,2217.602226816952,253.7702425855382,0.7653465241436411,0.7662979101446823,-708
1507,2021-02-16,2021,189928,189928,465988434.9333335,3176250.5666666655,145876,0,43,0.8667653005349397,53552690,7982236408,190691,190691,50643,241334,419720421.366665,3172601.116666459,146677,0,43,0.6878019673978812,6771328887,-763,-763,46268013.56666851,3649.450000206474,-801,0,0,0.17896333313705848,-6717776197,2453.5004577173113,2201.0499780622317,252.45047965507956,0.7680594751695379,0.7691867995867661,-801
1508,2021-02-17,2021,187495,187495,466484775.4833334,3196264.0000000047,144942,0,41,0.8685618283154213,55455723,8001040201,188215,188215,52467,240682,420399040.9000162,3193250.1166662234,145693,0,41,0.6818125161000833,6789027698,-720,-720,46085734.58331722,3013.8833337812684,-751,0,0,0.18674931221533797,-6733571975,2487.985148848414,2233.610715936648,254.37443291176623,0.773044614523054,0.7740775177323805,-751
1509,2021-02-18,2021,199185,199185,467335151.1833339,3267842.5499999938,151497,0,41,0.8512488390190032,55486059,8021138757,200100,200100,49905,250005,421380628.09999907,3264054.8833330953,152505,0,41,0.6847023059538786,6808331316,-915,-915,45954523.0833348,3787.6666668984108,-1008,0,0,0.16654653306512457,-6752845257,2346.236670348339,2105.850215392299,240.38645495603987,0.7605843813540176,0.762143928035982,-1008
1510,2021-02-19,2021,212212,212212,467948916.4833332,3364523.1833333345,158606,0,49,0.8354004486079951,55963210,8040408751,213203,213203,54430,267633,422149889.8666642,3361499.266666719,159616,0,51,0.6682247704879414,6832931987,-991,-991,45799026.616669,3023.9166666152887,-1010,0,-2,0.16717567812005374,-6776968777,2205.101108718325,1980.0372877804916,225.0638209378335,0.7473941153186436,0.7486573828698471,-1010
1511,2021-02-20,2021,213953,213953,468393455.09999967,3451390.4333333303,159341,0,236,0.8352675587629064,56378982,8056495034,214785,214785,63085,277870,422670842.3833279,3447913.6333331433,160281,0,236,0.6484867024147966,6857059690,-832,-832,45722612.716671765,3476.8000001870096,-940,0,0,0.1867808563481098,-6800680708,2189.2352764392162,1967.878773579756,221.3565028594603,0.7447476782283959,0.7462392625183323,-940
1512,2021-02-21,2021,211441,211441,468850784.383333,3412505.249999997,158179,0,100,0.8381250561622401,55883068,8070753389,212213,212213,63056,275269,423295051.76666474,3408932.299999826,159044,0,101,0.6492776157140848,6873575965,-772,-772,45555732.616668284,3572.950000171084,-865,0,-1,0.18884744044815527,-6817692897,2217.4071461227154,1994.6706929672769,222.73645315543854,0.7480999427736342,0.7494545574493551,-865
1513,2021-02-22,2021,215611,215611,469599500.8833332,3411552.8999999957,161476,0,36,0.8393542073456359,54558754,8091672744,229436,229436,64520,293956,424264985.43332815,3469560.449999808,169635,0,36,0.6466682088475891,6894246998,-13825,-13825,45334515.450005054,-58007.54999981215,-8159,0,0,0.1926859984980468,-6839688244,2177.99416951516,1849.1648452436764,328.82932427148376,0.7489228286126404,0.7393565090046897,-8159
1514,2021-02-23,2021,212404,212404,469946919.61666703,3404501.7166666714,159437,0,43,0.8411658914144741,55240168,8105019941,217019,217019,75109,292128,422429918.66666365,3402019.099999692,162326,0,43,0.6241544802278469,6851115800,-4615,-4615,47517000.950003386,2482.616666979622,-2889,0,0,0.21701141118662715,-6795875632,2212.5144517837093,1946.5112209837096,266.00323079999976,0.7506308732415585,0.7479805915611075,-2889
1515,2021-02-24,2021,217225,217225,470590576.5666669,3428889.3333333367,162966,0,54,0.8455288295546094,55495971,8122742706,217904,217904,67787,285691,422075842.8333295,3424876.533333007,163789,0,54,0.6479693094987365,6825724060,-679,-679,48514733.7333374,4012.8000003299676,-823,0,0,0.19755952005587285,-6770228089,2166.373928261788,1936.9807017463172,229.39322651547081,0.7502175164000461,0.7516566928555695,-823
1516,2021-02-25,2021,220531,220531,471076157.6000003,3457546.133333334,166369,0,41,0.8503158286136631,55491896,8133528547,221312,221312,66495,287807,422722181.8500017,3453388.9833329543,167330,0,41,0.6578088788667592,6844008202,-781,-781,48353975.74999863,4157.150000379421,-961,0,0,0.19250694974690385,-6788516306,2136.099494402149,1910.0734792962048,226.02601510594423,0.7544018754732895,0.7560819115095431,-961
1517,2021-02-26,2021,212159,212159,469441631.466666,3419385.0333333323,160270,0,41,0.8459504428282552,55989614,8115776463,212915,212915,68643,281558,421350823.86666065,3415448.6333330926,161101,0,41,0.6433878632466369,6838977479,-756,-756,48090807.60000533,3936.4000002397224,-831,0,0,0.20256257958161827,-6782987865,2212.6878023872,1978.9626088657947,233.72519352140534,0.7554239980392065,0.7566446704083789,-831
1518,2021-02-27,2021,211792,211792,469510545.01666653,3432047.883333332,159813,0,58,0.8448005590390577,57027222,8127383825,215565,215565,65824,281389,421627417.4666634,3427895.649999787,161702,0,58,0.645789281030878,6852234303,-3773,-3773,47883127.55000311,4152.233333544806,-1889,0,0,0.19901127800817975,-6795207081,2216.847402246858,1955.9177856640151,260.929616582843,0.7545752436352647,0.7501310509591075,-1889
1519,2021-02-28,2021,215385,215385,469879670.98333347,3448951.866666663,161973,0,35,0.8417484968776859,56912240,8143225067,216093,216093,66158,282251,422064671.8500063,3445956.883333197,162891,0,37,0.648004790062756,6870897816,-708,-708,47814999.133327186,2994.983333466109,-918,0,-2,0.19374370681492992,-6813985576,2181.5802910292427,1953.1621655953977,228.41812543384503,0.7520161571140052,0.7538004470297511,-918
1520,2021-03-01,2021,217494,217494,470489926.83333313,3443780.8000000054,163010,0,41,0.8434347614187063,56466212,8161285939,218131,218131,66327,284458,422837774.0499979,3440580.599999759,163717,0,42,0.6495756842837886,6891974131,-637,-637,47652152.78333521,3200.200000246521,-707,0,-1,0.19385907713491768,-6835507919,2163.231752753332,1938.4579635631703,224.77378919016155,0.7494919400075405,0.7505443976326153,-707
1521,2021-03-02,2021,217614,217614,470606164.2833333,3441613.05,161640,0,42,0.8349049233964726,56410347,8173935949,218142,218142,69514,287656,423076735.59999734,3437790.8833331466,162298,0,42,0.6360618238451586,6913836904,-528,-528,47529428.68333596,3822.1666668532416,-658,0,0,0.19884309955131396,-6857426557,2162.5730159058394,1939.4556554904482,223.1173604153912,0.7427830929995313,0.7440016136278204,-658
1522,2021-03-03,2021,235420,235420,471239589.8999999,3590108.9166666637,180911,0,34,0.8604366663834853,57215877,8186336951,236013,236013,69450,305463,423921095.39999205,3586725.783333162,181633,0,36,0.6675767605242072,6930167139,-593,-593,47318494.50000787,3383.1333335018717,-722,0,-2,0.19285990585927804,-6872951262,2001.6973489932882,1796.1768860189568,205.5204629743314,0.768460623566392,0.7695889633198171,-722
1523,2021-03-04,2021,237163,237163,472184085.9833326,3713964.916666666,183471,0,40,0.8684491257067916,57625748,8201707102,237849,237849,72698,310547,424926559.1499991,3710604.016666385,184313,0,40,0.6677185740000621,6947711569,-686,-686,47257526.83333349,3360.9000002811663,-842,0,0,0.2007305517067295,-6890085821,1990.9685995848113,1786.5391872574578,204.42941232735348,0.7736071815586748,0.7749160181459666,-842
1524,2021-03-05,2021,234194,234194,472912651.43333334,3644415.6666666656,180892,0,105,0.8700649888553926,57645426,8217396789,234933,234933,74789,309722,425786353.81666,3640099.6666664695,181712,0,105,0.6622939281032644,6966465223,-739,-739,47126297.61667335,4316.000000196043,-820,0,0,0.20777106075212826,-6908819797,2019.3200997178976,1812.3735440174858,206.94655570041186,0.7724023672681622,0.7734630724504433,-820
1525,2021-03-06,2021,222808,222808,473029257.6333337,3554195.6333333356,173806,0,169,0.8832537431331011,56167323,8231081656,223480,223480,79135,302615,426046808.2000024,3550453.949999901,174633,0,169,0.6557209655833401,6986828546,-672,-672,46982449.43333131,3741.68333343463,-827,0,0,0.22753277754976098,-6930661223,2123.03533819851,1906.4202980132557,216.61504018525443,0.7800707335463718,0.7814256309289422,-827
1526,2021-03-07,2021,223874,223874,473556734.78333366,3597329.100000004,173271,0,140,0.8767923028131893,57201152,8248927300,224475,224475,72711,297186,426664300.999994,3593351.6499998653,174052,0,142,0.6656605627451999,7006483692,-601,-601,46892433.78333968,3977.4500001384877,-781,0,-2,0.2111317400679894,-6949282540,2115.2824123539745,1900.7207974161665,214.56161493780792,0.7739666062159964,0.7753736496269072,-781
1527,2021-03-08,2021,232992,232992,474774805.916667,3690263.9500000025,178169,0,147,0.8589307787391839,57728949,8270609373,233691,233691,69255,302946,427953824.06666297,3687082.4333331147,178990,0,148,0.6654123177067817,7030351775,-699,-699,46820981.85000402,3181.5166668877937,-821,0,-1,0.19351846103240222,-6972622826,2037.7300762114878,1831.2807256876088,206.44935052387905,0.7647000755390743,0.7659259449443924,-821
1528,2021-03-09,2021,237634,237634,475729209.49999994,3756531.600000004,185241,0,173,0.8775932736897922,57929426,8287509325,238300,238300,70523,308823,429052554.5333312,3752750.516666272,186072,0,174,0.6801695469573155,7051279174,-666,-666,46676654.966668725,3781.083333731629,-831,0,-1,0.19742372673247677,-6993349748,2001.9408396946562,1800.4723228423468,201.46851685230945,0.7795222905813142,0.7808308854385229,-831
1529,2021-03-10,2021,235838,235838,476630948.51666605,3741701.2333333334,182575,0,167,0.8695502845173383,57165151,8306615328,236414,236414,73910,310324,430081124.26666105,3738652.5833332255,183373,0,169,0.6659716941003571,7071684030,-576,-576,46549824.25000501,3048.6500001079403,-798,0,-2,0.20357859041698123,-7014518879,2021.009966657901,1819.1863606497968,201.8236060081042,0.7741542923532255,0.775643574407607,-798
1530,2021-03-11,2021,239414,239414,477448440.43333274,3746140.716666671,183971,0,167,0.8662108314467836,56879642,8321438644,240182,240182,73021,313203,430989799.56666994,3742087.483333118,184960,0,168,0.667420171582014,7095222181,-768,-768,46458640.8666628,4053.2333335531875,-989,0,-1,0.19879065986476951,-7038342539,1994.23776568343,1794.4300554024446,199.80771028098548,0.7684220638726224,0.7700826872954676,-989
1531,2021-03-12,2021,235567,235567,477867731.8166669,3703494.5166666694,180255,0,130,0.863355223779222,55792980,8336753304,236100,236100,76383,312483,431533523.3833318,3699056.21666637,180976,0,130,0.655027633503259,7115058021,-533,-533,46334208.433335125,4438.300000299234,-721,0,0,0.20832759027596304,-7059265041,2028.5852085252473,1827.7574052661237,200.82780325912358,0.765196313575331,0.7665226598898772,-721
1532,2021-03-13,2021,229197,229197,477937897.98333305,3652492.666666667,174899,0,142,0.8599676261033085,55623950,8347276901,229699,229699,76131,305830,431720576.08332753,3648341.8166664015,175638,0,142,0.6486773697805958,7131996026,-502,-502,46217321.90000552,4150.85000026552,-739,0,0,0.2112902563227127,-7076372076,2085.27117712419,1879.5056838877292,205.765493236461,0.7630946303834693,0.7646441647547443,-739
1533,2021-03-14,2021,230788,230788,478413597.8833335,3649863.1166666695,176626,0,70,0.8612709499627349,56209657,8364743951,231453,231453,72612,304065,432273501.94999504,3645417.3999997154,177506,0,72,0.6586157564994309,7150259543,-665,-665,46140095.93333846,4445.716666954104,-880,0,-2,0.20265519346330396,-7094049886,2072.9569903258985,1867.6513242429135,205.305666082985,0.7653170875435464,0.7669202818714814,-880
1534,2021-03-15,2021,237808,237808,479190727.65000004,3717177.6499999966,180335,0,174,0.8531714660566508,56695229,8384589485,238493,238493,72205,310698,433173450.51666623,3713601.3666663594,181208,0,175,0.6577770053234886,7167720100,-685,-685,46017277.1333338,3576.283333637286,-873,0,-1,0.19539446073316225,-7111024871,2015.0319907236092,1816.294191094356,198.73779962925323,0.7583218394671332,0.7598042709848927,-873
1535,2021-03-16,2021,238943,238943,479726406.0666666,3699013.3166666655,181158,0,225,0.8542246477193308,55727249,8398321279,239549,239549,74604,314153,433830633.3666639,3694798.633333075,181934,0,228,0.6543117525536912,7187748553,-606,-606,45895772.70000273,4214.683333590627,-776,0,-3,0.1999128951656396,-7132021304,2007.7022807391998,1811.0308678669662,196.67141287223353,0.7581640809732865,0.7594855332311969,-776
1536,2021-03-17,2021,243473,243473,480519516.91666687,3757895.3000000026,182366,0,120,0.8434816180849609,57157323,8415603381,244244,244244,75482,319726,434801625.4833279,3753960.133333101,183276,0,120,0.6480893014643788,7208062829,-771,-771,45717891.43333894,3935.1666669016704,-910,0,0,0.1953923166205821,-7150905506,1973.6049455860275,1780.1936812504214,193.41126433560612,0.7490193984548594,0.7503807667742094,-910
1537,2021-03-18,2021,237964,237964,481120139.4000005,3550212.1499999953,179022,0,130,0.8473466574776015,56359410,8433216490,238606,238606,77597,316203,435529116.76666087,3546457.9499999373,179834,0,131,0.6425524109512082,7227373209,-642,-642,45591022.63333964,3754.2000000579283,-812,0,-1,0.20479424652639333,-7171013799,2021.8190121194825,1825.3066426102482,196.5123695092343,0.7523070716578978,0.7536859928082278,-812
1538,2021-03-19,2021,237863,237863,481648846.1166668,3710624.5833333326,178567,0,129,0.8457305255546248,55040619,8446085376,238526,238526,78527,317053,436183758.4666575,3706278.216666569,179361,0,130,0.6390666544710261,7250211967,-663,-663,45465087.650009274,4346.366666763555,-794,0,-1,0.20666387108359874,-7195171348,2024.900241385448,1828.663367794947,196.2368735905011,0.7507136460903966,0.751955761636048,-794
1539,2021-03-20,2021,230466,230466,481820366.34999967,3622509.1333333333,174177,0,128,0.8486457872310885,57162036,8461988833,231011,231011,77867,308878,436401806.48332024,3618239.9166664924,174889,0,129,0.6377242794890082,7269043501,-545,-545,45418559.86667943,4269.216666840948,-712,0,-1,0.2109215077420803,-7211881465,2090.63534903196,1889.0953525300538,201.539996501906,0.7557600687303117,0.7570591876577306,-712
1540,2021-03-21,2021,218149,218149,481790933.4166665,3547345.9499999997,165807,0,134,0.8570014072950142,56648615,8475883580,218677,218677,77254,295931,436498665.1166635,3543594.966666406,166517,0,135,0.637391824445564,7287161430,-528,-528,45292268.30000299,3750.9833335937,-710,0,-1,0.2196095828494502,-7230512815,2208.5406461485795,1996.0885923835772,212.45205376500235,0.7600630761543715,0.7614746864096361,-710
1541,2021-03-22,2021,234387,234387,482546101.866667,3674283.283333334,176229,0,138,0.8478499234172542,56734379,8494253958,234758,234758,67838,302596,437362446.74999547,3670343.2333331127,176810,0,138,0.6609505743631856,7310275325,-371,-371,45183655.1166715,3940.0500002214685,-581,0,0,0.18689934905406858,-7253540946,2058.7579595569164,1863.0353246747522,195.72263488216413,0.7518719041585071,0.7531585718058597,-581
1542,2021-03-23,2021,239506,239506,483322629.81666696,3701752.350000001,179247,0,127,0.8400290598147856,56507097,8510979775,239995,239995,70656,310651,438223172.0999972,3697766.166666246,179882,0,129,0.6516959546243214,7325626961,-489,-489,45099457.71666974,3986.183333755005,-635,0,-2,0.1883331051904642,-7269119864,2017.9980034599007,1825.9679247484207,192.03007871147997,0.7484029627650247,0.749523948415592,-635
1543,2021-03-24,2021,241792,241792,483922167.9166664,3778075.9166666735,180114,0,58,0.8406233456855481,57534750,8523754022,246858,246858,75645,322503,438944816.7333281,3778688.016666549,182630,0,59,0.6403196249337195,7344147088,-5066,-5066,44977351.183338284,-612.0999998752959,-2516,0,-1,0.20030372075182856,-7286612338,2001.3985901794367,1778.1267641045788,223.27182607485793,0.74491298305982,0.7398180330392371,-2516
1544,2021-03-25,2021,246021,246021,485024295.0333341,3808545.5000000033,181540,0,160,0.8292909954841253,57863565,8542464139,246754,246754,80333,327087,439835132.51665896,3804029.883333093,182411,0,160,0.6287837792391687,7359840887,-733,-733,45189162.516675115,4515.616666910239,-871,0,0,0.2005072162449566,-7301977322,1971.4751790836315,1782.4843062996301,188.99087278400134,0.7379044878282748,0.7392423223129109,-871
1545,2021-03-26,2021,245237,245237,485167075.3833339,3759229.2499999925,180433,0,80,0.8206469659961588,57797216,8547977576,245759,245759,79099,324858,439991925.3166687,3755223.0333332643,181135,0,80,0.6233338874215903,7368880355,-522,-522,45175150.06666523,4006.216666728258,-702,0,0,0.19731307857456848,-7311083139,1978.3600165690084,1790.3390122708372,188.0210042981712,0.735749499463784,0.7370432008593785,-702
1546,2021-03-27,2021,234717,234717,485147586.2666661,3695013.866666664,175544,0,77,0.8348607045931912,56908907,8554904344,235217,235217,82164,317381,440084094.7166669,3691041.283333342,176206,0,78,0.6210989315680419,7382204625,-500,-500,45063491.54999924,3972.583333321847,-662,0,-1,0.21376177302514932,-7325295718,2066.9469457545306,1870.9706131642988,195.97633259023178,0.7478964029022184,0.7491210244157522,-662
1547,2021-03-28,2021,237001,237001,485990937.21666646,3698548.733333334,174001,0,82,0.8240302783532563,56964436,8576400016,237518,237518,76242,313760,441001012.6333289,3695058.6500000237,174710,0,82,0.626239801121883,7398474102,-517,-517,44989924.583337545,3490.0833333102055,-709,0,0,0.19779047723137322,-7341509666,2050.5860195385944,1856.7056502384194,193.88036930017506,0.7341783368002667,0.7355653045242887,-709
1548,2021-03-29,2021,246468,246468,486972112.1499998,3795741.716666671,180546,0,87,0.8232427739097974,57523195,8595110433,246878,246878,74597,321475,442182231.7666641,3791213.1833331813,181134,0,87,0.6344008087720657,7422762315,-410,-410,44789880.38333571,4528.533333489671,-588,0,0,0.18884196513773166,-7365239120,1975.8025875570045,1791.0961356081307,184.7064519488738,0.7325332294658942,0.7336984259431785,-588
1549,2021-03-30,2021,253151,253151,487623304.3166662,3891438.3666666616,184931,0,104,0.8220350699779974,58728205,8607255714,253874,253874,76044,329918,442997568.28332996,3887305.749999835,185676,0,104,0.6346516407107045,7445587302,-723,-723,44625736.03333622,4132.6166668264195,-745,0,0,0.1873834292672929,-7386859097,1926.2152008748383,1744.9505198773013,181.26468099753697,0.7305165691622787,0.7313706799435941,-745
1550,2021-03-31,2021,252200,252200,488522524.56666654,3880635.783333329,185830,0,146,0.8289770023790635,58391430,8624467297,252843,252843,80230,333073,443973447.13332623,3876612.4166665664,186642,0,147,0.6321256901640391,7462265879,-643,-643,44549077.43334031,4023.366666762624,-812,0,-1,0.1968513122150244,-7403874449,1937.0441100978055,1755.925404829583,181.11870526822258,0.7368358445678034,0.7381734910596695,-812
1551,2021-04-01,2021,242976,242976,488754904.7333333,3794234.300000003,180277,0,127,0.834378704069538,57504421,8638035667,243614,243614,82667,326281,444322451.18332356,3789536.2833333393,181103,0,128,0.6257397764503541,7482581540,-638,-638,44432453.55000973,4698.016666663811,-826,0,-1,0.2086389276191839,-7425077119,2011.5357267110055,1823.8789691205086,187.6567575904969,0.7419539378374819,0.7434014465506908,-826
1552,2021-04-02,2021,237948,237948,488729014.2666665,3728331.5166666657,178635,0,124,0.8421377780019162,57103951,8646808822,238555,238555,78816,317371,444411907.516657,3723743.966666475,179386,0,124,0.6353479051331107,7498734178,-607,-607,44317106.75000948,4587.550000190735,-751,0,0,0.20678987286880557,-7441630227,2053.9320114758957,1862.9326885483724,190.99932292752328,0.7507312522063644,0.7519691475760307,-751
1553,2021-04-03,2021,227477,227477,488401157.1833333,3617192.61666666,172290,0,142,0.8499057047525678,57084780,8655106397,228002,228002,76772,304774,444136975.3666639,3613430.9333332023,173000,0,143,0.6381023315637196,7509190492,-525,-525,44264181.816669405,3761.6833334579132,-710,0,-1,0.21180337318884812,-7452105712,2147.035336246448,1947.952102905518,199.08323334093006,0.7573952531464719,0.7587652739888247,-710
1554,2021-04-04,2021,221212,221212,488179823.33333343,3583696.5500000026,167292,0,150,0.8494204654358718,56934821,8663331906,221736,221736,74517,296253,444051694.9333292,3579920.4499998824,167972,0,151,0.6384542941337273,7523695308,-524,-524,44128128.40000421,3776.1000001202337,-680,0,-1,0.21096617130214446,-7466760487,2206.841506488497,2002.6143473920754,204.2271590964217,0.7562519212339295,0.7575314788757802,-680
1555,2021-04-05,2021,231361,231361,489030072.2333335,3665325.533333334,172475,0,134,0.8354044112879869,57499613,8683768108,231983,231983,67314,299297,444967894.3333268,3661313.633333197,173245,0,136,0.6503306080582003,7535844486,-622,-622,44062177.90000671,4011.900000137277,-770,0,-2,0.18507380322978662,-7478344873,2113.7100558578736,1918.1056126238855,195.60444323398815,0.7454800074342693,0.7468004120991625,-770
1556,2021-04-06,2021,236055,236055,489545867.31666577,3710683.449999998,174939,0,119,0.8295736163182321,57996118,8699556934,236876,236876,68985,305861,445605137.4166527,3707243.5666663954,175854,0,121,0.6451231114787378,7556286031,-821,-821,43940729.90001309,3439.8833336024545,-915,0,-2,0.18445050483949432,-7498289913,2073.8635797448296,1881.1746965359625,192.68888320886708,0.7410942365126771,0.7423884226346275,-915
1557,2021-04-07,2021,239442,239442,489578961.7166662,3747109.133333338,176961,0,163,0.8281838608097165,58365204,8712065482,240241,240241,71954,312195,445764986.249987,3742737.416666673,177792,0,164,0.6396547029901085,7576585352,-799,-799,43813975.466679215,4371.716666664928,-831,0,-1,0.188529157819608,-7518220148,2044.6661893764094,1855.4908872756398,189.1753021007696,0.7390558047460345,0.7400568595701816,-831
1558,2021-04-08,2021,238015,238015,489975003.733333,3730253.33333333,176616,0,131,0.8354431443396427,58059865,8724256022,238862,238862,75101,313963,446270745.4166582,3726806.183333254,177501,0,132,0.6385975417485481,7594044475,-847,-847,43704258.31667477,3447.1500000762753,-885,0,-1,0.19684560259109463,-7535984610,2058.5887600921496,1868.3203917603396,190.26836833181005,0.7420372665588303,0.7431110850616675,-885
1559,2021-04-09,2021,248752,248752,490679729.5000002,3863180.3833333324,192770,0,164,0.8746020132501449,58889798,8738951145,249540,249540,74592,324132,447125179.33331966,3858904.5499997013,193659,0,165,0.6753112929300481,7613059690,-788,-788,43554550.166680515,4275.833333631046,-889,0,-1,0.19929072032009676,-7554169892,1972.5659673088062,1791.7976249632109,180.76834234559533,0.7749485431272914,0.7760639576821351,-889
1560,2021-04-10,2021,249296,249296,491237018.3500004,3874599.966666667,191711,0,243,0.8612813683332258,58137612,8753845941,249825,249825,78368,328193,447826210.6333278,3870325.4333332395,192380,0,244,0.6570889689908138,7627430426,-529,-529,43410807.7166726,4274.533333427273,-669,0,-1,0.20419239934241196,-7569292814,1970.4969929320982,1792.5596342773053,177.9373586547929,0.7690095308388422,0.7700590413289302,-669
1561,2021-04-11,2021,246963,246963,491844547.86666614,3851618.1833333327,189084,0,165,0.8642023299036717,57464613,8769518137,260201,260201,80023,340224,448501841.8499876,3858224.016666547,194942,0,166,0.6463859104589987,7644454828,-13238,-13238,43342706.01667851,-6605.833333214279,-5858,0,-1,0.217816419444673,-7586990215,1991.5718057630743,1723.6745510201254,267.8972547429489,0.7656369577629037,0.7491977355967118,-5858
1562,2021-04-12,2021,245237,245237,492367551.6166668,3855078.6500000036,189094,0,370,0.8685434905825797,57128383,8784179945,261426,261426,86454,347880,447923901.56665176,3913175.3333331216,196551,0,374,0.6359865470852201,7644044334,-16189,-16189,44443650.05001503,-58096.68333311798,-7457,0,-4,0.23255694349735967,-7586915951,2007.7213129204272,1713.3869682688476,294.3343446515796,0.7710663562186783,0.7518418213949646,-7457
1563,2021-04-13,2021,248214,248214,492655970.0166669,3805069.2333333325,188459,0,164,0.849722416946667,57304385,8795141056,248809,248809,89526,338335,442784839.51666045,3801094.5333331143,189151,0,165,0.6266924793474079,7460631388,-595,-595,49871130.50000644,3974.7000002181157,-692,0,-1,0.22302993759925904,-7403327003,1984.8033149486607,1779.6174556252404,205.18585932342035,0.7592601545440628,0.760225715307726,-692
1564,2021-04-14,2021,246109,246109,493108675.3833335,3820139.716666668,185725,0,160,0.8404812501777671,58028979,8808446417,246702,246702,81286,327988,443334885.86666244,3816182.133333026,186408,0,161,0.6341116138395309,7461512403,-593,-593,49773789.51667106,3957.583333642222,-683,0,-1,0.20636963633823624,-7403483424,2003.6190280864719,1797.046176628736,206.57285145773585,0.7546452994404919,0.7555998735316293,-683
1565,2021-04-15,2021,249061,249061,493440217.18333375,3847645.016666672,187911,0,164,0.8386058033975613,58590300,8819982064,249604,249604,79067,328671,443866352.5999944,3843556.2333330647,188482,0,165,0.6388881282498363,7482185562,-543,-543,49573864.58333933,4088.7833336074837,-571,0,-1,0.19971767514772498,-7423595262,1981.2022644385663,1778.2822094196986,202.92005501886774,0.7544778186869884,0.7551241166006954,-571
1566,2021-04-16,2021,265129,265129,493875268.3666667,3896425.8500000024,193010,0,159,0.8148976535950431,59785049,8836234982,266386,266386,81514,347900,444459687.1166651,3892067.516666385,193896,0,160,0.6249094567404392,7497623456,-1257,-1257,49415581.25000155,4358.333333617542,-886,0,-1,0.18998819685460389,-7437838407,1862.7734739189855,1668.479901784122,194.29357213486355,0.7279852449185114,0.7278760895842875,-886
1567,2021-04-17,2021,245034,245034,493664209.04999965,3790301.233333331,185127,0,161,0.8443807798101479,59775586,8843211586,245507,245507,95421,340928,444379793.5499886,3786187.8166664904,185766,0,161,0.6100818941242782,7514447854,-473,-473,49284415.50001103,4113.416666840669,-639,0,0,0.23429888568586976,-7454672268,2014.676367565316,1810.0493816876449,204.62698587767113,0.7555155611058058,0.7566627428138505,-639
1568,2021-04-18,2021,244833,244833,494240871.98333406,3806422.566666668,184171,0,165,0.8409323906499528,59503567,8860015491,245364,245364,82865,328229,445047556.5999914,3802490.583333036,184817,0,166,0.6305049218685684,7529219772,-531,-531,49193315.38334268,3931.9833336318843,-646,0,-1,0.2104274687813844,-7469716205,2018.685683642867,1813.8258122625625,204.8598713803044,0.75223111263596,0.7532360085424105,-646
1569,2021-04-19,2021,246417,246417,495021679.333334,3830434.1999999993,183640,0,158,0.8274023301963745,60404750,8879299309,246950,246950,79533,326483,446046145.46666145,3826835.116666315,184326,0,159,0.628066392430837,7548617772,-533,-533,48975533.866672575,3599.0833336841315,-686,0,-1,0.1993359377655376,-7488213022,2008.8779562016177,1806.2204716204149,202.65748458120288,0.7452407910168536,0.746410204494837,-686
1570,2021-04-20,2021,253321,253321,495647320.8000002,3905492.2333333343,186606,0,122,0.8197978059458161,60032268,8895657970,253805,253805,77208,331013,446843902.28332824,3901617.6166663556,187245,0,123,0.6306247790872319,7574096512,-484,-484,48803418.516671956,3874.616666978691,-639,0,-1,0.18917302685858417,-7514064244,1956.5978375263014,1760.579587806892,196.01824971940937,0.7366384942424828,0.7377514233368136,-639
1571,2021-04-21,2021,250641,250641,496202890.06666654,3889972.649999995,185290,0,42,0.8236202377105103,59020657,8905383372,251257,251257,79632,330889,447558663.66666675,3885940.949999693,185983,0,42,0.6274218846803737,7588674068,-616,-616,48644226.3999998,4031.700000301935,-693,0,0,0.19619835303013655,-7529653411,1979.735518397495,1781.278386937147,198.45713146034814,0.7392645257559617,0.7402102229987623,-693
1572,2021-04-22,2021,244239,244239,496644211.1333335,3810877.583333333,182079,0,36,0.830792789030417,58731966,8922549201,244807,244807,81659,326466,448054006.79998755,3807161.933333064,182787,0,36,0.6250053604356974,7607275419,-568,-568,48590204.33334595,3715.650000269059,-708,0,0,0.20578742859471955,-7548543453,2033.4353282372329,1830.2336403778795,203.20168785935334,0.7454951911856829,0.7466575710661868,-708
1573,2021-04-23,2021,247369,247369,496967543.3999999,3799515.350000002,183814,0,37,0.8286689116259516,59064261,8935136179,248500,248500,78027,326527,448507543.06667054,3797296.7999999,184802,0,37,0.6322662444453361,7626673625,-1131,-1131,48460000.33332938,2218.5500001017936,-988,0,0,0.1964026671806155,-7567609364,2009.013026692916,1804.8593282360987,204.1536984568172,0.7430761332260711,0.7436700201207244,-988
1574,2021-04-24,2021,245514,245514,497140908.44999975,3823842.1833333275,183500,0,46,0.8327590279984035,59505549,8947114131,245915,245915,82333,328248,448616996.88332325,3819201.483333151,184143,0,46,0.6265811215909954,7637467389,-401,-401,48523911.5666765,4640.700000176672,-643,0,0,0.20617790640740807,-7577961840,2024.898410884918,1824.276668293204,200.62174259171388,0.7474115529053333,0.7488075147916963,-643
1575,2021-04-25,2021,245177,245177,497722905.2666664,3834913.9166666674,183069,0,38,0.8363019369679863,59780603,8964686490,245683,245683,78651,324334,449311142.6666647,3830809.1499999706,183759,0,38,0.6358414473968259,7654050131,-506,-506,48411762.60000169,4104.766666696873,-690,0,0,0.20046048957116036,-7594269528,2030.0554508239616,1828.8247158601316,201.23073496382995,0.7466809692589436,0.7479516287248202,-690
1576,2021-04-26,2021,248768,248768,498593704.83333313,3873760.066666669,185359,0,33,0.8288485657319272,59894360,8981227876,249422,249422,78987,328409,450313711.60000074,3869277.5666666026,186154,0,33,0.6324613515464037,7675157047,-654,-654,48279993.233332396,4482.50000006659,-795,0,0,0.19638721418552352,-7615262687,2004.2517720660742,1805.428998243943,198.82277382213124,0.7451078916902496,0.7463415416442816,-795
1577,2021-04-27,2021,255758,255758,499444178.48333293,3958048.7999999984,188431,0,96,0.824400409762353,60648400,8995545318,256769,256769,76811,333580,451310593.2999958,3953080.6166665303,189524,0,96,0.6372714191498119,7695040107,-1011,-1011,48133585.18333715,4968.183333468158,-1093,0,0,0.18712899061254107,-7634391707,1952.799828288198,1757.6521827011663,195.14764558703155,0.7367550575153075,0.73811090902718,-1093
1578,2021-04-28,2021,265952,265952,500413301.29999965,4090520.5333333327,203622,0,40,0.8585383828660814,61111324,9009407531,266639,266639,79858,346497,452352608.7166592,4085833.733333168,204445,0,40,0.6633592787238975,7715958396,-687,-687,48060692.583340466,4686.800000164658,-823,0,0,0.19517910414218387,-7654847072,1881.5925479033797,1696.4982943855146,185.09425351786513,0.7656344001925159,0.7667483001361391,-823
1579,2021-04-29,2021,268066,268066,501255909.96666694,4111281.833333333,204405,0,41,0.8544425626524812,60305887,9025856379,268727,268727,83261,351988,453367543.3833263,4105852.8166661463,205289,0,41,0.6554541632101268,7736100754,-661,-661,47888366.583340645,5429.016667186748,-884,0,0,0.19898839944235436,-7675794867,1869.8973758949921,1687.0933824413858,182.80399345360638,0.7625174397349906,0.7639314248289156,-884
1580,2021-04-30,2021,272808,272808,501961760.8166672,4138069.1500000083,212105,0,54,0.8716130025512443,61913310,9047163726,273398,273398,85843,359241,454150522.73332816,4132211.5333330203,213029,0,54,0.667292987159046,7758157882,-590,-590,47811238.083339036,5857.616666988004,-924,0,0,0.20432001539219835,-7696244572,1839.981821708554,1661.1333028527208,178.84851885583316,0.7774881968270725,0.7791900452819699,-924
1581,2021-05-01,2021,254206,254206,501163674.7499999,3945075.383333334,197602,0,44,0.8644327828611442,60729731,9053947744,257285,257285,94685,351970,453504347.5999952,3940126.8333330466,199504,0,44,0.6325652754496202,7775013024,-3079,-3079,47659327.150004685,4948.550000287127,-1902,0,0,0.23186750741152407,-7714283293,1971.486411611055,1762.6536626697832,208.8327489412718,0.7773301967695491,0.7754202538041471,-1902
1582,2021-05-02,2021,241310,241310,501145977.16666687,3851493.7166666677,188437,0,48,0.8660768306327972,60130120,9066343349,241676,241676,88505,330181,453584975.8666706,3846262.8833329375,189268,0,51,0.6380227814441091,7788750990,-366,-366,47561001.29999626,5230.833333730232,-831,0,-3,0.2280540491886881,-7728620870,2076.772521514512,1876.8308639114791,199.9416576030328,0.7808917989308358,0.7831476853307734,-831
1583,2021-05-03,2021,231615,231615,501565955.3500001,3775194.816666666,180471,0,48,0.8632083414286643,59033490,9084612787,232277,232277,76923,309200,454089297.883333,3770879.0833330234,181296,0,48,0.6522703751617105,7806522378,-662,-662,47476657.466667056,4315.7333336425945,-825,0,0,0.21093796626695382,-7747488888,2165.515857565357,1954.947316709502,210.56854085585474,0.7791852859270773,0.7805163662351416,-825
1584,2021-05-04,2021,231210,231210,501789250.23333335,3773377.2166666733,179746,0,57,0.8606937416201731,59130220,9096539846,232059,232059,68787,300846,454460991.69999915,3769170.716666454,180691,0,57,0.6680328141307995,7825582595,-849,-849,47328258.533334196,4206.5000002193265,-945,0,0,0.19266092748937358,-7766452375,2170.274859363061,1958.385547209973,211.88931215308776,0.7774144716924009,0.7786425003986055,-945
1585,2021-05-05,2021,236079,236079,502501183.9333336,3820185.7666666685,182448,0,63,0.8527357367660819,60444414,9110835119,236790,236790,66944,303734,455237682.6499957,3815604.999999689,183322,0,56,0.6684566100601164,7843882426,-711,-711,47263501.28333789,4580.766666979529,-874,0,7,0.18427912670596558,-7783438012,2128.529788474763,1922.5376183537974,205.9921701209655,0.7728260455186611,0.7741965454622239,-874
1586,2021-05-06,2021,238113,238113,503338768.9499999,3838631.3333333344,184749,0,55,0.8570258658704059,60081171,9129429426,238878,238878,68774,307652,456243992.11667293,3833655.2499996666,185657,0,57,0.6702670549841897,7863169977,-765,-765,47094776.833326995,4976.083333667833,-908,0,-2,0.18675881088621615,-7803088806,2113.86513525091,1909.9456296380283,203.91950561288172,0.7758879187612604,0.777204263264093,-908
1587,2021-05-07,2021,239496,239496,503974481.95000046,3829095.0833333316,186376,0,93,0.8626824665130104,60303054,9144427176,240324,240324,70956,311280,456996306.93333143,3824441.549999757,187376,0,93,0.6701747622718927,7879933880,-828,-828,46978175.016669035,4653.533333574422,-1000,0,0,0.19250770424111774,-7819630826,2104.312731527877,1901.5841402994768,202.72859122840032,0.7782008885325851,0.7796807643015262,-1000
1588,2021-05-08,2021,241780,241780,504318483.98333377,3839251.9333333313,186806,0,76,0.8578583836545617,61355857,9152141021,242414,242414,72567,314981,457491974.15000266,3834255.0499995886,187622,0,78,0.6641352970496697,7900589646,-634,-634,46826509.83333111,4996.883333742619,-816,0,-2,0.19372308660489201,-7839233789,2085.8569111726933,1887.2341290107117,198.6227821619816,0.7726280089337414,0.7739734503782785,-816
1589,2021-05-09,2021,239096,239096,504927664.59999955,3816128.3499999964,184515,0,93,0.8582284939940437,60993743,9171445935,239677,239677,74170,313847,458177612.61666346,3811540.1833329946,185317,0,93,0.6592065560607497,7920870887,-581,-581,46750051.98333609,4588.166667001788,-802,0,0,0.19902193793329392,-7859877144,2111.819790377085,1911.6461430035567,200.1736473735284,0.7717193093987352,0.7731947579450678,-802
1590,2021-05-10,2021,237352,237352,505667252.34999985,3782117.866666672,183077,0,57,0.8534370892177022,59895669,9193323952,238184,238184,75947,314131,458960939.3333374,3778162.799999701,184050,0,57,0.651190108585279,7941278216,-832,-832,46706313.01666242,3955.066666970961,-973,0,0,0.2022469806324232,-7881382547,2130.4528815851554,1926.917590322345,203.53529126281046,0.7713311874346962,0.7727219292647701,-973
1591,2021-05-11,2021,241716,241716,505256812.06666726,3871900.9333333313,191063,0,45,0.8741250062056286,61458841,9187462979,242523,242523,71366,313889,458711385.18333054,3867980.149999784,191986,0,47,0.6795555116617714,7947921669,-807,-807,46545426.88333672,3920.7833335474133,-923,0,-2,0.1945694945438572,-7886462828,2090.29113532686,1891.4139491237142,198.8771862031458,0.7904441576064473,0.7916197638986818,-923
1592,2021-05-12,2021,245082,245082,505604114.1166663,3912147.900000004,194183,0,64,0.8744257024179657,60976104,9196583004,245774,245774,70220,315994,459115393.1166662,3908270.166666288,195046,0,64,0.6842914738887621,7962330194,-692,-692,46488721.00000012,3877.733333716169,-863,0,0,0.19013422852920359,-7901354090,2062.999788302145,1868.038902067209,194.9608862349362,0.7923184893219413,0.7935989974529446,-863
1593,2021-05-13,2021,246870,246870,506039571.69999945,3931835.583333336,193875,0,123,0.864398266294001,61364680,9214946378,247616,247616,73261,320877,459644258.350008,3927927.533333131,194798,0,124,0.6710016610726467,7976769761,-746,-746,46395313.34999144,3908.0500002047047,-923,0,-1,0.19339660522135427,-7915405081,2049.8220589784073,1856.278505225866,193.54355375254136,0.7853323611617451,0.7866939131558542,-923
1594,2021-05-14,2021,246556,246556,506467120.7166665,3902771.149999998,192910,0,82,0.8608348610457672,60488854,9227987681,247214,247214,74643,321857,460271999.53333795,3898459.116666497,193736,0,82,0.6654725545817073,7996619038,-658,-658,46195121.18332857,4312.033333500847,-826,0,0,0.19536230646405994,-7936130184,2054.166683092955,1861.8363018815194,192.33038121143545,0.7824185986145136,0.7836772998292977,-826
1595,2021-05-15,2021,240429,240429,506601247.43333393,3844881.4499999993,187943,0,73,0.8624417187610489,60582349,9239362145,240986,240986,76767,317753,460462319.93332684,3840767.2499998156,188718,0,75,0.6580110966694284,8014960386,-557,-557,46138927.50000709,4114.200000183657,-775,0,-2,0.20443062209162055,-7954378037,2107.0721395228275,1910.743030438809,196.32910908401846,0.7816985471802487,0.7831077323993925,-775
1596,2021-05-16,2021,237073,237073,506672662.9833334,3783254.799999994,184987,0,102,0.8582672847603892,59548254,9247032431,237584,237584,74925,312509,460665529.9500066,3779265.516666437,185691,0,103,0.6565058926302858,8027558337,-511,-511,46007133.033326805,3989.2833335571922,-704,0,-1,0.20176139213010336,-7968010083,2137.201043490121,1938.958557604917,198.2424858852039,0.7802955207889553,0.7815804094551821,-704
1597,2021-05-17,2021,239825,239825,507270360.7499996,3851913.2333333353,186293,0,37,0.8569373501511514,60011762,9261742775,240353,240353,73515,313868,461374137.749997,3847960.8499996467,187028,0,38,0.6590764270330269,8042341352,-528,-528,45896223.00000256,3952.383333688602,-735,0,-1,0.19786092311812442,-7982329590,2115.1688137183346,1919.568874738393,195.5999389799415,0.7767872406963411,0.7781388208177139,-735
1598,2021-05-18,2021,241223,241223,507760100.2833334,3863592.7166666654,186384,0,174,0.8517554296232116,59319984,9271722545,241636,241636,69215,310851,461995757.28333324,3859697.549999729,186950,0,175,0.6649713206648902,8057046121,-413,-413,45764343.00000018,3895.166666936595,-566,0,-1,0.18678410895832143,-7997726137,2104.9406577454615,1911.9492016228262,192.99145612263533,0.7726626399638509,0.7736843847771028,-566
1599,2021-05-19,2021,240876,240876,508612781.00000024,3843835.7499999995,185662,0,155,0.8508029027383381,59532247,9292147672,241420,241420,71134,312554,462927134.54999596,3840151.2166663986,186198,0,157,0.6590925088144535,8075270249,-544,-544,45685646.45000428,3684.5333336009644,-536,0,-2,0.19171039392388467,-8015738002,2111.5128987528865,1917.5177472868693,193.9951514660172,0.7707783257775785,0.7712617015988733,-536
1600,2021-05-20,2021,235101,235101,508906526.8499999,3792422.4833333315,182885,0,156,0.8577122173023509,59131885,9304013146,235441,235441,73811,309252,463337363.6833349,3788620.6499996167,183348,0,158,0.6551032814662332,8094688031,-340,-340,45569163.16666502,3801.833333714865,-463,0,-2,0.20260893583611772,-8035556146,2164.6293586586185,1967.955299558424,196.67405910019443,0.7778997111879575,0.7787428697635501,-463
1601,2021-05-21,2021,241841,241841,509308473.9833333,3891028.166666668,192781,0,150,0.8780397037723134,59303193,9316748510,242229,242229,71271,313500,463852689.5333331,3887652.1166663514,193260,0,151,0.6810558213716189,8112540988,-388,-388,45455784.45000017,3376.0500003164634,-479,0,-1,0.19698388240069453,-8053237795,2105.9641416605673,1914.9345847662053,191.02955689436203,0.7971394428570838,0.7978400604386758,-479
1602,2021-05-22,2021,244948,244948,509736750.66666716,4013828.0666666664,192561,0,159,0.8704418897072029,59449607,9321530277,245378,245378,67796,313174,464454527.8999996,4010231.9333331236,193109,0,159,0.6850313244394393,8125098204,-430,-430,45282222.766667545,3596.13333354285,-548,0,0,0.18541056526776367,-8065648597,2080.9998475867005,1892.8124277645088,188.1874198221917,0.7861301174126754,0.7869857933474068,-548
1603,2021-05-23,2021,244611,244611,510746107.6500006,3998955.9499999997,192790,0,154,0.8756719853154604,60688265,9340525402,245115,245115,69873,314988,465617842.81665707,3995262.149999864,193447,0,155,0.6846927502000095,8141178182,-504,-504,45128264.833343506,3693.800000135787,-657,0,-1,0.1909792351154509,-8080489917,2087.993212283996,1899.5893471091408,188.40386517485513,0.7881493473310686,0.7892091467270465,-657
1604,2021-05-24,2021,246461,246461,511905418.35000056,3997201.2333333404,194401,0,155,0.874154531548602,60157531,9363327606,247055,247055,71812,318867,466881773.48333865,3993735.1333329966,195070,0,156,0.6798414385935234,8164689664,-594,-594,45023644.866661906,3466.100000343751,-669,0,-1,0.1943130929550786,-8104532133,2077.0240255050517,1889.7888060688456,187.23521943620608,0.7887698256519287,0.7895812673291372,-669
1605,2021-05-25,2021,245318,245318,512585493.04999995,4007345.500000002,194130,0,47,0.8860132562632999,60062544,9379230998,245990,245990,71265,317255,467648606.44999653,4003524.733332603,194987,0,49,0.6915352003908538,8188460777,-672,-672,44936886.60000342,3820.76666739909,-857,0,-2,0.19447805587244604,-8128398233,2089.473634425521,1901.087875320121,188.3857591054002,0.7913402196332923,0.7926623033456645,-857
1606,2021-05-26,2021,243092,243092,513463987.7333332,3988240.2833333355,192724,0,287,0.8815921544106752,59591061,9398099919,243673,243673,69650,313323,468547107.25000286,3984215.649999725,193412,0,287,0.6890429365223725,8205054645,-581,-581,44916880.48333031,4024.6333336103708,-688,0,0,0.1925492178883027,-8145463584,2112.2208371041957,1922.8519665699641,189.36887053423152,0.7928027248942787,0.7937358673303977,-688
1607,2021-05-27,2021,247862,247862,514157113.2666668,4026773.416666664,196479,0,261,0.8802922594024096,60044284,9411261292,248372,248372,68543,316915,469387417.2499983,4023446.7166662687,197054,0,261,0.692040452487256,8223899544,-510,-510,44769696.01666856,3326.7000003955327,-575,0,0,0.18825180691515364,-8163855260,2074.3684520687593,1889.856413967751,184.51203810100833,0.792695128740993,0.793382506884834,-575
1608,2021-05-28,2021,253766,253766,514872535.4166665,4056199.4499999993,201678,0,50,0.8821512732202108,60407363,9424276029,254305,254305,70584,324889,470230459.78333056,4052600.6666654195,202328,0,50,0.6929074237662644,8241458967,-539,-539,44642075.63333595,3598.7833345797844,-650,0,0,0.18924384945394646,-8181051604,2028.926394460513,1849.0806699959912,179.8457244645217,0.7947400360962461,0.7956115687855134,-650
1609,2021-05-29,2021,255821,255821,515475032.1499996,4113697.299999998,204209,0,42,0.8891334175067718,61300021,9432621499,256353,256353,74119,330472,470948948.9333347,4109732.7166663795,204799,0,42,0.6929089302573234,8256616754,-532,-532,44526083.21666491,3964.5833336184733,-590,0,0,0.1962244872494484,-8195316733,2014.9832584111532,1837.111127754833,177.87213065632022,0.7982495573076487,0.7988944931403182,-590
1610,2021-05-30,2021,256120,256120,516413277.63333356,4093995.9833333353,204642,0,37,0.8844135561455567,61897051,9448690208,256513,256513,73797,330310,472017232.7333312,4089773.366666595,205158,0,38,0.6888861978141797,8273247007,-393,-393,44396044.90000236,4222.616666740272,-516,0,-1,0.19552735833137702,-8211349956,2016.2942278359112,1840.1298676220356,176.16436021387563,0.7990082773699828,0.799795721854253,-516
1611,2021-05-31,2021,258997,258997,517291029.4333336,4113192.78333333,202598,0,35,0.8626818071251787,61533955,9465356261,259342,259342,79235,338577,472968688.25000226,4109182.499999818,203117,0,35,0.6633321223828038,8294352946,-345,-345,44322341.18333131,4010.283333512023,-519,0,0,0.1993496847423749,-8232818991,1997.2857964892783,1823.7257684833241,173.5600280059541,0.7822407209349915,0.7832013326032806,-519
1612,2021-06-01,2021,258873,258873,517856891.73333263,4125877.900000002,202337,0,39,0.8639101026372004,61211904,9476665620,259332,259332,77404,336736,473630541.8166696,4122125.166664793,202911,0,39,0.6678198945167658,8310744873,-459,-459,44226349.91666305,3752.7333352086134,-574,0,0,0.19609020812043454,-8249532969,2000.428363457497,1826.3482401580584,174.08012329943858,0.7816071973515971,0.7824371847670168,-574
1613,2021-06-02,2021,256845,256845,518305269.7999997,4133957.399999999,201520,0,35,0.8702213397185076,60996147,9484340362,257297,257297,75421,332718,474249439.7166631,4129628.583333079,202134,0,35,0.6763114709754181,8328251160,-452,-452,44055830.08333659,4328.816666920204,-614,0,0,0.19390986874308946,-8267255013,2017.9690856353043,1843.198481586117,174.77060404918734,0.7845977145749382,0.7856057396704975,-614
1614,2021-06-03,2021,255276,255276,518844376.2166666,4109568.5999999945,199827,0,42,0.8672887384634668,60810352,9493126008,255719,255719,75294,331013,474884934.4499982,4105501.616666317,200374,0,42,0.6727439707806129,8340341807,-443,-443,43959441.76666838,4066.983333677519,-547,0,0,0.1945447676828539,-8279531455,2032.483963305076,1857.0576861711418,175.42627713393426,0.7827880411789593,0.7835710291374517,-547
1615,2021-06-04,2021,256738,256738,519182182.1500007,4103175.0999999987,202065,0,34,0.8670590251540482,61601182,9501137999,257283,257283,76083,333366,475325278.200002,4099175.9499996933,202758,0,37,0.6723781069455231,8354689060,-545,-545,43856903.94999868,3999.1500003053807,-693,0,-3,0.19468091820852507,-8293087878,2022.2257014933539,1847.4803162276637,174.74538526569017,0.7870474958907524,0.7880738330942969,-693
1616,2021-06-05,2021,255916,255916,519577749.73333395,4152887.566666667,204204,0,63,0.8764750933900188,61815147,9509497285,256303,256303,75437,331740,475741877.2833326,4148652.616666376,204737,0,63,0.6799059504431114,8363821144,-387,-387,43835872.45000136,4234.950000290759,-533,0,0,0.19656914294690742,-8302005997,2030.266766178488,1856.1697572144399,174.0970089640482,0.7979336969943263,0.7988084415711092,-533
1617,2021-06-06,2021,260225,260225,520551004.43333334,4131076.2166666696,206577,0,39,0.8743049284273217,63754374,9527357913,260662,260662,72713,333375,476814626.616668,4127121.5499996883,207082,0,40,0.6859632545931759,8377685218,-437,-437,43736377.81666535,3954.6666669812985,-505,0,-1,0.1883416738341458,-8313930844,2000.388142697025,1829.2448711997451,171.14327149727978,0.7938399462004035,0.7944464478903714,-505
1618,2021-06-07,2021,255148,255148,521302562.63333344,4124042.383333334,200594,0,34,0.8689897628043334,62807972,9547381463,255470,255470,81089,336559,477664501.7333352,4119661.8666664725,201040,0,35,0.6616254505153647,8397512375,-322,-322,43638060.89999825,4380.516666861251,-446,0,-1,0.20736431228896868,-8334704403,2043.1379537889125,1869.7479223914165,173.39003139749593,0.7861868405788013,0.7869417152698948,-446
1619,2021-06-08,2021,258525,258525,521860157.9499998,4161149.283333338,201762,0,45,0.8661135286722758,62843958,9556158784,258803,258803,72317,331120,478300406.3166719,4157395.416666344,202097,0,45,0.6784760811790257,8418125901,-278,-278,43559751.6333279,3753.8666669940576,-335,0,0,0.18763744749325006,-8355281943,2018.60616168649,1848.1254325362222,170.48072915026773,0.7804351610095736,0.7808912570565256,-335
1620,2021-06-09,2021,257917,257917,522663621.7166665,4158603.650000005,202260,0,43,0.8659181054370202,62382490,9573607751,258236,258236,74343,332579,479152722.35000354,4155134.599999721,202632,0,43,0.6735542532751781,8435095617,-319,-319,43510899.36666298,3469.050000283867,-372,0,0,0.19236385216184204,-8372713127,2026.479920736774,1855.4838301011614,170.99609063561252,0.7842057716242047,0.7846775817469291,-372
1621,2021-06-10,2021,257269,257269,522030843.56666654,4152389.4833333353,202259,0,57,0.87423280690639,62250805,9562840375,257545,257545,74884,332429,478664402.88332784,4148217.9999995283,202618,0,57,0.6786772513829922,8439869223,-276,-276,43366440.6833387,4171.483333806973,-359,0,0,0.19555555552339787,-8377618418,2029.1245488833345,1858.5660870268414,170.55846185649307,0.7861771142267432,0.7867285328777495,-359
1622,2021-06-11,2021,258431,258431,522624421.5333336,4139645.083333337,204478,0,41,0.8789270637036574,62411112,9576886779,258645,258645,74222,332867,479412014.11667216,4135764.8166663153,204765,0,41,0.6843033403732008,8447697904,-214,-214,43212407.41666144,3880.266667021904,-287,0,0,0.19462372333045652,-8385286792,2022.297717895042,1853.552220675722,168.74549721932,0.7912286064752294,0.7916835817433161,-287
1623,2021-06-12,2021,256814,256814,522857011.58333355,4158668.0833333344,204701,0,57,0.8814122283053099,62745871,9587963363,256876,256876,76274,333150,479742626.68333256,4154638.3833330935,204884,0,56,0.6810655860723386,8465138903,-62,-62,43114384.90000099,4029.700000240933,-183,0,1,0.20034664223297127,-8402393032,2035.9365594684618,1867.6039282896518,168.33263117881006,0.7970788196905153,0.7975988414643641,-183
1624,2021-06-13,2021,256699,256699,523572095.3499996,4139201.916666665,204339,0,72,0.8786555459896604,63240470,9601377175,256822,256822,73447,330269,480585231.4500084,4135571.3499997207,204539,0,71,0.6843149069394954,8479844922,-123,-123,42986863.899991214,3630.566666944418,-200,0,1,0.19434063905016508,-8416604452,2039.6343396351353,1871.277505237123,168.35683439801232,0.7960256954643377,0.7964232036196276,-200
1625,2021-06-14,2021,246307,246307,523745497.166666,4057501.5999999917,195021,0,52,0.8722163803708382,61134095,9614332145,246539,246539,78827,325366,480774683.98333406,4054765.3166662417,195238,0,52,0.6616487278941299,8500026714,-232,-232,42970813.18333191,2736.283333749976,-217,0,0,0.21056765247670828,-8438892619,2126.3930670531736,1950.0958630615605,176.29720399161306,0.7917801767712651,0.7919152750680419,-217
1626,2021-06-15,2021,250433,250433,524265579.1833325,4083324.099999998,199059,0,49,0.8800717157882545,62188263,9623335911,250609,250609,68225,318834,481413596.40000135,4080113.2166663115,199221,0,49,0.6925955199257383,8513661192,-176,-176,42851982.783331156,3210.883333686739,-162,0,0,0.18747619586251618,-8451472929,2093.4364847417573,1920.9748907660992,172.46159397565816,0.7948593036860159,0.7949475078708267,-162
1627,2021-06-16,2021,258383,258383,524960833.0,4178687.2666666643,200716,0,63,0.8603313685497889,63146233,9637227917,258508,258508,69222,327730,482162076.75000244,4175146.2833329807,200928,0,63,0.679596008909783,8528258676,-125,-125,42798756.249997556,3540.9833336835727,-212,0,0,0.18073535964000587,-8465112443,2031.7158365681953,1865.172748038755,166.5430885294404,0.7768158121857862,0.7772602782118928,-212
1628,2021-06-17,2021,260517,260517,526275656.2833333,4255741.316666667,201402,0,60,0.8532571770748173,61665200,9661710294,260711,260711,69870,330581,483519905.13332486,4252256.1333333375,201610,0,60,0.6738469543016699,8539591186,-194,-194,42755751.15000844,3485.1833333298564,-208,0,0,0.17941022277314744,-8477925986,2020.1202082141792,1854.6202696983437,165.49993851583554,0.773085825493154,0.7733083759411763,-208
1629,2021-06-18,2021,262951,262951,527569427.5833332,4265368.083333337,204950,0,92,0.8618944213941001,62093565,9684310550,263032,263032,71981,335013,484876234.91666937,4261060.333333071,205157,0,92,0.6779139913973387,8565618403,-81,-81,42693192.666663826,4307.750000265427,-207,0,0,0.18398042999676145,-8503524838,2006.3412102761852,1843.4115807835906,162.9296294925946,0.7794227821913589,0.7799697375224307,-207
1630,2021-06-19,2021,265639,265639,528392035.48333377,4303939.666666669,204968,0,56,0.8522167302241014,63560137,9703142063,265748,265748,73807,339555,485794055.53333384,4299854.916666853,205143,0,56,0.6678476240962427,8589583595,-109,-109,42597979.94999993,4084.749999815598,-175,0,0,0.18436910612785873,-8526023458,1989.1357650169357,1828.0252552543532,161.11050976258252,0.7716035672472792,0.7719456026009603,-175
1631,2021-06-20,2021,263993,263993,529215897.26666707,4262695.399999995,203771,0,58,0.8626857530313304,63794662,9723165872,264018,264018,75461,339479,486707280.9666725,4258045.150000014,203938,0,58,0.6723273015414646,8612277320,-25,-25,42508616.29999459,4650.249999980442,-167,0,0,0.19035845148986585,-8548482658,2004.658825297137,1843.4624948551707,161.1963304419662,0.7718803150083525,0.7724397578952951,-167
1632,2021-06-21,2021,261879,261879,530371097.40000033,4256542.38333333,200212,0,67,0.8538599887734403,62561738,9747835922,261904,261904,78904,340808,487893050.06666094,4252302.250000212,200433,0,67,0.6578249336870108,8633467662,-25,-25,42478047.33333939,4240.133333117701,-221,0,0,0.1960350550864295,-8570905924,2025.252492181505,1862.8697922393737,162.38269994213124,0.764521019249348,0.7652918626672368,-221
1633,2021-06-22,2021,263047,263047,531338675.89999986,4277230.249999996,201704,0,61,0.8613821864533708,62111796,9766253610,263191,263191,73341,336532,488946032.233336,4272700.016666784,201910,0,61,0.6746044952634671,8655829569,-144,-144,42392643.666663885,4530.2333332123235,-206,0,0,0.18677769118990373,-8593717773,2019.9381703649913,1857.7612161256882,162.1769542393031,0.7667983288157629,0.7671614910844216,-206
1634,2021-06-23,2021,264105,264105,532426973.50000083,4254651.283333336,206312,0,69,0.8788019916321166,62546961,9786466303,264253,264251,72151,336404,490083304.6666704,4250622.450000072,206519,0,69,0.6912075956290523,8678138405,-148,-146,42343668.83333045,4028.833333264105,-207,0,0,0.18759439600306427,-8615591444,2015.9670339448357,1854.6128668072038,161.35416713763198,0.781174154218966,0.78151998274381,-207
1635,2021-06-24,2021,260761,260761,532160260.8666664,4180320.3000000026,207018,0,78,0.8844689198154632,61748773,9785805225,260817,260817,76888,337705,489917502.8666643,4176149.6333330637,207196,0,78,0.6844909018225938,8700442468,-56,-56,42242758.000002086,4170.666666938923,-178,0,0,0.1999780179928694,-8638693695,2040.79697833137,1878.3955910338063,162.4013872975636,0.7938993944646631,0.7944114072318905,-178
1636,2021-06-25,2021,262163,262163,532587992.34999967,4206473.099999999,207924,0,87,0.88104347295385,62033992,9793475033,262102,262102,76209,338311,490414251.48333246,4203095.583333035,208078,0,86,0.6840067275376709,8708502521,61,61,42173740.86666721,3377.5166669636965,-154,0,1,0.1970367454161791,-8646468529,2031.5147154632791,1871.081683784681,160.43303167859813,0.7931096302681919,0.7938817712188385,-154
1637,2021-06-26,2021,260413,260413,532341231.9000002,4199321.783333333,206533,0,76,0.8929047320986275,62414730,9794908546,260363,260363,76938,337301,490318326.2500015,4195699.166666408,206662,0,76,0.690267743054417,8714361603,50,50,42022905.649998724,3622.6166669251397,-129,0,0,0.20263698904421057,-8651946873,2044.2191131011132,1883.2104648125944,161.00864828851877,0.7930978868182464,0.7937456551046039,-129
1638,2021-06-27,2021,258649,258649,532533566.0000009,4143965.433333338,204963,0,67,0.8969994084647533,62766300,9801685224,258604,258604,75948,334552,490636817.2333326,4140138.0666665593,205080,0,67,0.6951086826562151,8725555894,45,45,41896748.76666832,3827.3666667784564,-117,0,0,0.20189072580853828,-8662789594,2058.9044071309027,1897.2514625966055,161.65294453429715,0.7924368545789854,0.7930271766871355,-117
1639,2021-06-28,2021,255871,255871,533140479.1666669,4160785.283333336,202717,0,83,0.895087759066093,63036586,9819495311,255585,255585,78748,334333,491325739.8000031,4156962.4999996573,202793,0,72,0.684987721822248,8735812364,286,286,41814739.36666381,3822.78333367873,-76,0,11,0.21010003724384496,-8672775778,2083.629950899738,1922.3574928106232,161.27245808911493,0.7922625072790586,0.7934464072617721,-76
1640,2021-06-29,2021,252702,252702,533310914.5666667,4143951.6833333364,200346,0,88,0.8962018504008669,61185249,9817816827,252695,252695,71334,324029,491822140.13333553,4140222.5333328065,200454,0,88,0.6999342651429561,8746629221,7,7,41488774.43333119,3729.1500005298294,-108,0,0,0.19626758525791077,-8685443972,2110.4340866580665,1946.3073671158334,164.1267195422331,0.7928152527482965,0.7932646075308177,-108
1641,2021-06-30,2021,252124,252124,533639690.36666644,4123329.9999999967,200875,0,84,0.8986213133220161,61132271,9824759268,252085,252085,69723,321808,492183258.10000384,4119676.9666661755,200973,0,84,0.70459715109631,8755737141,39,39,41456432.2666626,3653.033333821222,-98,0,0,0.19402416222570606,-8694604870,2116.5763289756883,1952.4496027133857,164.12672626230255,0.7967309736478876,0.7972429934347541,-98
1642,2021-07-01,2021,253427,253427,533944923.03333324,4144483.4333333396,202522,0,82,0.8939339533672427,62840038,9835737734,253474,253474,70508,323982,492568767.5166802,4140989.1833327524,202685,0,82,0.7006376897481988,8768970000,-47,-47,41376155.51665306,3494.250000587199,-163,0,0,0.19329626361904384,-8706129962,2106.89832982805,1943.2713710939986,163.6269587340514,0.7991334782797413,0.7996283642503768,-163
1643,2021-07-02,2021,256839,256839,534315407.7499997,4168699.65,206135,0,114,0.8990534926549318,64031332,9842029754,256799,256799,68884,325683,493029416.1333306,4164910.283332874,206241,0,114,0.7099480169367048,8780450171,40,40,41285991.61666912,3789.3666671258397,-106,0,0,0.189105475718227,-8716418839,2080.351534424288,1919.903956531492,160.44757789279583,0.8025844984601248,0.803122286301738,-106
1644,2021-07-03,2021,254933,254933,534499003.6333336,4158998.666666667,205431,0,175,0.8887433168714914,63160053,9853384488,254927,254927,73331,328258,493297094.4333442,4154863.2833335116,205555,0,169,0.6908133236661547,8788126163,6,6,41201909.19998944,4135.38333315542,-124,0,6,0.19792999320533677,-8724966110,2096.6254020991146,1935.0523657099648,161.57303638914982,0.8058234908779954,0.8063288706178632,-124
1645,2021-07-04,2021,253566,253566,534977466.31666636,4100884.049999995,204229,0,84,0.9046678182406157,60790954,9867434095,253467,253466,72749,326216,493855067.7333336,4097744.6666659866,204330,0,87,0.7030035314025199,8803315484,99,100,41122398.58333278,3139.383334008511,-101,0,-3,0.20166428683809579,-8742524530,2109.815457579748,1948.4075486784561,161.40790890129188,0.8054273837975123,0.8061404443181953,-101
1646,2021-07-05,2021,252011,252011,535295237.566667,4064550.900000004,203050,0,105,0.8962624647336823,58659000,9874358799,252173,252172,75166,327339,494285386.0999971,4063097.9333330733,203238,0,105,0.6911428213564487,8818915377,-162,-161,41009851.46666992,1452.9666669308208,-188,0,0,0.20511964337723365,-8760256377,2124.0947322405254,1960.1120905572272,163.9826416832982,0.8057187979889767,0.8059467111863681,-188
1647,2021-07-06,2021,250171,250171,535733401.9166664,4135140.233333332,201622,0,157,0.899069036778844,62383722,9881572151,250325,250325,71529,321854,494867624.66667616,4132579.8166664364,201781,0,159,0.6992456206851608,8830829669,-154,-154,40865777.249990225,2560.416666895617,-159,0,-2,0.19982341609368315,-8768445947,2141.4688429780686,1976.9005279803303,164.5683149977383,0.805936739270339,0.8060761010686108,-159
1648,2021-07-07,2021,259132,259132,536433997.40000015,4221201.08333334,207952,0,71,0.8985767871200773,62632552,9891637316,259174,259174,66153,325327,495630227.033336,4218575.766666588,208073,0,74,0.7163438632514472,8841228265,-42,-42,40803770.36666417,2625.3166667511687,-121,0,-3,0.1822329238686301,-8778595713,2070.118693947487,1912.3454784559253,157.7732154915616,0.8024944815769569,0.8028313025226296,-121
1649,2021-07-08,2021,261720,261720,536160268.26666623,4237219.450000004,209014,0,89,0.8968821641448874,62383540,9894553517,261842,261842,69123,330965,495464874.76667005,4233809.416666526,209184,0,90,0.7103047150000741,8846103974,-122,-122,40695393.499996185,3410.033333477564,-170,0,-1,0.18657744914481333,-8783720434,2048.602583931936,1892.228423120317,156.37416081161882,0.7986168424270212,0.7988939895051214,-170
1650,2021-07-09,2021,265744,265744,536450883.1166665,4238465.266666663,211573,0,74,0.8912976398338248,63514809,9905633454,265843,265843,73256,339099,495724024.51666105,4234236.19999986,211776,0,74,0.6998103798595864,8856300213,-99,-99,40726858.60000545,4229.066666803323,-203,0,0,0.19148725997423843,-8792785404,2018.6754286707,1864.7247605416019,153.95066812909818,0.7961534409055332,0.7966205617601366,-203
1651,2021-07-10,2021,260729,260729,535930139.31666684,4213195.766666667,207575,0,142,0.8780956472045692,60195291,9902710596,260852,260852,77558,338410,495288895.65000135,4209190.1333329175,207700,0,143,0.6773588250938258,8860443454,-123,-123,40641243.666665494,4005.633333749138,-125,0,-1,0.2007368221107434,-8800248163,2055.5064427688017,1898.7352815006261,156.77116126817555,0.7961331497455212,0.7962369466210725,-125
1652,2021-07-11,2021,261669,261669,536371086.45000035,4225158.099999999,209203,0,146,0.8849768218627336,62332264,9913193772,261731,261731,74879,336610,495826736.98332673,4221396.466666242,209311,0,149,0.6887169127476824,8871359750,-62,-62,40544349.46667361,3761.6333337565884,-108,0,-3,0.1962599091150512,-8809027486,2049.8075295506933,1894.413489358642,155.3940401920513,0.7994947815751962,0.7997180311082753,-108
1653,2021-07-12,2021,266305,266305,537578668.6333339,4249710.716666668,210658,0,93,0.8903362685642394,64322659,9940221322,266432,266432,77462,343894,497054850.99999714,4245520.933333181,210843,0,93,0.691416541143475,8892731004,-127,-127,40523817.63333678,4189.783333486877,-185,0,0,0.19891972742076447,-8828408345,2018.6578120325714,1865.597416976929,153.0603950556424,0.791040348472616,0.79135764472736,-185
1654,2021-07-13,2021,266113,266113,536619824.4000002,4222895.266666667,208809,0,77,0.8800547135991102,63858843,9936573407,266336,266336,76051,342387,495896770.48333895,4218276.5833330825,209046,0,77,0.6843338094027969,8895791778,-223,-223,40723053.91666126,4618.6833335841075,-237,0,0,0.19572090419631338,-8831932935,2016.5111227185453,1861.9216721860319,154.5894505325134,0.7846629063593286,0.7848957707557371,-237
1655,2021-07-14,2021,262331,262331,535055179.4833331,4232694.283333334,207459,0,72,0.8882289931422523,64432491,9918534371,262377,262377,76718,339095,494704801.5999925,4228835.383333226,207592,0,72,0.6883439744024551,8893538308,-46,-46,40350377.8833406,3858.900000108406,-133,0,0,0.19988501873979725,-8829105817,2039.618571512071,1885.4731992514303,154.14537226064067,0.7908291433341846,0.7911973991622742,-133
1656,2021-07-15,2021,265829,265829,535761594.08333355,4268580.099999998,209354,0,141,0.8859040962423218,64991639,9935839334,265853,265853,73951,339804,495431494.03333265,4264342.46666685,209568,0,141,0.6942266718461384,8901935476,-24,-24,40330100.050000906,4237.633333147503,-214,0,0,0.1916774243961834,-8836943837,2015.436969191975,1863.554272599266,151.88269659270918,0.7875513958221263,0.788285255385495,-214
1657,2021-07-16,2021,268556,268556,536407160.55000013,4255210.4666666705,211584,0,122,0.886001429869376,65021434,9954309299,268539,268539,76261,344800,496157815.2666672,4250336.150000198,211808,0,122,0.6913950116009351,8921073508,17,17,40249345.283332944,4874.316666472703,-224,0,0,0.19460641826844094,-8856052074,1997.3754470203612,1847.619210865711,149.7562361546502,0.7878580258865935,0.7887420449171256,-224
1658,2021-07-17,2021,264608,264608,535696142.7499995,4238036.850000004,210101,0,134,0.8858273370419633,65213560,9960496351,264612,264612,80344,344956,495511721.46666443,4233797.933333445,210331,0,135,0.6810288848432776,8938907043,-4,-4,40184421.28333509,4238.916666558944,-230,0,-1,0.20479845219868564,-8873693483,2024.4895949857885,1872.5973178339018,151.89227715188667,0.7940084955859233,0.7948656901425484,-230
1659,2021-07-18,2021,263394,263394,536144559.7500002,4227352.416666668,210027,0,131,0.8957189609482364,65069547,9975567409,263394,263394,77771,341165,496004783.56667334,4222968.633333298,210148,0,131,0.6925651810707529,8949360134,0,0,40139776.18332684,4383.783333369531,-121,0,0,0.2031537798774835,-8884290587,2035.5230557643688,1883.1286345424471,152.39442122192168,0.7973871842183193,0.7978465720555518,-121
1660,2021-07-19,2021,266416,266416,536583146.9333335,4234439.400000004,211174,0,149,0.8910200588553235,64569135,9992696794,266454,266454,78798,345252,496522426.000003,4230636.199999858,211369,0,150,0.689322581766373,8967456292,-38,-38,40060720.933330536,3803.200000146404,-195,0,-1,0.20169747708895058,-8902887157,2014.0800362340608,1863.445195043058,150.6348411910028,0.7926475887334095,0.7932663799380005,-195
1661,2021-07-20,2021,259693,259693,535981176.5833333,4213612.733333328,206379,0,137,0.8864428382744228,65295840,10007609372,259770,259770,78933,338703,495956595.78334147,4209946.766666372,206503,0,139,0.6807645636442462,8985252466,-77,-77,40024580.799991846,3665.966666955501,-124,0,-2,0.20567827463017663,-8919956626,2063.903057007056,1909.214288729805,154.6887682772508,0.7947037463466478,0.7949455287369597,-124
1662,2021-07-21,2021,264219,264219,536781891.2999993,4251492.383333328,210677,0,133,0.8914385415129114,66237302,10031764602,264178,264178,73787,337965,496763874.4833444,4247582.21666634,210753,0,134,0.6976965070347548,9004909298,41,41,40018016.81665492,3910.1666669882834,-76,0,-1,0.19374203447815652,-8938671996,2031.579452272544,1880.4134881910848,151.16596408145915,0.7973574951082246,0.7977689285254639,-76
1663,2021-07-22,2021,266642,266642,537344444.0833342,4260945.533333331,213306,0,110,0.888355922922872,65844373,10050799978,266680,266680,73921,340601,497364961.050014,4257096.199999678,213461,0,110,0.6966832158449335,9027458517,-38,-38,39979483.03332019,3849.333333653398,-155,0,0,0.1916727070779385,-8961614144,2015.2280739093399,1865.0253526699191,150.20272123942073,0.7999714973635061,0.8004387280635968,-155
1664,2021-07-23,2021,260409,260409,537518749.0500003,4192157.0499999984,209181,0,86,0.8944199317227894,64601073,10061799323,260379,260379,78102,338481,497607413.40000755,4188622.36666632,209311,0,86,0.6888363010035873,9043633406,30,30,39911335.649992764,3534.6833336786367,-130,0,0,0.20558363071920216,-8979032333,2064.1327644205858,1911.0888873526956,153.0438770678902,0.8032786885245902,0.8038705118308312,-130
1665,2021-07-24,2021,256311,256311,537306302.6333337,4204851.033333325,206818,0,76,0.9035702720523116,65328763,10071754059,256226,256226,77008,333234,497468273.0666698,4200640.2166663185,206898,0,82,0.69550526056764,9058739210,85,85,39838029.56666386,4210.816667006351,-80,0,-6,0.2080650114846716,-8993410447,2096.306060345961,1941.5214422684264,154.7846180775348,0.8069025519778706,0.8074824568935237,-80
1666,2021-07-25,2021,250349,250349,537602334.5,4135205.8000000007,202715,0,62,0.9056956488741725,64532571,10083372884,250342,250342,71663,322005,497849768.1499992,4131264.633332789,202810,0,61,0.7049455753792678,9068306505,7,7,39752566.3500008,3941.166667211801,-95,0,1,0.2007500734949047,-9003773934,2147.411551474142,1988.678560329466,158.7329911446759,0.8097296174540342,0.810131739779981,-95
1667,2021-07-26,2021,251313,251313,538124959.9666663,4145091.600000002,201784,0,95,0.9008606797101626,63751924,10102105458,251293,251293,70549,321842,498440145.7333533,4140696.133332899,201891,0,94,0.7048924627612432,9088314293,20,20,39684814.233313024,4395.4666671031155,-107,0,1,0.19596821694891942,-9024562369,2141.253973995242,1983.5019110494654,157.75206294577674,0.8029190690493528,0.8034087698423752,-107
1668,2021-07-27,2021,251726,251726,538708237.4499995,4126866.0500000026,200404,0,144,0.899168143139763,63808912,10117248201,254338,254337,67980,322318,499082553.2500253,4122725.049999586,201301,0,144,0.7065382634540934,9104465030,-2612,-2611,39625684.19997418,4141.000000416767,-897,0,0,0.19262987968566958,-9040656118,2140.057989440898,1962.2884332599083,177.76955618098964,0.7961195903482358,0.7914704055233587,-897
1669,2021-07-28,2021,259664,259664,539470233.816667,4210727.133333329,205732,0,251,0.8857061433236799,64208721,10132040716,259656,259656,71331,330987,499818714.43334854,4206519.683332937,205832,0,253,0.6962962291570338,9121237757,8,8,39651519.383318424,4207.450000392273,-100,0,-2,0.1894099141666461,-9057029036,2077.5703748562255,1924.9264967239292,152.64387813229632,0.7923008195206113,0.7927103552392396,-100
1670,2021-07-29,2021,263447,263447,540376885.7666672,4286980.216666666,209172,0,181,0.8843752253774013,64640765,10150689837,263397,263397,70962,334359,500820948.21667993,4282505.166666405,209256,0,183,0.6973791643114208,9137901251,50,50,39555937.549987316,4475.050000260584,-84,0,-2,0.18699606106598055,-9073260486,2051.1787409485296,1901.3919984535887,149.78674249494088,0.7939813321085456,0.7944509618560576,-84
1671,2021-07-30,2021,266562,266562,540986264.8500001,4278215.849999998,211366,0,272,0.8948649845064178,64723904,10161052032,266472,266472,73205,339677,501477275.46667445,4274310.716666516,211388,0,273,0.7020316359364906,9153057798,90,90,39508989.383325696,3905.1333334818482,-22,0,-1,0.19283334856992718,-9088333894,2029.4950700024765,1881.913579913366,147.5814900891105,0.7929337264876464,0.7932840973910955,-22
1672,2021-07-31,2021,267762,267762,541306735.3833333,4306058.833333332,213262,0,293,0.8992314069957645,65230432,10175180328,267713,267712,77797,345510,501898539.6833353,4302120.733333598,213360,0,296,0.6974790888830948,9169908513,49,50,39408195.69999802,3938.0999997342005,-98,0,-3,0.2017523181126697,-9104678081,2021.5965498589544,1874.770423751402,146.82612610755245,0.7964610362934248,0.7969728776712375,-98
1673,2021-08-01,2021,269183,269183,541751317.6333339,4285335.883333335,214546,0,256,0.8997670729578013,62881445,10186326117,269029,269029,77668,346697,502395514.783328,4281805.816666855,214579,0,257,0.6984946509488077,9184630514,154,154,39355802.850005925,3530.066666480154,-33,0,-1,0.20127242200899365,-9121749069,2012.5762683131325,1867.4399963696405,145.13627194349192,0.7970265581407444,0.7976054626081203,-33
1674,2021-08-02,2021,263773,263773,541638365.8666667,4210830.116666665,209531,0,335,0.8953569925655774,61600344,10197982694,263708,263708,84998,348706,502330850.5166645,4206838.566666485,209585,0,338,0.6779866133648457,9200585143,65,65,39307515.35000217,3991.5500001804903,-54,0,-3,0.21737037920073177,-9138984799,2053.4261120989136,1904.8752806765988,148.5508314223148,0.7943610604572872,0.7947616302880459,-54
1675,2021-08-03,2021,268190,268190,542308079.9666669,4298761.199999997,215201,0,365,0.9108206868265034,64956140,10211113447,268093,268093,75199,343292,503097222.3666691,4294767.900000201,215263,0,369,0.7121634060799451,9215236503,97,97,39210857.59999782,3993.2999997967854,-62,0,-4,0.1986572807465583,-9150280363,2022.1040306001973,1876.57724135531,145.52678924488737,0.802419926171744,0.8029415165632822,-62
1676,2021-08-04,2021,269059,269059,543034402.0999995,4306332.06666667,215614,0,348,0.906094945718225,65563871,10227351241,269008,269006,75710,344718,503879032.35000235,4302625.833333387,215695,0,352,0.7079641910199101,9230162312,51,53,39155369.7499972,3706.233333283104,-81,0,-4,0.19813075469831487,-9164598441,2018.2725799917473,1873.1144745842187,145.15810540752864,0.8013632697661108,0.8018163028608815,-81
1677,2021-08-05,2021,262649,262649,543362082.2666668,4243112.183333336,210346,0,331,0.9048920803048932,63771599,10232303304,262587,262587,79129,341716,504275308.5166717,4239271.533333048,210411,0,334,0.696332627093829,9245933180,62,62,39086773.74999505,3840.650000288151,-65,0,-3,0.20855945321106417,-9182161581,2068.7765126334643,1920.4123148391645,148.3641977942998,0.8008635098553583,0.8013001405248547,-65
1678,2021-08-06,2021,266024,266024,543505526.4166671,4236194.850000005,211846,0,321,0.9065535440411392,63422545,10243020919,265935,265934,76498,342433,504515024.4333358,4231527.316666306,211929,0,322,0.704762683503043,9259240610,89,90,38990501.98333132,4667.533333699219,-83,0,-1,0.20179086053809614,-9195818065,2043.0695216095808,1897.143744061819,145.92577754776175,0.7963416834571316,0.7969203000733261,-83
1679,2021-08-07,2021,267866,267866,543519680.4333328,4254506.016666668,211336,0,267,0.888776477791134,64158774,10250582948,267814,267814,79853,347667,504628523.24998885,4250999.850000036,211441,0,270,0.6858689493106918,9271283609,52,52,38891157.18334395,3506.166666631587,-105,0,-3,0.20290752848044225,-9207124835,2029.0730456024012,1884.2499766628662,144.823068939535,0.7889616450016053,0.7895068965774754,-105
1680,2021-08-08,2021,266758,266758,541676367.2999998,4262469.133333337,210711,0,256,0.9019523313265204,63905594,10134090692,266683,266683,79869,346552,503363869.5666661,4258343.966666862,210806,0,258,0.6948105911955551,9178658416,75,75,38312497.73333371,4125.166666474193,-95,0,-2,0.2071417401309653,-9114752822,2030.5908999917522,1887.498901567277,143.09199842447515,0.7898957107190787,0.7904740834623879,-95
1681,2021-08-09,2021,268964,268964,542519076.3666663,4298751.5333333295,213250,0,271,0.8955250516797783,64695348,10158564610,268960,268960,80869,349829,504236909.4499995,4294863.566666835,213380,0,274,0.6898827712968361,9195321532,4,4,38282166.916666806,3887.966666494496,-130,0,-3,0.2056422803829422,-9130626184,2017.0694827808418,1874.7654277587728,142.30405502206895,0.7928570366294374,0.7933521713265913,-130
1682,2021-08-10,2021,271037,271037,543599816.0166656,4328888.983333335,216297,0,357,0.898987961053288,65046501,10179828176,271127,271127,77230,348357,505380844.0166709,4324542.1166668935,216446,0,362,0.7006547880478842,9219923068,-90,-90,38218971.999994695,4346.866666441783,-149,0,-5,0.19833317300540387,-9154876567,2005.629548794687,1864.0004279052653,141.62912088942176,0.7980349546371898,0.7983196066787889,-149
1683,2021-08-11,2021,271950,271950,544425049.3500007,4298905.46666666,215738,0,264,0.8913623827909534,64615472,10199578118,272078,272078,77795,349873,506308211.83333176,4294857.466666908,216010,0,266,0.6949636010781027,9240261656,-128,-128,38116837.516668975,4047.999999752268,-272,0,-2,0.19639878171285063,-9175646184,2001.9306833976862,1860.8936107782758,141.0370726194103,0.7933002390145247,0.79392674159616,-272
1684,2021-08-12,2021,270501,270501,544996549.4000003,4289568.083333337,215796,0,251,0.8935752548049732,64110012,10216495635,270596,270596,79990,350586,506919054.16666514,4286579.800000208,215921,0,256,0.6907206790915873,9262390692,-95,-95,38077495.2333352,2988.283333128318,-125,0,-5,0.20285457571338594,-9198280680,2014.7672259991657,1873.3427477370883,141.4244782620774,0.7977641487462154,0.797946015462165,-125
1685,2021-08-13,2021,267658,267658,545207526.0333331,4261889.933333332,213914,0,321,0.9048935581974001,64909161,10226838207,267770,267770,79997,347767,507155220.0166663,4258382.050000017,214122,0,324,0.6976682663967487,9282485893,-112,-112,38052306.01666677,3507.8833333151415,-208,0,-3,0.2072252918006514,-9217576732,2036.9558392924293,1893.9956679862057,142.96017130622363,0.799206450022043,0.7996489524592001,-208
1686,2021-08-14,2021,263513,263513,545055044.2000002,4247350.55,210504,0,232,0.9032191960168948,64498238,10232208937,267906,267906,80939,348845,507076871.13332826,4247477.866666549,212618,0,233,0.6894122031274584,9288841918,-4393,-4393,37978173.06667191,-127.31666654907167,-2114,0,-1,0.2138069928894364,-9224343680,2068.4180446505493,1892.7417494693223,175.67629518122703,0.7988372490161776,0.7936291087172367,-2114
1687,2021-08-15,2021,266152,266152,545536884.7333332,4256710.966666659,213482,0,233,0.909198503111004,64437080,10246851699,266145,266145,81546,347691,507486480.83333755,4253067.95000012,213658,0,236,0.6971304980571882,9300308339,7,7,38050403.899995685,3643.0166665390134,-176,0,-3,0.21206800505381584,-9235871259,2049.7192759525883,1906.8044894074192,142.91478654516914,0.8021055637380143,0.8027879539348851,-176
1688,2021-08-16,2021,276343,276343,546254776.2666669,4382829.450000001,218501,0,304,0.9015462667771581,64238839,10265408422,276362,276362,78875,355237,508191040.81666356,4379153.550000686,218717,0,306,0.702820933630226,9316668698,-19,-19,38063735.450003326,3675.899999314919,-216,0,-2,0.19872533314693208,-9252429859,1976.7273868586028,1838.8600488369007,137.86733802170215,0.7906876599009203,0.7914148833775989,-216
1689,2021-08-17,2021,269905,269905,546033006.8999999,4332889.95,212193,0,296,0.8961486448935729,62965406,10269831414,269889,269889,81072,350961,508107777.14999723,4328839.116667015,212342,0,297,0.6901735520471061,9330337745,16,16,37925229.75000262,4050.8333329856396,-149,0,-1,0.20597509284646687,-9267372339,2023.0562861006645,1882.6546363504895,140.401649750175,0.78617661769882,0.7867753039212417,-149
1690,2021-08-18,2021,271289,271289,546172965.316667,4340551.466666665,214370,0,263,0.901968011972472,63232769,10278522569,271278,271278,78046,349324,508344507.3666614,4335266.316667005,214501,0,267,0.701878485303058,9342013469,11,11,37828457.95000553,5285.1499996595085,-131,0,-4,0.20008952666941404,-9278780700,2013.2514230826423,1873.8876995799933,139.363723502649,0.7901905348171139,0.7907054755638128,-131
1691,2021-08-19,2021,276332,276332,546877230.4833332,4361805.433333329,215672,0,243,0.8932009322119765,63433793,10290995642,276337,276337,77639,353976,509153142.88333297,4356882.950000429,215859,0,246,0.6985558342938379,9353663286,-5,-5,37724087.60000026,4922.48333290033,-187,0,-3,0.19464509791813855,-9290229493,1979.0586341188614,1842.5080350562284,136.55059906263295,0.7804814498501802,0.7811440378957577,-187
1692,2021-08-20,2021,280592,280592,547460404.683333,4363424.166666664,220629,0,141,0.8976699264412388,64900236,10305946856,280624,280624,80584,361208,509833248.96666664,4358709.950000466,220800,0,143,0.6980216385019028,9369476492,-32,-32,37627155.7166664,4714.216666198336,-171,0,-2,0.19964828793933598,-9304576256,1951.0905680964997,1816.7841986667806,134.3063694297191,0.7862982551177511,0.7868179485717544,-171
1693,2021-08-21,2021,278737,278737,547580213.0166669,4373364.600000003,220582,0,87,0.9029658782292979,64478260,10317077065,278778,278778,87450,366228,510013540.28333503,4368987.883333858,220765,0,87,0.6886830062147056,9384055317,-41,-41,37566672.73333186,4376.71666614525,-183,0,0,0.21428287201459228,-9319577057,1964.5049384066947,1829.4612210552305,135.04371735146424,0.7913624671285118,0.791902517415291,-183
1694,2021-08-22,2021,279004,279004,547966243.0166665,4368058.350000005,220180,0,80,0.8967004057289509,64959189,10332544347,278881,278881,86023,364904,510462498.4333288,4364039.8000005465,220324,0,80,0.6867066406507014,9399119141,123,123,37503744.583337724,4018.5499994587153,-144,0,0,0.20999376507824952,-9334159952,1964.008555492633,1830.3953960052095,133.61315948742345,0.7891643130564436,0.7900287219279908,-144
1695,2021-08-23,2021,273969,273969,548586079.6333333,4359184.58333333,214453,0,81,0.89226518328716,64130716,10354674718,273929,273929,87751,361680,511131514.0000104,4354313.300000546,214578,0,81,0.6770957752709503,9415983552,40,40,37454565.633322954,4871.28333278466,-125,0,0,0.21516940801620965,-9351852836,2002.3655217682779,1865.9269883802385,136.43853338803933,0.782763743343225,0.7833343676646138,-125
1696,2021-08-24,2021,278206,278206,548770342.5666668,4352802.700000003,216740,0,45,0.8835970467926637,64303228,10362829123,280871,280870,83288,364159,511380545.99999756,4349282.916667151,218218,0,45,0.6799145428233235,9437594237,-2665,-2664,37389796.566669285,3519.7833328517154,-1478,0,0,0.20368250396934018,-9373291009,1972.5323773271132,1820.7019119165363,151.83046541057683,0.7790629964846193,0.776933182849066,-1478
1697,2021-08-25,2021,281635,281635,549724115.5500001,4412954.883333328,218813,0,78,0.8822802563601825,64348115,10380414939,281627,281627,86152,367779,512289854.26666033,4409745.783333981,218944,0,78,0.6767406513150502,9442244861,8,8,37434261.28333974,3209.0999993467703,-131,0,0,0.20553960504513225,-9377896746,1951.9026951550768,1819.036719727371,132.86597542770573,0.7769382356596304,0.7774254599168403,-131
1698,2021-08-26,2021,282000,282000,550503422.2833337,4401255.666666661,218492,0,48,0.8844468085106387,64829311,10395779214,287672,287672,83612,371284,513159712.1166724,4403631.2333339555,220693,0,48,0.6789842815742207,9456833212,-5672,-5672,37343710.16666126,-2375.5666672941297,-2201,0,0,0.20546252693641798,-9392003901,1952.1397953309704,1783.8361471282308,168.30364820273962,0.7747943262411348,0.7671688589782808,-2201
1699,2021-08-27,2021,278354,278354,550812244.1833332,4338682.75,218014,0,78,0.891702652018653,64370441,10408866598,278334,278334,92706,371040,513175678.84998894,4334839.516666974,218153,0,78,0.6699681974989203,9465765251,20,20,37636565.33334422,3843.233333026059,-139,0,0,0.22173445451973262,-9401394810,1978.8192164773388,1843.7405378070553,135.07867867028358,0.7832256766563441,0.7837813562123205,-139
1700,2021-08-28,2021,269308,269308,550233059.75,4279911.766666669,212690,0,62,0.894232625841045,63339879,10413239929,269285,269285,89035,358320,512646149.64999956,4276507.600000011,212756,0,62,0.6727394507702568,9476414398,23,23,37586910.10000044,3404.166666658595,-66,0,0,0.22149317507078825,-9413074519,2043.1367049994801,1903.7308043522646,139.4059006472155,0.7897648788747457,0.7900774272610803,-66
1701,2021-08-29,2021,266941,266941,550383332.0833336,4239578.583333335,211374,0,65,0.8969210424775517,62889257,10423336494,266906,266906,83443,350349,512916924.1833274,4235790.266666736,211438,0,65,0.6842691145115449,9487148465,35,35,37466407.900006235,3788.3166665984318,-64,0,0,0.21265192796600674,-9424259208,2061.8164016892633,1921.7137276169415,140.10267407232186,0.7918378967637043,0.7921815170884131,-64
1702,2021-08-30,2021,270825,270825,550480134.45,4291600.599999996,211838,0,66,0.8843016708206414,63750790,10434918795,270837,270837,81076,351913,513060777.1333386,4288149.7666667905,211906,0,67,0.6813587449170676,9502183062,-12,-12,37419357.31666148,3450.8333332054317,-68,0,-1,0.20294292590357377,-9438432272,2032.604576571587,1894.352607410873,138.251969160714,0.7821951444659836,0.7824115611973254,-68
1703,2021-08-31,2021,274592,274592,550657506.7500002,4243247.483333333,214152,0,75,0.8836164199976685,61377990,10440867074,274567,274567,80551,355118,513368958.4500016,4237681.96666689,214368,0,75,0.6849047358906081,9512655077,25,25,37288548.29999864,5565.516666443087,-216,0,0,0.19871168410706042,-9451277087,2005.3661678053265,1869.740203484037,135.62596432128953,0.7798916210231908,0.7807493253012926,-216
1704,2021-09-01,2021,284465,284465,549602645.2166667,4395959.966666671,221441,0,80,0.8888263934051642,63355398,10430554743,284527,284527,83281,367808,512666717.88332725,4391484.183333803,221627,0,83,0.6885331477292538,9513525223,-62,-62,36935927.33333945,4475.783332868479,-186,0,-3,0.20029324567591045,-9450169825,1932.0571782703205,1801.820979672675,130.2361985976454,0.7784472606471798,0.7789313492216907,-186
1705,2021-09-02,2021,279365,279365,549635046.5833341,4270615.216666668,217860,0,77,0.8760331466003252,55513816,10431703314,279499,279499,87096,366595,512735437.26666075,4266616.7333337525,218121,0,77,0.6692617193360579,9510552830,-134,-134,36899609.31667334,3998.4833329152316,-261,0,0,0.20677142726426723,-9455039014,1967.4441915892617,1834.4803998105924,132.96379177866925,0.7798399942727257,0.7803999298745254,-261
1706,2021-09-03,2021,287462,287462,549665419.3166668,4440700.750000006,223580,0,61,0.8824331563824093,63569922,10438001726,291831,291831,85942,377773,512795287.8999896,4438950.166667634,225268,0,61,0.6763506126695213,9519172504,-4369,-4369,36870131.41667724,1750.583332371898,-1688,0,0,0.20608254371288792,-9455602582,1912.1324533909415,1757.165235701449,154.96721768949237,0.7777723664345201,0.7719125110080834,-1688
1707,2021-09-04,2021,288702,288702,549124038.2999995,4437642.650000006,223636,0,63,0.8799419470595983,63764054,10432388809,288784,288784,93374,382158,512289511.4833242,4432837.950000953,223863,0,63,0.6660334207317465,9525418297,-82,-82,36834526.816675246,4804.699999053031,-227,0,0,0.21390852632785173,-9461654243,1902.0444551821583,1773.9539291765618,128.09052600559653,0.7746257386509272,0.7751918388830407,-227
1708,2021-09-05,2021,285200,285200,549490439.916667,4427215.599999997,223225,0,44,0.8897931276297335,64484977,10444697871,285260,285260,92107,377367,512733604.19999826,4422979.783334073,223431,0,45,0.6736333595677374,9529823181,-60,-60,36756835.716668725,4235.816665924154,-206,0,-1,0.2161597680619961,-9465338204,1926.6845719378225,1797.4255212788273,129.2590506589952,0.7826963534361852,0.783253873659118,-206
1709,2021-09-06,2021,281923,281923,549609825.0666667,4357145.266666667,218448,0,46,0.8800629959244191,63261828,10454595091,281934,281934,94929,376863,512871289.2833317,4352963.7166670915,218623,0,47,0.6595685965457105,9540849964,-11,-11,36738535.78333503,4181.549999575131,-175,0,-1,0.22049439937870852,-9477588136,1949.5033220654814,1819.1182662727151,130.38505579276625,0.7748498703546713,0.7754403512878901,-175
1710,2021-09-07,2021,284855,284855,549867296.5833334,4332411.283333338,219858,0,46,0.8766144178617185,62607775,10462357436,284709,284709,92510,377219,513161328.3999977,4327148.316667068,219971,0,46,0.6629199483589051,9551749584,146,146,36705968.18333566,5262.966666270047,-113,0,0,0.21369446950281334,-9489141809,1930.3410387156039,1802.406416376011,127.9346223395928,0.7718242614663601,0.7726169527482447,-113
1711,2021-09-08,2021,287749,287749,549304627.016667,4445688.08333333,220268,0,61,0.8726702786108728,63834811,10447589620,287799,287799,89351,377150,512709401.0166674,4440958.816667647,220397,0,61,0.6664801802995967,9539826272,-50,-50,36595225.99999958,4729.266665683128,-129,0,0,0.2061900983112761,-9475991461,1908.971454346208,1781.4843033390227,127.48715100718528,0.7654865872687655,0.7658018269695169,-129
1712,2021-09-09,2021,291336,291336,549705594.633333,4488060.5833333405,224135,0,56,0.8774610758711591,64743039,10452634549,291363,291363,88820,380183,513349286.90000117,4483139.416667851,224290,0,57,0.6731337277048056,9547489728,-27,-27,36356307.7333318,4921.166665489785,-155,0,-1,0.20432734816635345,-9482746689,1886.844037926425,1761.8890761695932,124.95496175683184,0.7693350632946152,0.7697957530640472,-155
1713,2021-09-10,2021,285261,285261,549990964.5833337,4404442.299999998,221767,0,49,0.8862129768878327,63419374,10460685900,285260,285260,93794,379054,513616813.4500006,4400349.150000571,221881,0,51,0.66761200251151,9557436949,1,1,36374151.13333315,4093.149999426678,-114,0,-2,0.21860097437632275,-9494017575,1928.027191180476,1800.5216765407017,127.50551463977422,0.7774178734562384,0.777820234172334,-114
1714,2021-09-11,2021,289068,289068,550044726.6333332,4457319.166666663,225894,0,46,0.889167946642313,63846613,10469956454,291498,291498,92222,383720,513759907.3666707,4453091.4500011,226882,0,46,0.6729490253309672,9568800323,-2430,-2430,36284819.26666248,4227.716665563174,-988,0,0,0.2162189213113458,-9504953710,1902.821227646551,1762.4817575649602,140.3394700815909,0.7814562663456349,0.7783312406946188,-988
1715,2021-09-12,2021,286552,286552,550276038.7999994,4458953.183333332,225220,0,47,0.8908260978810125,64094495,10487698852,286492,286492,94594,381086,513970074.35000336,4453827.983334446,225338,0,49,0.6704917000361984,9579494168,60,60,36305964.449995995,5125.199998885393,-118,0,-2,0.22033439784481412,-9515399673,1920.3357114938976,1794.011959670788,126.32375182310966,0.7859655490103018,0.7865420325872974,-118
1716,2021-09-13,2021,283189,283189,550800834.9333336,4453008.950000003,219719,0,40,0.8845152883763138,64011348,10506029719,283153,283153,95928,379081,514544007.05000293,4448528.80000094,219856,0,40,0.6618532714644045,9597818711,36,36,36256827.8833307,4480.149999062531,-137,0,0,0.22266201691190923,-9533807363,1944.9937495218162,1817.1942626424686,127.79948687934757,0.7758740629049857,0.7764565446949175,-137
1717,2021-09-14,2021,278686,278686,550964718.0833338,4479955.53333334,216003,0,43,0.8894382925586507,63672592,10512110726,278759,278759,85797,364556,514813394.01666003,4475422.916667771,216120,0,44,0.6808364147072108,9613644776,-73,-73,36151324.066673815,4532.616665569134,-117,0,-1,0.2086018778514399,-9549972184,1977.008956615452,1846.8045660109988,130.20439060445324,0.7750766095175216,0.7752933537571881,-117
1718,2021-09-15,2021,287754,287754,551945496.0666667,4543676.199999999,222598,0,45,0.8809086928418023,63892873,10523514788,287783,287783,81690,369473,515850448.58332825,4539296.1833346,222725,0,45,0.6869784801595726,9631208453,-29,-29,36095047.483338475,4380.016665399075,-127,0,0,0.19393021268222965,-9567315580,1918.1158074837074,1792.4979883569504,125.61781912675701,0.7735704803408467,0.7739338320887613,-127
1719,2021-09-16,2021,291708,291708,552520620.9333332,4553701.383333331,225639,0,37,0.8800958492739313,63809987,10536422100,291774,291774,84472,376246,516479064.88333285,4549521.933334678,225847,0,39,0.6832790248932853,9640198221,-66,-66,36041556.05000031,4179.4499986525625,-208,0,-2,0.19681682438064596,-9576388234,1894.0879953012368,1770.1339560184692,123.95403928276755,0.773509811181044,0.7740477218669244,-208
1720,2021-09-17,2021,287198,287198,552497340.7166663,4398385.116666664,223163,0,135,0.8829274577121012,63219681,10545263634,287223,287223,91720,378943,516583248.90000063,4393797.016667485,223450,0,136,0.6704596733545563,9652637346,-25,-25,35914091.81666571,4588.099999179132,-287,0,-1,0.212467784357545,-9589417665,1923.7506553550734,1798.5441587198818,125.20649663519157,0.7770353553994108,0.7779669455440547,-287
1721,2021-09-18,2021,284368,284368,552108625.2666665,4430286.283333332,223288,0,195,0.891482163956563,63976596,10549350545,284360,284360,92366,376726,516253634.3166674,4425654.566667432,223456,0,197,0.6737363494954008,9665065727,8,8,35854990.94999915,4631.716665900312,-168,0,-2,0.21774581446116215,-9601089131,1941.5286715335992,1815.4931576757187,126.03551385788046,0.7852078996230237,0.7858207905471937,-168
1722,2021-09-19,2021,280709,280709,552389281.2833333,4313776.083333332,220871,0,185,0.8943496645992822,63139057,10552601774,280552,280552,88914,369466,516597715.61666197,4309447.483333707,221048,0,185,0.6805605928556403,9673663037,157,157,35791565.666671336,4328.599999625236,-177,0,0,0.21378907174364192,-9610523980,1967.8360198046137,1841.3617283664416,126.47429143817203,0.7868326273828057,0.7879038467022156,-177
1723,2021-09-20,2021,267122,267122,551921566.1999999,4233423.666666662,211835,0,203,0.9065707803924795,62318299,10562490497,267065,267065,95351,362416,516184275.7333347,4229602.349999946,211878,0,205,0.6690212352655464,9682441629,57,57,35737290.46666521,3821.3166667167097,-43,0,-2,0.23754954512693316,-9620123330,2066.177874529241,1932.803908162188,133.37396636705284,0.7930271561309065,0.7933574223503641,-43
1724,2021-09-21,2021,270506,270506,551533099.1666665,4251677.299999994,212055,0,93,0.8961132100581866,62134852,10565614693,270417,270417,87204,357621,515913690.7833362,4247114.116666488,212179,0,94,0.6786094776313497,9691106724,89,89,35619408.383330286,4563.183333505876,-124,0,-1,0.21750373242683685,-9628971872,2038.8941434447536,1907.844886909241,131.04925653551254,0.7839197651808093,0.7846363209413609,-124
1725,2021-09-22,2021,287472,287472,552515068.0499998,4435232.833333333,222430,0,205,0.8922573328880735,63324823,10576314831,287544,287544,79230,366774,516946495.8499968,4430584.000000779,222649,0,205,0.7009875291050938,9696322635,-72,-72,35568572.20000303,4648.833332554437,-219,0,0,0.19126980378297975,-9632997812,1921.97872505844,1797.7996266658208,124.17909839261915,0.7737449212445038,0.7743128008235262,-219
1726,2021-09-23,2021,282379,282379,552762726.2833333,4399207.333333335,217767,0,273,0.8788790951168466,62627517,10582568330,282433,282433,87403,369836,517277247.6833364,4394748.166667439,217984,0,276,0.672484560724216,9708220319,-54,-54,35485478.599996924,4459.166665895842,-217,0,-3,0.20639453439263056,-9645592802,1957.5206594092808,1831.5042777697238,126.01638163955704,0.7711869508709925,0.7718078269890558,-217
1727,2021-09-24,2021,280232,280232,553326731.7499999,4349291.250000003,218362,0,255,0.8868330526135477,62316776,10598616882,280292,280292,89798,370090,517906097.1166614,4344753.6166671235,218566,0,256,0.6726093652895365,9716670345,-60,-60,35420634.63333845,4537.6333328792825,-204,0,-1,0.2142236873240112,-9654353569,1974.5308592523334,1847.737706094578,126.79315315775534,0.7792186474064347,0.7797796583562856,-204
1728,2021-09-25,2021,277460,277460,553642353.8500003,4372813.666666668,217275,0,104,0.8912636055647678,64209457,10609209158,277299,277299,89207,366506,518324325.7166613,4367880.950000474,217440,0,108,0.6760080326106667,9731452666,161,161,35318028.13333899,4932.716666193679,-165,0,-4,0.21525557295410114,-9667243209,1995.395205975637,1869.189307269991,126.20589870564595,0.7830858502126432,0.7841355360098666,-165
1729,2021-09-26,2021,278908,278908,554260484.8833332,4301800.233333334,219296,0,42,0.8914875155965418,61591185,10620924186,278850,278850,84543,363393,519000207.6500105,4297555.850000102,219499,0,42,0.6852085758393858,9745532915,58,58,35260277.23332268,4244.383333232254,-203,0,0,0.20627893975715605,-9683941730,1987.252014583064,1861.216452035182,126.03556254788191,0.7862664391125389,0.7871579702348933,-203
1730,2021-09-27,2021,274820,274820,554404684.5333331,4340711.349999998,214572,0,55,0.8975584018630385,62962996,10632061861,274788,274788,90936,365724,519182214.0666662,4336386.81666709,214706,0,54,0.6749488685456922,9765606219,32,32,35222470.46666688,4324.533332907595,-134,0,1,0.22260953331734623,-9702643223,2017.3374737403867,1889.3918732501645,127.9456004902222,0.7807728695145914,0.7813514418387993,-134
1731,2021-09-28,2021,275631,275631,554871433.3333331,4330320.166666669,215393,0,51,0.8948267792809955,62417163,10644517974,275635,275635,82607,358242,519719484.5833361,4325447.983333805,215509,0,52,0.689436191178034,9769323514,-4,-4,35151948.74999702,4872.183332864195,-116,0,-1,0.2053905881029615,-9706906351,2013.0951646706399,1885.5351627454284,127.56000192521151,0.7814541905663731,0.781863696555227,-116
1732,2021-09-29,2021,278152,278152,555308509.1333332,4394379.466666669,217913,0,116,0.9055013086370038,63225908,10653508260,278296,278296,82877,361173,520208700.383334,4390174.433333794,218083,0,116,0.698429838332325,9783640571,-144,-144,35099808.749999225,4205.033332874998,-170,0,0,0.20707147030467887,-9720414663,1996.4210544354642,1869.264022419776,127.15703201568817,0.7834313612700969,0.7836368470980539,-170
1733,2021-09-30,2021,280711,280711,556055478.4999999,4438037.533333334,218162,0,114,0.9017637356569553,63645457,10667150144,280722,280722,82594,363316,521028493.8500048,4433408.133334368,218328,0,116,0.6979984366226734,9796288017,-11,-11,35026984.64999509,4629.3999989666045,-166,0,-2,0.20376529903428198,-9732642560,1980.8823968423035,1856.0301431665662,124.8522536757373,0.7771765267481502,0.7777374056896147,-166
1734,2021-10-01,2021,281149,281149,556271711.3333325,4429613.249999997,217579,0,137,0.8953437501111515,62369822,10676552358,281221,281221,83445,364666,521341745.166668,4425114.116667428,217725,0,137,0.6912462362819499,9807323997,-72,-72,34929966.16666454,4499.133332569152,-146,0,0,0.2040975138292016,-9744954175,1978.5654984841935,1853.8506909749556,124.71480750923797,0.7738921354868771,0.7742131633128394,-146
1735,2021-10-02,2021,281186,281186,556449600.85,4412824.766666667,215049,0,42,0.8747590562830297,62778900,10679626209,281075,281075,83294,364369,521582395.79999804,4408042.116667762,215231,0,44,0.6763089066303638,9819964968,111,111,34867205.05000198,4782.649998904206,-182,0,-2,0.19845014965266594,-9757186068,1978.9377879766419,1855.6698240683022,123.26796390833965,0.764792699494285,0.7657422396157609,-182
1736,2021-10-03,2021,267380,267380,556389326.9000002,4264050.966666664,209870,0,64,0.8955494053407133,62834796,10692141221,267312,267312,90473,357785,521595087.08333176,4259347.8166667335,210047,0,64,0.6704333608172438,9827105005,68,68,34794239.81666845,4703.149999930523,-177,0,0,0.22511604452346945,-9764270209,2080.893585533698,1951.2595285035156,129.63405703018248,0.7849128581045702,0.7857746752858084,-177
1737,2021-10-04,2021,261307,261307,556591146.5833336,4221363.533333328,205183,0,132,0.9005537547788625,63062496,10711248761,261345,261345,85079,346424,521855303.3666753,4216647.249999789,205407,0,132,0.6805417638500821,9848909429,-38,-38,34735843.216658294,4716.283333539031,-224,0,0,0.22001199092878032,-9785846933,2130.027693798228,1996.8061503632184,133.2215434350096,0.7852181533598411,0.7859610859209092,-224
1738,2021-10-05,2021,261154,261154,556599030.2499998,4220879.749999995,205251,0,120,0.8999708983971147,62819780,10715270923,261212,261212,78114,339326,521952826.0000028,4216277.016665959,205480,0,121,0.694096532538048,9863509419,-58,-58,34646204.24999696,4602.733334036544,-229,0,-1,0.2058743658590667,-9800689639,2131.3057822204514,1998.196200787111,133.1095814333405,0.7859385649846451,0.7866407362602025,-229
1739,2021-10-06,2021,263954,263954,557148773.5166667,4241878.683333327,207241,0,141,0.8991718253938191,63475589,10730827060,264019,264019,75226,339245,522551777.34999967,4237857.566666641,207386,0,142,0.7006912408436512,9877271874,-65,-65,34596996.166666985,4021.11666668579,-145,0,-1,0.19848058455016793,-9813796285,2110.7798082873023,1979.2203491036616,131.55945918364068,0.7851405926790274,0.7854964983580727,-145
1740,2021-10-07,2021,265501,265501,557691375.283333,4268870.1,207579,0,41,0.895442955017118,63592494,10743961263,265516,265516,77043,342559,523165885.8833357,4264891.300000098,207757,0,42,0.6951386476490099,9892248330,-15,-15,34525489.399997234,3978.799999902025,-178,0,-1,0.20030430736810811,-9828655836,2100.5245753625522,1970.3742368947096,130.15033846784263,0.781838863130459,0.7824650868497567,-178
1741,2021-10-08,2021,268241,268241,558046104.9666666,4300784.700000001,210172,0,50,0.9003619879138527,63679144,10755752091,268152,268152,77361,345513,523670031.73332846,4297153.366666961,210304,0,51,0.6998810464439851,9906996237,89,89,34376073.23333812,3631.3333330396563,-132,0,-1,0.2004809414698676,-9843317093,2080.3907865190877,1952.885049275517,127.5057372435706,0.7835192979447586,0.7842716071481846,-132
1742,2021-10-09,2021,266940,266940,558179391.0666664,4307615.116666665,210533,0,37,0.9046939387128188,63904426,10760433215,266946,266946,78216,345162,523863249.13333404,4303849.9666670505,210690,0,37,0.7005000550466239,9922944211,-6,-6,34316141.933332324,3765.149999614805,-157,0,0,0.20419388366619484,-9859039785,2091.029411353362,1962.4315372147703,128.59787413859158,0.788690342399041,0.7892607493650401,-157
1743,2021-10-10,2021,264985,264985,558555020.0499995,4261146.783333334,210737,0,39,0.9167650999113153,64812940,10774056014,264956,264956,80330,345286,524182453.3000047,4257435.166666656,210890,0,39,0.7042306957131285,9930541607,29,29,34372566.749994755,3711.6166666783392,-153,0,0,0.2125344041981868,-9865728667,2107.8741062701642,1978.3754785700446,129.49862770011964,0.7952789780553616,0.7959434774075695,-153
1744,2021-10-11,2021,255981,255981,558904188.6166664,4205722.033333335,202777,0,47,0.9116496927506339,62501611,10785656360,255941,255941,82556,338497,524556578.0499945,4201679.333333228,202954,0,49,0.6902867676818398,9947550537,40,40,34347610.56667191,4042.7000001072884,-177,0,-2,0.22136292506879407,-9885048926,2183.3815346321267,2049.521483662229,133.86005096989766,0.7921564491114574,0.792971817723616,-177
1745,2021-10-12,2021,256868,256868,558907770.6166666,4247196.416666662,203581,0,35,0.9081707336063655,62751565,10788887140,256847,256847,73636,330483,524605253.4333371,4244007.466666609,203639,0,35,0.7062753606085478,9962677024,21,21,34302517.18332946,3188.9500000532717,-58,0,0,0.20189537299781768,-9899925459,2175.8559673321183,2042.481529600646,133.37443773147243,0.7925510378871639,0.792841652812764,-58
1746,2021-10-13,2021,272295,272295,559179202.8666669,4344031.566666665,213151,0,48,0.8910409665987259,63414968,10788040256,272428,272428,70992,343420,525079137.15000355,4340585.766666863,213311,0,50,0.7073758080484702,9966220506,-133,-133,34100065.71666336,3445.799999801442,-160,0,-2,0.18366515855025567,-9902805538,2053.5786660301032,1927.405175495924,126.17349053417934,0.7827943957839842,0.7829995448338644,-160
1747,2021-10-14,2021,273445,273445,559890130.8499998,4330568.116666663,212235,0,45,0.8817860995812689,63268918,10802342466,273447,273444,78475,351922,525841015.4666609,4326981.96666712,212454,0,45,0.6863225373804361,9975640939,-2,1,34049115.38333887,3586.149999543093,-219,0,0,0.19546356220083272,-9912372021,2047.5420316699876,1923.0300005363472,124.51203113364045,0.7761524255334711,0.7769476351907316,-219
1748,2021-10-15,2021,272560,272560,559940560.9000001,4295459.899999999,212725,0,40,0.894782800117404,63209937,10812987782,272497,272497,85566,358063,525935700.7833398,4291111.76666695,212926,0,41,0.6821397351862784,9987262787,63,63,34004860.1166603,4348.133333049715,-201,0,-1,0.2126430649311256,-9924052850,2054.3754068828885,1930.0605173023548,124.31488958053365,0.7804703551511594,0.781388418955071,-201
1749,2021-10-16,2021,258521,258521,559324322.0166667,4219961.3333333265,206378,0,45,0.9226871317997375,62736735,10812071719,258566,258566,86573,345139,525400874.11666864,4215618.183333278,206522,0,45,0.6919907631417946,9998543335,-45,-45,33923447.89999801,4343.150000048801,-144,0,0,0.23069636865794285,-9935806600,2163.5546900122877,2031.979742567347,131.57494744494056,0.7983026523957435,0.7987206361238524,-144
1750,2021-10-17,2021,263733,263733,559504465.1500007,4157102.066666669,207185,0,31,0.8910337348758036,61785375,10820361635,263802,263802,80982,344784,525601652.1833314,4153186.3666664083,207296,0,33,0.6820357093136484,10005199935,-69,-69,33902812.96666932,3915.7000002609566,-111,0,-2,0.2089980255621552,-9943414560,2121.4806836838798,1992.4096564216018,129.071027262278,0.7855861799623104,0.7858014723163584,-111
1751,2021-10-18,2021,271339,271339,558702851.7499999,4259973.100000007,213676,0,47,0.9004750515038388,63331685,10807129142,271364,271364,83171,354535,524984320.98332775,4255875.683333363,213892,0,47,0.6901998392260307,10003582642,-25,-25,33718530.766672134,4097.416666643694,-216,0,0,0.2102752122778081,-9940250957,2059.058416777536,1934.6129957670425,124.44542101049342,0.787487239209992,0.78821066906443,-216
1752,2021-10-19,2021,265545,265545,558902414.0500002,4205914.066666661,210271,0,48,0.9120224444067854,60966556,10811702647,265562,265562,83854,349416,525234194.88333267,4201204.566666539,210477,0,48,0.6942097671543315,9999858649,-17,-17,33668219.16666752,4709.500000122003,-206,0,0,0.2178126772524539,-9938892093,2104.737103127531,1977.8213557788113,126.91574734871983,0.7918469562597676,0.7925719794247671,-206
1753,2021-10-20,2021,266942,266942,559077319.0333328,4286663.649999997,207887,0,54,0.9086955218736643,61748758,10815527779,266685,266685,80087,346772,525493527.5999904,4281773.8166669505,208068,0,54,0.7005236870335565,10007033949,257,257,33583791.4333424,4889.8333330461755,-181,0,0,0.20817183484010782,-9945285191,2094.3775016045915,1970.465259013407,123.91224259118462,0.7787721677368118,0.7802013611564205,-181
1754,2021-10-21,2021,266783,266783,559289821.4666659,4268574.766666672,210351,0,122,0.9225812739192522,62474158,10813393289,266777,266777,78903,345680,525762944.3333434,4264360.416666836,210486,0,122,0.712896320296228,10013637492,6,6,33526877.133322477,4214.349999836646,-135,0,0,0.2096849536230242,-9951163334,2096.4222662863294,1970.795624560376,125.6266417259535,0.7884722789683001,0.7889960528831196,-135
1755,2021-10-22,2021,262372,262372,559005343.833333,4241588.266666666,206663,0,60,0.9166145777750667,62401515,10812038465,262367,262367,80338,342705,525525746.250009,4237456.016666553,206815,0,61,0.7025896908419905,10014967944,5,5,33479597.583324015,4132.25000011269,-152,0,-1,0.2140248869330762,-9952566429,2130.583079876408,2003.0177051611254,127.56537471528281,0.7876717027731618,0.7882660548010992,-152
1756,2021-10-23,2021,265752,265752,559166248.3666662,4259787.683333337,209499,0,37,0.909249977422559,62465335,10815647568,265687,265687,77632,343319,525783277.83333045,4255425.06666678,209637,0,38,0.704784762859044,10014578188,65,65,33382970.533335745,4362.616666557267,-138,0,-1,0.20446521456351496,-9952112853,2104.0904616584867,1978.9574869426447,125.13297471584201,0.7883252054547096,0.7890374764290311,-138
1757,2021-10-24,2021,261150,261150,559018435.4500006,4188099.4833333367,206380,0,38,0.9121883974727163,61611194,10817286264,261150,261150,80039,341189,525659875.01666343,4183633.2333332943,206529,0,38,0.699172599351087,10018366832,0,0,33358560.43333721,4466.250000042375,-149,0,0,0.2130157981216293,-9956755638,2140.6028544897595,2012.8656902801586,127.7371642096009,0.7902737890101474,0.7908443423319931,-149
1758,2021-10-25,2021,266041,266041,559450580.0166668,4217767.400000002,207013,0,45,0.8963280095925067,61405274,10833104291,265903,265903,78034,343937,526160998.3000017,4214658.3333333265,207181,0,45,0.6945719710295656,10029963755,138,138,33289581.71666509,3109.0666666757315,-168,0,0,0.2017560385629411,-9968558481,2102.8735421106776,1978.7704474940174,124.1030946166602,0.7781244244308209,0.7791600696494586,-168
1759,2021-10-26,2021,267062,267062,559212945.5166667,4254667.183333331,210696,0,42,0.9152930780118473,61587733,10829431616,267018,267018,80974,347992,525962617.43333787,4251279.75000003,210736,0,42,0.7027977654658871,10032145951,44,44,33250328.083328784,3387.4333333009854,-40,0,0,0.2124953125459602,-9970558218,2093.9442733023293,1969.7646504480517,124.17962285427757,0.7889403958631329,0.7892202023833599,-40
1760,2021-10-27,2021,272744,272744,559578421.0333334,4343299.149999995,214365,0,42,0.9221614407649664,63021626,10837170524,272752,272752,79432,352184,526397535.4833363,4338865.016667079,214506,0,42,0.7150551984190375,10035897647,-8,-8,33180885.54999709,4434.133332915604,-141,0,0,0.2071062423459289,-9972876021,2051.6617085374323,1929.9493147010337,121.71239383639863,0.7859567946499282,0.7864506951369743,-141
1761,2021-10-28,2021,272925,272925,560111856.4666663,4334069.266666667,212500,0,54,0.9103893010900431,62610499,10845099622,272938,272938,79468,352406,526970472.1166673,4330705.900000503,212653,0,54,0.7061911545206287,10045647247,-13,-13,33141384.34999907,3363.366666163318,-153,0,0,0.20419814656941437,-9983036748,2052.255588409513,1930.733251202351,121.52233720716208,0.7786021800861043,0.7791256622383105,-153
1762,2021-10-29,2021,252891,252891,558909629.3499994,3883335.2666666736,191889,0,71,0.8690661193953123,59572786,10841519469,252975,252975,85531,338506,525830786.483335,3881093.73333284,192115,0,71,0.6507211098178333,10051530405,-84,-84,33078842.86666441,2241.533333833795,-226,0,0,0.21834500957747904,-9991957619,2210.0811391073603,2078.587949336239,131.49318977112125,0.7587814512971992,0.7594228678723194,-226
1763,2021-10-30,2021,227586,227586,549775228.0000006,3709010.6000000015,165419,0,67,0.8301960577539922,58228569,10799537777,227747,227747,89380,317127,516732485.866668,3705207.7499997728,165643,0,67,0.5969911108167943,10047370536,-161,-161,33042742.13333261,3802.850000228733,-224,0,0,0.23320494693719784,-9989141967,2415.6812281950583,2268.888221871937,146.79300632312152,0.7268417213712619,0.7273114464734991,-224
1764,2021-10-31,2021,222855,222855,547294170.8166665,3648718.1333333333,162950,0,43,0.8363509905543968,58148252,10790549023,223045,223045,68674,291719,514262022.8666602,3645511.049999642,163155,0,43,0.6402325525591499,10011265209,-190,-190,33032147.950006306,3207.0833336911164,-205,0,0,0.19611843799524686,-9953116957,2455.830790499053,2305.6424616855797,150.18832881347316,0.7311929281371295,0.7314891613799905,-205
1765,2021-11-01,2021,223832,223832,546049067.7166665,3630140.266666669,163532,0,59,0.8354301440365977,57697419,10790845945,223891,223891,65508,289399,513074747.35000354,3626490.383333033,163685,0,59,0.6473311932660407,10002058598,-59,-59,32974320.36666292,3649.883333635982,-153,0,0,0.18809895077055694,-9944361179,2439.548713841928,2291.6273872107568,147.92132663117127,0.7306015225704993,0.73109236190825,-153
1766,2021-11-02,2021,224736,224736,544596760.3000001,3643432.700000002,163856,0,39,0.827548768332621,58162546,10779407236,224975,224975,64025,289000,511711195.7166726,3640776.3666662206,164068,0,39,0.6447993079584879,10001657534,-239,-239,32885564.583327472,2656.3333337814547,-212,0,0,0.1827494603741331,-9943494988,2423.2733531788413,2274.524705930315,148.74864724852614,0.7291043713512744,0.7292721413490387,-212
1767,2021-11-03,2021,229238,229238,543379980.8666667,3675579.9666666607,165874,0,47,0.8216918660954984,57517841,10767540850,229469,229469,63458,292927,510640875.8666704,3674039.166666379,166071,0,47,0.6442936294708163,9990431154,-231,-231,32739104.999996245,1540.8000002815388,-197,0,0,0.17739823662468213,-9932913313,2370.3748107498177,2225.3152969101293,145.0595138396884,0.7235885847896073,0.7237186722389517,-197
1768,2021-11-04,2021,231271,231271,542401016.6333328,3598318.5000000033,165644,0,46,0.8102745264213848,56929718,10755552716,231452,231452,63935,295387,509747684.58332264,3596049.283333023,165871,0,46,0.6359352307312156,9977243782,-181,-181,32653332.050010204,2269.216666980181,-227,0,0,0.17433929569016915,-9920314064,2345.304930723406,2202.390493853251,142.914436870155,0.7162333366483477,0.7166539930525552,-227
1769,2021-11-05,2021,223462,223462,539210140.1500003,3525854.7833333337,160707,0,60,0.8120217307640671,56137208,10726741828,223727,223727,73751,297478,506595552.1000049,3524533.5833328944,160987,0,61,0.6117796946328782,9969340435,-265,-265,32614588.049995422,1321.2000004393049,-280,0,-1,0.20024203613118896,-9913203227,2412.983595197395,2264.3469590170384,148.63663618035662,0.7191692547278732,0.7195689389300353,-280
1770,2021-11-06,2021,211303,211303,536283287.04999983,3388897.7166666654,154637,0,50,0.8240015522732762,55751429,10701776081,211440,211440,72494,283934,503710612.69998837,3385788.1999997427,154830,0,50,0.61447378616158,9945692979,-137,-137,32572674.350011468,3109.5166669227183,-193,0,0,0.2095277661116962,-9889941550,2537.9823620582756,2382.2862878357378,155.69607422253785,0.73182586144068,0.7322644721906924,-193
1771,2021-11-07,2021,168751,168751,522967419.8833333,2865955.6999999983,132224,0,34,0.8823651415399022,52028796,10588782553,168856,168856,82351,251207,490442281.6500033,2863607.2833328447,132342,0,34,0.5938250128380151,9912202062,-105,-105,32525138.23333001,2348.416667153593,-118,0,0,0.28854012870188706,-9860173266,3099.0478271733696,2904.5001755934245,194.54765157994507,0.7835449864000806,0.7837565736485527,-118
1772,2021-11-08,2021,170801,170801,519343243.0166669,2878490.066666668,132999,0,87,0.8817044396695567,52158694,10557862610,170945,170945,47510,218455,486852068.25001395,2875696.8166663083,133100,0,87,0.690865395619232,9818438837,-144,-144,32491174.76665294,2793.2500003594905,-101,0,0,0.1908390440503247,-9766280143,3040.6335034143062,2848.004143145538,192.62936026876832,0.7786781107838947,0.7786130041826318,-101
1773,2021-11-09,2021,172256,172256,517702899.0666669,2889788.433333334,134485,0,45,0.8809910830391977,52606597,10539306743,172399,172399,44066,216465,485332635.63333476,2885508.633332977,134639,0,45,0.7029311897997406,9782537444,-143,-143,32370263.433332145,4279.800000356976,-154,0,0,0.17805989323945715,-9729930847,3005.427381726424,2815.1708283304124,190.25655339601144,0.780727521827977,0.7809732075012036,-154
1774,2021-11-10,2021,171856,171856,515029427.59999985,2882684.383333336,133579,0,61,0.8758437296341132,51540546,10505241880,172066,172066,45781,217847,482819451.9499975,2881608.6333329873,133788,0,61,0.6931148925622067,9765290105,-210,-210,32209975.65000236,1075.7500003487803,-209,0,0,0.18272883707190646,-9713749559,2996.8661414207236,2806.0131109574086,190.853030463315,0.7772728330695466,0.7775388513709856,-209
1775,2021-11-11,2021,173182,173182,514049665.85,2890794.5833333367,134417,0,202,0.8809980251989238,51555990,10489251574,173376,173376,47414,220790,481927452.73333436,2888612.333333061,134565,0,203,0.6927895285112459,9748717803,-194,-194,32122213.11666566,2182.2500002756715,-148,0,-1,0.18820849668767792,-9697161813,2968.262670774099,2779.6664632552047,188.59620751889452,0.7761603399891444,0.7761454872646734,-148
1776,2021-11-12,2021,174181,174181,513439694.81666696,2887500.633333334,135496,0,185,0.8876513511806674,52231195,10482427887,174268,174268,50111,224379,481416153.7333432,2884879.8166663335,135624,0,188,0.6908489653666265,9737509123,-87,-87,32023541.083323777,2620.8166670002975,-128,0,-3,0.19680238581404086,-9685277928,2947.7365201524103,2762.504612053522,185.2319080988882,0.7779034452667053,0.778249592581541,-128
1777,2021-11-13,2021,170675,170675,512409475.86666703,2883284.7500000023,133539,0,126,0.8942610224110155,52025677,10472660480,170829,170829,52455,223284,480422406.3833349,2879199.5833331584,133691,0,127,0.6853110836423748,9723323262,-154,-154,31987069.483332157,4085.1666668439284,-152,0,-1,0.20894993876864065,-9671297585,3002.252678287195,2812.300056684374,189.95262160282118,0.7824168741760656,0.7826013147650575,-152
1778,2021-11-14,2021,169435,169435,512232134.75000024,2871281.500000002,131933,0,135,0.8891492312686282,52250274,10475441092,169608,169608,50324,219932,480200975.9833328,2868941.616666455,132069,0,136,0.6866576941963874,9723096023,-173,-173,32031158.766667426,2339.883333547041,-136,0,-1,0.20249153707224077,-9670845749,3023.1778248295823,2831.24013008427,191.93769474531246,0.7786643845722548,0.7786719966039338,-136
1779,2021-11-15,2021,174223,174223,512586763.5333335,2924474.1833333327,134824,0,73,0.8856867348168724,53169118,10485225094,174440,174440,49720,224160,480582657.21666753,2922086.4999998156,135016,0,73,0.6911001070663711,9727713253,-217,-217,32004106.316665947,2387.6833335170522,-192,0,0,0.19458662775050128,-9674544135,2942.1302786275837,2755.0026210540445,187.12765757353918,0.7738587901712174,0.7739967897271268,-192
1780,2021-11-16,2021,174844,174844,512637896.61666656,2929763.783333332,136326,0,50,0.8875397497197508,52638659,10490540997,175113,175113,49423,224536,480729553.3500024,2927176.7666664445,136502,0,50,0.6935324402323021,9732701813,-269,-269,31908343.266664147,2587.016666887328,-176,0,0,0.1940073094874487,-9680063154,2931.973053788901,2745.2533698240704,186.71968396483044,0.779700761821967,0.779508089062491,-176
1781,2021-11-17,2021,174220,174220,512916728.1833329,2917942.750000004,135715,0,51,0.8892492251176675,52035493,10498913295,175456,175456,50787,226243,481073722.31666636,2916261.249999668,136355,0,53,0.6889273922287,9740272204,-1236,-1236,31843005.866666555,1681.5000003362074,-640,0,-2,0.20032183288896743,-9688236711,2944.074894864728,2741.848225860993,202.22666900373497,0.7789863391114683,0.777146407076418,-640
1782,2021-11-18,2021,172322,172322,512689124.74999976,2899005.8333333307,134491,0,37,0.8866772669769389,52064542,10496942401,172532,172532,52943,225475,480951365.0833284,2895303.0999996844,134653,0,38,0.6797294600288324,9747306777,-210,-210,31737759.666671336,3702.73333364632,-162,0,-1,0.20694780694810655,-9695242235,2975.1809098664116,2787.6067343062646,187.57417556014707,0.7804633186708604,0.7804523218881135,-162
1783,2021-11-19,2021,172153,172153,512577740.80000097,2877870.499999997,134480,0,39,0.888180862372424,52329521,10501253688,172239,172239,51000,223239,480884331.18333304,2875789.433333086,134610,0,41,0.6863854434036992,9750743138,-86,-86,31693409.616667926,2081.066666911356,-130,0,-2,0.20179541896872477,-9698413617,2977.454594459585,2791.9596095154584,185.49498494412683,0.781165591073057,0.7815303154337868,-130
1784,2021-11-20,2021,168223,168223,512066502.3666671,2861236.5333333346,131433,0,66,0.8934687884534214,52641160,10501897651,168324,168324,53323,221647,480411044.89999574,2858669.0833331156,131545,0,69,0.6796843629735616,9757297940,-101,-101,31655457.466671348,2567.450000219047,-112,0,-3,0.21378442547985976,-9704656780,3043.9743814262442,2854.085245716569,189.88913570967543,0.7813022000558782,0.7814987761697678,-112
1785,2021-11-21,2021,165397,165397,511915193.2833328,2820097.833333332,129925,0,65,0.9000163243589674,52000474,10502519165,165507,165507,50921,216428,480381541.30000174,2815450.5833330527,130036,0,65,0.6888526438353508,9754721183,-110,-110,31533651.983331084,4647.250000279397,-111,0,0,0.21116368052361656,-9702720709,3095.0693983768315,2902.484736597254,192.58466177957735,0.7855341995320351,0.785682780788728,-111
1786,2021-11-22,2021,165116,165116,511854698.66666645,2821023.4999999977,130261,0,76,0.9016085660989835,52071169,10512336878,165305,165305,51481,216786,480347216.5833375,2818367.449999714,130383,0,76,0.6877658151356564,9761479374,-189,-189,31507482.083328962,2656.050000283867,-122,0,0,0.21384275096332717,-9709408205,3099.970315818373,2905.8238806045642,194.14643521380867,0.7889059812495458,0.7887420223223738,-122
1787,2021-11-23,2021,165410,165410,511996800.56666726,2826317.9166666716,130918,0,65,0.9025935554077746,52042756,10520613788,165624,165624,46860,212484,480515336.63332695,2824005.583333121,131064,0,65,0.7043212665424178,9767868701,-214,-214,31481463.93334031,2312.3333335504867,-146,0,0,0.19827228886535686,-9715825945,3095.319512524438,2901.2421909465234,194.07732157791452,0.7914757269814401,0.7913345891899725,-146
1788,2021-11-24,2021,168135,168135,512132003.21666664,2856954.183333326,132189,0,104,0.9006928955898524,51715046,10525220643,168342,168342,46890,215232,480666924.64999676,2854383.799999813,132300,0,106,0.7051274903360053,9775950249,-207,-207,31465078.56666988,2570.3833335130475,-111,0,-2,0.19556540525384714,-9724235203,3045.957136923702,2855.3000715804537,190.65706534324818,0.7862075118208582,0.7859001318743986,-111
1789,2021-11-25,2021,167460,167460,512325073.4333326,2870187.5833333344,131788,0,72,0.9015884390302163,51036739,10529015837,167612,167612,48159,215771,480983493.9999994,2868590.5166664296,131997,0,72,0.7016698258802241,9780939078,-152,-152,31341579.433333218,1597.066666904837,-209,0,0,0.19991861314999226,-9729902339,3059.387754886735,2869.6244540963617,189.76330079037325,0.7869819658425893,0.787515213707849,-209
1790,2021-11-26,2021,167524,167524,512712912.30000025,2854463.7666666666,131921,0,35,0.8999546333659649,51498695,10534663068,167732,167732,48312,216044,481428216.6166692,2852029.449999734,132125,0,35,0.6999129806891213,9786319577,-208,-208,31284695.683331072,2434.3166669327766,-204,0,0,0.2000416526768436,-9734820882,3060.534086459255,2870.222835336544,190.31125112271093,0.7874752274300996,0.7877149261917822,-204
1791,2021-11-27,2021,162465,162465,512465374.7666665,2821918.566666667,128795,0,43,0.9047364047641033,50954169,10531976187,162673,162673,49789,212462,481213305.2500019,2819926.5333330953,128997,0,42,0.6941758996902958,9793661615,-208,-208,31252069.516664565,1992.0333335716277,-202,0,1,0.21056050507380752,-9742707446,3154.3124658644415,2958.163341488765,196.14912437567637,0.7927553626935032,0.7929834699058849,-202
1792,2021-11-28,2021,161789,161789,512237882.79999965,2811821.150000003,128042,0,60,0.9105377992323332,51282143,10532679102,161974,161974,47568,209542,480959797.9000072,2809270.8499996546,128233,0,60,0.7049278903513412,9794004720,-185,-185,31278084.899992466,2550.300000348594,-191,0,0,0.20560990888099206,-9742722577,3166.0859687617804,2969.3642059837207,196.72176277805966,0.791413507716841,0.791688789558818,-191
1793,2021-11-29,2021,205933,205933,513043650.0166666,3136360.699999997,147118,0,45,0.8261376272865452,55505853,10551123261,206581,206581,45751,252332,481833583.2166776,3132718.5166664277,147603,0,45,0.6780511389756285,9806321313,-648,-648,31210066.799988985,3642.1833335692063,-485,0,0,0.14808648831091664,-9750815460,2491.313436975456,2332.4196475797753,158.89378939568087,0.7143974010964731,0.7145042380470614,-485
1794,2021-11-30,2021,218871,218871,514391802.2333325,3676201.899999995,160407,0,101,0.8540921364639453,61816691,10570810730,220409,220409,42917,263326,483313543.4166893,3671656.883332664,161760,0,101,0.7200352414877462,9798119669,-1538,-1538,31078258.816643238,4545.016667330638,-1353,0,0,0.1340568949761991,-9736302978,2350.2053823180436,2192.803122452755,157.40225986528867,0.7328837534438094,0.7339083249776551,-1353
1795,2021-12-01,2021,234883,234883,515842520.9666661,3833268.6999999983,172823,0,42,0.8624038351008798,62936922,10592428263,236832,236832,54876,291708,484851331.6499932,3828272.5833334983,174488,0,39,0.707039231011829,9820651726,-1949,-1949,30991189.31667292,4996.116666499991,-1665,0,3,0.15536460408905084,-9757714804,2196.1679685914523,2047.2374157630438,148.9305528284085,0.7357833474538387,0.7367585461424132,-1665
1796,2021-12-02,2021,251835,251835,517812938.3999992,4077913.633333332,183360,0,75,0.8559096233645059,62673681,10616071335,253728,253728,57128,310856,486833189.51666725,4072083.833333481,184994,0,75,0.7033031371438837,9845049383,-1893,-1893,30979748.883331954,5829.799999850802,-1634,0,0,0.15260648622062223,-9782375702,2056.159542557624,1918.7207935926158,137.43874896500802,0.7280957769968431,0.7291036070122335,-1634
1797,2021-12-03,2021,255631,255631,519643788.56666756,4133400.8666666592,184526,0,44,0.86198465757283,63214584,10643687951,257572,257572,63839,321411,488730606.84999937,4128195.8166668043,186233,0,42,0.6946588635734127,9873590087,-1941,-1941,30913181.71666819,5205.049999854993,-1707,0,2,0.16732579399941738,-9810375503,2032.7886233151205,1897.4523894289728,135.33623388614774,0.7218451596246152,0.7230327830664823,-1707
1798,2021-12-04,2021,247841,247841,521042062.2499999,4059445.833333331,179176,0,53,0.8656033505352236,63254983,10666146522,249707,249707,68799,318506,490114822.03333277,4053238.5666671055,180934,0,53,0.6835224454170317,9899765388,-1866,-1866,30927240.216667116,6207.266666225623,-1758,0,0,0.18208090511819197,-9836510405,2102.3239183589476,1962.759642434264,139.56427592468367,0.7229473735176989,0.7245852138706564,-1758
1799,2021-12-05,2021,246832,246832,522427680.2499999,3963447.85,177012,0,43,0.8515427497245086,62849585,10689660363,248598,248598,66309,314907,491547141.0999976,3957366.183333647,178631,0,43,0.6773364834697158,9922261122,-1766,-1766,30880539.1500023,6081.666666353121,-1619,0,0,0.17420626625479285,-9859411537,2116.531406989369,1977.2771345706626,139.25427241870625,0.717135541582939,0.7185536488628227,-1619
1800,2021-12-06,2021,242079,242079,523812235.01666695,3900215.233333333,173050,0,42,0.8415310704356831,63117109,10726793013,243955,243955,72027,315982,492943858.1166664,3893818.6666668146,174702,0,39,0.6541543505642705,9950900608,-1876,-1876,30868376.900000572,6396.566666518338,-1652,0,3,0.18737671987141258,-9887783499,2163.8070010891774,2020.6343715712585,143.17262951791895,0.714849284737627,0.7161238753048718,-1652
1801,2021-12-07,2021,243666,243666,525029888.81666696,3927265.4999999935,174811,0,47,0.8522567777203224,62586970,10752951250,245592,245592,68954,314546,494145212.5833389,3921915.433333709,176470,0,45,0.6705060627062611,9982191314,-1926,-1926,30884676.233328044,5350.066666284576,-1659,0,2,0.18175071501406126,-9919604344,2154.7113213032058,2012.0574472431467,142.65387406005902,0.7174205674981327,0.7185494641519268,-1659
1802,2021-12-08,2021,250924,250924,526226142.9166669,3985072.150000002,179315,0,50,0.8501458608981202,63062895,10775396912,255025,255025,66264,321289,495374364.4666635,3982176.033333548,182457,0,50,0.6784670499145656,10012147067,-4101,-4101,30851778.450003445,2896.1166664538905,-3142,0,0,0.17167881098355453,-9949084172,2097.1534923589093,1942.4541298565375,154.69936250237174,0.7146187690296664,0.7154475051465543,-3142
1803,2021-12-09,2021,254936,254936,527197054.3166662,4051474.200000004,183109,0,51,0.8520452191922687,62836667,10790787285,266980,266980,70213,337193,496462156.8499983,4051914.950000463,189179,0,51,0.6675108913886104,10032127262,-12044,-12044,30734897.46666789,-440.75000045914203,-6070,0,0,0.1845343278036583,-9969290595,2067.958445714478,1859.5481191474953,208.41032656698258,0.7182547776696896,0.7085886583264664,-6070
1804,2021-12-10,2021,252189,252189,528389549.3333336,4043091.633333329,180659,0,88,0.8504375686489111,62691127,10810739247,254214,254214,78313,332527,494711515.41666514,4037657.033333582,182407,0,88,0.655312200212322,9888906878,-2025,-2025,33678033.916668475,5434.599999747239,-1748,0,0,0.19512536843658912,-9826215751,2095.2125165385232,1946.0435515615393,149.16896497698394,0.7163635210100361,0.7175332593798925,-1748
1805,2021-12-11,2021,242899,242899,529123458.56666595,3967143.316666668,175624,0,111,0.8542357111391973,62755767,10835859138,244642,244642,73037,317679,495554274.84999734,3961147.616667075,177307,0,113,0.6623446938576387,9906867985,-1743,-1743,33569183.716668606,5995.699999592733,-1683,0,-2,0.19189101728155855,-9844112218,2178.3682047545108,2025.6304103547116,152.7377943997992,0.7230330301895026,0.7247610794548769,-1683
1806,2021-12-12,2021,227832,227832,529757309.34999985,3779633.7499999967,164692,0,119,0.8491168931493376,62382744,10862848097,229762,229762,71463,301225,496204820.01666135,3774506.616666907,166431,0,121,0.652581957008889,9934651052,-1930,-1930,33552489.3333385,5127.133333089761,-1739,0,-2,0.1965349361404486,-9872268308,2325.2102836739346,2159.6470261255618,165.5632575483728,0.7228659714175357,0.7243626013004761,-1739
1807,2021-12-13,2021,244026,244026,531044619.9333328,3929678.2833333337,176620,0,157,0.8559948530074657,62703696,10891878890,260162,260162,64838,325000,497536175.5166955,3934097.2333328477,188330,0,158,0.6839876923076841,9964954240,-16136,-16136,33508444.4166373,-4418.949999514036,-11710,0,-1,0.1720071606997816,-9902250544,2176.1804886910936,1912.4090970883353,263.7713916027583,0.7237753354150788,0.7238951115074453,-11710
1808,2021-12-14,2021,256368,256368,532301987.46666706,4120821.866666671,183225,0,171,0.8519667041128375,63941340,10915970891,258199,258199,64967,323166,483792757.66666186,4114918.5833336497,184907,0,177,0.685328902174119,9335153427,-1831,-1831,48509229.8000052,5903.283333021216,-1682,0,-6,0.16663780193871847,-9271212087,2076.3199286442423,1873.7204933662092,202.59943527803307,0.7146952817824378,0.7161414257994803,-1682
1809,2021-12-15,2021,255183,255183,533715950.6499998,4110403.8333333274,179281,0,125,0.8298867871292364,63425262,10941779725,257234,257234,67406,324640,485269356.39999896,4104780.483333446,181063,0,129,0.6632731641202623,9357424642,-2051,-2051,48446594.250000834,5623.3499998813495,-1782,0,-4,0.1666136230089741,-9293999380,2091.502767229791,1886.4899523391114,205.0128148906797,0.7025585560166625,0.7038844009734327,-1782
1810,2021-12-16,2021,246273,246273,534629954.63333327,3872922.1833333364,174776,0,111,0.8331242158092858,62596678,10972655403,248160,248160,71981,320141,486168883.766674,3868694.566666024,176300,0,111,0.6495356733439185,9386700407,-1887,-1887,48461070.86665928,4227.61666731257,-1524,0,0,0.18358854246536727,-9324103729,2170.883347477528,1959.0944703686089,211.788877108919,0.7096839686039477,0.7104287556415216,-1524
1811,2021-12-17,2021,222503,222503,534130057.01666665,3694624.1499999976,160054,0,110,0.8475750888752063,62617906,10992379080,224000,224000,80841,304841,485747347.5500078,3689418.7333331276,161328,0,110,0.6270088341135278,9413644216,-1497,-1497,48382709.46665883,5205.416666870005,-1274,0,0,0.22056625476167846,-9351026310,2400.5521589222017,2168.5149444196777,232.03721450252397,0.7193341213376898,0.7202142857142857,-1274
1812,2021-12-18,2021,221727,221727,534581982.3333341,3727272.216666664,163674,0,53,0.8645676890951477,62894116,11008641171,223424,223424,66136,289560,486287709.13333184,3721777.450000209,165239,0,53,0.6717916839342433,9437783637,-1697,-1697,48294273.20000225,5494.766666455194,-1565,0,0,0.19277600516090443,-9374889521,2410.991815761428,2176.52404904277,234.4677667186579,0.7381780297392739,0.7395758736751648,-1565
1813,2021-12-19,2021,232869,232869,535600446.90000045,3870730.466666667,169553,0,59,0.8627597490434529,62785238,11033629382,234633,234633,56711,291344,487357831.4666697,3864782.1666669673,171106,0,60,0.6997295293536118,9459914398,-1764,-1764,48242615.433330774,5948.299999699462,-1553,0,-1,0.1630302196898411,-9397129160,2300.0075016425562,2077.1069349438044,222.90056669875185,0.7281046425243377,0.7292495088073715,-1553
1814,2021-12-20,2021,243592,243592,537405328.2333335,3965349.233333338,176022,0,95,0.8554878649545142,63363177,11065112950,245430,245430,58170,303600,489240644.0833324,3959354.366666898,177603,0,95,0.6962154150197627,9489716779,-1838,-1838,48164684.15000105,5994.866666439921,-1581,0,0,0.15927244993475154,-9426353602,2206.169858752888,1993.4019642396302,212.76789451325794,0.722609937928996,0.723640141791957,-1581
1815,2021-12-21,2021,242922,242922,538473488.3666667,3873043.716666666,173773,0,66,0.841475864680845,62360225,11085959243,246695,246695,64011,310706,490295847.549996,3867256.616666897,176883,0,66,0.6722593062251699,9518661096,-3773,-3773,48177640.816670656,5787.0999997686595,-3110,0,0,0.16921655845567507,-9456300871,2216.6517992057807,1987.4575793996473,229.19421980613333,0.7153448432006981,0.7170108838849591,-3110
1816,2021-12-22,2021,237717,237717,538887421.5833327,3863356.683333336,168900,0,47,0.8302098714017095,62218031,11107984188,239960,239960,71343,311303,489615810.16666925,3858582.2500000037,170703,0,48,0.6439803021493643,9490691959,-2243,-2243,49271611.41666341,4774.433333332185,-1803,0,-1,0.18622956925234524,-9428473928,2266.928413127091,2040.4059433516804,226.52246977541063,0.710508714143288,0.711381063510585,-1803
1817,2021-12-23,2021,236105,236105,539699925.5166663,3835540.8500000015,169904,0,41,0.8386480591262355,62504935,11124864039,237758,237758,68328,306086,490450919.1500103,3829695.8999993782,171193,0,40,0.6544827270767064,9515151489,-1653,-1653,49249006.366656005,5844.950000623241,-1289,0,1,0.18416533204952912,-9452646554,2285.8470829362627,2062.8156324919046,223.03145044435814,0.7196120370174287,0.720030451130982,-1289
1818,2021-12-24,2021,213188,213188,539255907.766667,3525881.0999999996,153428,0,36,0.832438974051072,54633320,11131071169,214435,214435,70610,285045,490087131.01667374,3522757.1833330765,154465,0,34,0.6294620147696038,9525186851,-1247,-1247,49168776.749993265,3123.916666923091,-1037,0,2,0.2029769592814682,-9470553531,2529.485279502913,2285.4810596062853,244.00421989662755,0.7196840347486725,0.7203348333993984,-1037
1819,2021-12-25,2021,190698,190698,537763324.5833337,3294846.1333333272,137117,0,38,0.8317863847549526,52777084,11127598879,191579,191579,66773,258352,488616173.35000396,3291384.8166666715,137721,0,40,0.6179476063665126,9533377409,-881,-881,49147151.23332977,3461.316666655708,-604,0,-2,0.21383877838844,-9480600325,2819.9735948113444,2550.4683360389395,269.5052587724049,0.7190269431247313,0.7188731541557268,-604
1820,2021-12-26,2021,199561,199561,538219416.2500001,3393251.6500000022,145550,0,35,0.8445187185872995,55760568,11140298913,200743,200743,49166,249909,489197306.2666804,3390294.9999995665,146447,0,35,0.6811479378493762,9540547736,-1182,-1182,49022109.9833197,2956.650000435766,-897,0,0,0.16337078073792333,-9484787168,2697.017033638838,2436.9333240346136,260.08370960422417,0.7293509252809918,0.7295248153111192,-897
1821,2021-12-27,2021,221846,221846,540107091.8666667,3714525.8833333342,162748,0,37,0.8512121020888374,61301407,11177350984,223786,223786,44108,267894,491036818.10001504,3710003.299999486,164314,0,37,0.7154844826685138,9562516598,-1940,-1940,49070273.76665163,4522.583333848044,-1566,0,0,0.13572761942032352,-9501215191,2434.6036974597996,2194.22492068322,240.3787767765798,0.7336079983411916,0.734246110123064,-1566
1822,2021-12-28,2021,236925,236925,541617873.3833332,3892718.0833333354,171017,0,40,0.8437986704653376,61457675,11199710156,238746,238746,51746,290492,492591671.98335034,3887405.266666023,172605,0,40,0.6978333310383631,9593745583,-1821,-1821,49026201.39998287,5312.8166673122905,-1588,0,0,0.14596533942697454,-9532287908,2286.0309101333046,2063.245759021514,222.78515111179058,0.7218191410784003,0.722964992083637,-1588
1823,2021-12-29,2021,232248,232248,542944665.9499998,3824217.1166666574,167394,0,48,0.8431202852123584,61077422,11220918029,233996,233996,60296,294292,494039900.09999955,3818336.2833334752,168855,0,48,0.6746258817772891,9617451847,-1748,-1748,48904765.85000026,5880.833333182149,-1461,0,0,0.16849440343506927,-9556374425,2337.779726628431,2111.317715260088,226.46201136834316,0.7207553994006407,0.7216148993999898,-1461
1824,2021-12-30,2021,227029,227029,543866123.9166669,3746173.0833333335,164891,0,42,0.8518735491941558,61311715,11243791691,228837,228837,64784,293621,495038305.18333703,3740763.466666987,166369,0,44,0.6679529052758459,9645334534,-1808,-1808,48827818.73332983,5409.616666346323,-1478,0,-2,0.18392064391830987,-9584022819,2395.579965188002,2163.279125243457,232.3008399445448,0.7262992833514661,0.727019669022055,-1478
1825,2021-12-31,2021,228004,228004,544684231.2666669,3792639.466666665,165003,0,35,0.8522087331801191,61821170,11264895437,229723,229723,61449,291172,495998226.64999586,3787266.200000319,166516,0,36,0.6778708117538732,9670172468,-1719,-1719,48686004.616671026,5373.266666345764,-1513,0,-1,0.17433792142624593,-9608351298,2388.924015660545,2159.114353591046,229.80966206949915,0.7236846721987333,0.7248555869460176,-1513
1826,2022-01-01,2022,225584,225584,545720696.3666672,3817554.816666664,164795,0,38,0.8621001489467335,61119269,11288208435,227320,227320,58032,285352,497127631.78333914,3811862.9833335886,166357,0,30,0.6919734222994737,9694756477,-1736,-1736,48593064.58332801,5691.833333075512,-1562,0,8,0.1701267266472598,-9633637208,2419.14628859612,2186.906703252416,232.23958534370422,0.730526101141925,0.7318185817349991,-1562
1827,2022-01-02,2022,224366,224366,543755545.9166662,3763827.066666671,161237,0,51,0.8495003699312733,59392151,11289282361,226145,226145,59514,285659,495377210.3666674,3758498.166666912,163073,0,35,0.67893537399487,9720808700,-1779,-1779,48378335.54999876,5328.89999975916,-1836,0,16,0.17056499593640329,-9661416549,2423.5202567085303,2190.529131162163,232.99112554636713,0.7186338393517735,0.7210992947003029,-1836
1828,2022-01-03,2022,232728,232728,542625262.7000004,3819406.1833333327,166797,0,49,0.8406551854525461,59026831,11284754636,234420,234420,57074,291494,494385303.8166603,3813507.0000002366,168248,0,35,0.6804050855249141,9729547961,-1692,-1692,48239958.88334012,5899.183333096094,-1451,0,14,0.16025009992763206,-9670521130,2331.585639458941,2108.9723735886882,222.6132658702527,0.7167036196761886,0.7177203310297756,-1451
1829,2022-01-04,2022,233515,233515,543947754.7166662,3831788.583333332,168487,0,83,0.8454745947797784,59704289,11307650735,235401,235401,59978,295379,495796413.4499976,3825598.8833334683,170098,0,83,0.6794084887551215,9721994767,-1886,-1886,48151341.26666862,6189.6999998637475,-1611,0,0,0.16606610602465688,-9662290478,2329.3910657416704,2106.178025794273,223.21303994739765,0.7215253838083207,0.7225882642809504,-1611
1830,2022-01-05,2022,230956,230956,544746108.1333333,3755086.1666666637,165837,0,60,0.8417101092848845,60073026,11331868930,232730,232730,63226,295956,496661360.70000553,3749617.6166668325,167314,0,60,0.6669842814472512,9751372122,-1774,-1774,48084747.433327794,5468.549999831244,-1477,0,0,0.17472582783763335,-9691299096,2358.6575284181113,2134.066775662809,224.59075275530222,0.718045861549386,0.7189189189189189,-1477
1831,2022-01-06,2022,224568,224568,544888047.9666666,3734940.116666665,162735,0,56,0.8489811549285732,59954223,11346125389,226244,226244,66119,292363,496894674.03335005,3729255.349999261,164107,0,35,0.6617834678122837,9776856475,-1676,-1676,47993373.93331653,5684.766667403746,-1372,0,21,0.18719768711628948,-9716902252,2426.3833135917253,2196.2777975696595,230.10551602206579,0.7246580100459549,0.7253540425381446,-1372
1832,2022-01-07,2022,228026,228026,545918463.7833333,3774511.4666666714,165422,0,40,0.8553366721338792,59815917,11371484451,229751,229751,61217,290968,498008968.7333275,3769330.0833335523,166925,0,41,0.6803462923758035,9799342551,-1725,-1725,47909495.05000579,5181.383333119098,-1503,0,-1,0.17499037975807574,-9739526634,2394.106215007645,2167.603051709579,226.50316329806583,0.7254523606957102,0.7265474361373835,-1503
1833,2022-01-08,2022,229198,229198,546893643.5000002,3797701.2833333346,166237,0,91,0.8604918018481839,59309082,11387049615,230985,230985,60730,291715,499093864.5000019,3792080.616666873,167749,0,91,0.6856589479457665,9824887836,-1787,-1787,47799778.99999833,5620.6666664616205,-1512,0,0,0.17483285390241732,-9765578754,2386.1187423101433,2160.7198064809486,225.39893582919467,0.7252986500754806,0.7262333051929779,-1512
1834,2022-01-09,2022,224414,224414,547827476.1500002,3779987.366666661,164009,0,63,0.8640949316887545,58891853,11409636730,226116,226116,59685,285801,500145957.98333967,3773635.8333334527,165524,0,65,0.6894867407741719,9849166033,-1702,-1702,47681518.16666055,6351.533333208412,-1515,0,-2,0.17460819091458257,-9790274180,2441.1466136248196,2211.899900862122,229.24671276269737,0.7308323010150882,0.73203134674238,-1515
1835,2022-01-10,2022,223699,223699,548712993.9833332,3693064.7166666705,162788,0,56,0.8534995686167569,59028420,11433912517,225154,225154,60038,285192,501230132.23333466,3687827.250000138,164073,0,56,0.6780274341496358,9875704865,-1455,-1455,47482861.74999857,5237.46666653268,-1285,0,0,0.17547213446712107,-9816676445,2452.9076749709798,2226.1657897853675,226.74188518561232,0.7277100031739078,0.7287145686952041,-1285
1836,2022-01-11,2022,211481,211481,548559497.3833332,3602222.733333338,155042,0,37,0.8549420515318155,59656216,11452584574,213756,213756,63721,277477,501252315.1833553,3597114.7333327048,156420,0,37,0.6605556496574357,9904798534,-2275,-2275,47307182.199977934,5108.000000633299,-1378,0,0,0.19438640187437972,-9845142318,2593.894947457848,2344.9742471947234,248.92070026312467,0.7331249615804729,0.7317689328018863,-1378
1837,2022-01-12,2022,221558,221558,549261762.366667,3676531.133333328,162013,0,46,0.858398252376353,59458341,11472450498,224472,224472,58069,282541,502078825.1666681,3671688.250000137,163627,0,46,0.6835326554376279,9928651742,-2914,-2914,47182937.199998915,4842.883333191276,-1614,0,0,0.17486559693872517,-9869193401,2479.087924456201,2236.710258592021,242.37766586418002,0.731244188880564,0.728941694287038,-1614
1838,2022-01-13,2022,226077,226077,550179148.1333325,3712750.7,163893,0,48,0.8498874277347985,61128091,11486354752,227608,227608,59112,286720,502987841.56666464,3707624.43333267,165215,0,48,0.6787423270089342,9952185574,-1531,-1531,47191306.566667855,5126.266667330172,-1322,0,0,0.1711451007258643,-9891057483,2433.5918653084236,2209.886478360447,223.70538694797642,0.7249432715402274,0.7258751889213033,-1322
1839,2022-01-14,2022,235543,235543,551097959.75,3816725.0999999978,170978,0,54,0.856111198379914,60961540,11509502153,237255,237255,60707,297962,504029611.2499984,3810996.100000033,172467,0,45,0.6867486458004813,9973959054,-1712,-1712,47068348.50000161,5728.99999996461,-1489,0,9,0.16936255257943267,-9912997514,2339.6915202319747,2124.4214505489804,215.2700696829943,0.7258886912368442,0.7269267244104445,-1489
1840,2022-01-15,2022,231035,231035,551510026.2166663,3764669.9500000025,167656,0,95,0.8569437531110008,60944806,11520476033,232558,232558,63823,296381,504495754.7333353,3759038.216666948,168983,0,95,0.6767809002601433,9993560133,-1523,-1523,47014271.483331025,5631.733333054464,-1327,0,0,0.18016285285085754,-9932615327,2387.127604980485,2169.33304695317,217.7945580273149,0.7256735992382106,0.7266273359764016,-1327
1841,2022-01-16,2022,221146,221146,551969320.8000007,3667858.6499999953,161184,0,54,0.8573024155987449,59500975,11535791368,222600,222600,69384,291984,505023649.5000218,3661825.849999381,162489,0,55,0.6581079785193821,10011195093,-1454,-1454,46945671.29997885,6032.800000614021,-1305,0,-1,0.1991944370793628,-9951694118,2495.9498286200096,2268.749548517618,227.2002801023914,0.7288578586092446,0.7299595687331536,-1305
1842,2022-01-17,2022,219358,219358,552741941.283333,3682240.583333335,160874,0,121,0.857748520683084,59198131,11561584845,220859,220859,63219,284078,505871487.43333334,3677229.183333489,162108,0,121,0.6705552700314736,10030029209,-1501,-1501,46870453.84999961,5011.399999845773,-1234,0,0,0.1871932506516104,-9970831078,2519.816652610495,2290.4725975999772,229.34405501051788,0.7333856070897802,0.733988653394247,-1234
1843,2022-01-18,2022,220549,220549,553685614.5500002,3600548.3000000007,160507,0,67,0.8522641227119606,58722859,11582808587,222126,222126,54968,277094,506865110.3499989,3596253.783333005,161815,0,67,0.6873660201953239,10056791391,-1577,-1577,46820504.2000013,4294.516666995827,-1308,0,0,0.16489810251663672,-9998068532,2510.487984756223,2281.8810510701082,228.60693368611464,0.727761177788156,0.7284829331100366,-1308
1844,2022-01-19,2022,216812,216812,554013360.7499999,3458479.333333332,156867,0,191,0.8480942014279654,56471192,11598402018,218147,218147,62437,280584,507246679.81666845,3452872.6000001444,157867,0,191,0.6628104239728473,10075829236,-1335,-1335,46766680.93333143,5606.733333187643,-1000,0,0,0.18528377745511815,-10019358044,2555.270744931092,2325.251687241486,230.01905768960614,0.7235162260391491,0.7236725694142023,-1000
1845,2022-01-20,2022,222108,222108,555258543.9499998,3702708.666666672,163008,0,121,0.856533758351792,58670046,11620651363,223625,223625,54602,278227,508572198.91666913,3697530.966666812,164319,0,122,0.6930204473325638,10096596515,-1517,-1517,46686345.03333068,5177.699999860022,-1311,0,-1,0.16351331101922817,-10037926469,2499.9484212635284,2274.218888392036,225.7295328714922,0.7339132314009401,0.7347970933482393,-1311
1846,2022-01-21,2022,219747,219747,555800252.6333342,3647108.9000000013,160102,0,35,0.8502186605505421,58623344,11637052168,221244,221244,58118,279362,509228607.4333398,3642238.8666667566,161486,0,37,0.6791224289631255,10123540428,-1497,-1497,46571645.199994385,4870.0333332447335,-1384,0,-2,0.1710962315874166,-10064917084,2529.2734491635115,2301.6606436031702,227.61280556034126,0.7285742239939567,0.7299000198875449,-1384
1847,2022-01-22,2022,221708,221708,556143052.6500001,3644879.9833333353,163043,0,43,0.85701463185812,59228841,11653190828,223159,223159,59878,283037,509652625.06666875,3640168.7833336345,164392,0,36,0.6808367810568995,10142422036,-1451,-1451,46490427.58333135,4711.199999700766,-1349,0,7,0.1761778508012205,-10083193195,2508.4482862594045,2283.8094142143887,224.6388720450159,0.7353952045032205,0.7366586156059133,-1349
1848,2022-01-23,2022,214368,214368,556253325.1333337,3561373.5999999973,158305,0,40,0.8607254814151359,58703310,11665630843,215763,215763,61473,277236,509838592.40000606,3556186.9500002177,159625,0,40,0.6753199440188198,10162113054,-1395,-1395,46414732.73332763,5186.649999779649,-1320,0,0,0.18540553739631616,-10103409744,2594.8524272901445,2362.9565421319044,231.89588515824016,0.738473092998955,0.7398163725940036,-1320
1849,2022-01-24,2022,212147,212147,556964592.0833328,3564634.383333333,157207,0,40,0.8614639848784085,58813815,11695655420,213552,213552,60803,274355,510580576.6166711,3558275.1666667173,158470,0,40,0.6754897851324061,10181850281,-1405,-1405,46384015.46666169,6359.216666615568,-1263,0,0,0.18597419974600238,-10123036466,2625.3710497123825,2390.8957847113165,234.47526500106596,0.7410286263769933,0.7420675058065482,-1263
1850,2022-01-25,2022,211532,211532,557237932.866667,3549250.600000002,155749,0,36,0.8552701246147147,59113235,11709104346,213046,213046,55021,268067,510993176.03333575,3543979.4333332907,157024,0,36,0.6838924597208986,10206449912,-1514,-1514,46244756.83333129,5271.166666711215,-1275,0,0,0.17137766489381612,-10147336677,2634.2961484156867,2398.511007169042,235.7851412466448,0.7362904903277045,0.7370427043924787,-1275
1851,2022-01-26,2022,207425,207425,557851742.4000001,3488118.8500000043,154476,0,43,0.8647993250572493,59941484,11734804570,208758,208758,54327,263085,511660174.86667246,3483697.1333333934,155568,0,43,0.6900165345800788,10229843483,-1333,-1333,46191567.53332764,4421.7166666109115,-1092,0,0,0.1747827904771705,-10169901999,2689.4142094733043,2450.972776452507,238.44143302079738,0.7447318307822104,0.7452073692984221,-1092
1852,2022-01-27,2022,196988,196988,558047226.1666665,3389052.4666666705,148700,0,41,0.8764036388003335,59664393,11760045247,198194,198194,55615,253809,511943063.65000623,3384618.4166664053,149731,0,41,0.6876509501239213,10254310808,-1206,-1206,46104162.51666027,4434.050000265241,-1031,0,0,0.18875268867641215,-10194646415,2832.899598791127,2583.040170994108,249.85942779701918,0.7548683168517879,0.7554769569209966,-1031
1853,2022-01-28,2022,188275,188275,557825304.416666,3303710.716666668,142767,0,47,0.8744814765635383,58882798,11778068295,189260,189260,52348,241608,511814840.2333329,3299552.2833329993,143648,0,47,0.6886609714909985,10283380201,-985,-985,46010464.18333316,4158.433333668858,-881,0,0,0.18582050507253978,-10224497403,2962.8219594564653,2704.2948337384173,258.52712571804796,0.7582897357588634,0.7589982035295361,-881
1854,2022-01-29,2022,181852,181852,557943098.2166674,3253207.616666666,139156,0,60,0.882910278688163,59692797,11798123508,182669,182669,47411,230080,511991189.65000194,3249006.183333057,139938,0,61,0.7035465924895657,10306295695,-817,-817,45951908.56666547,4201.433333609253,-782,0,-1,0.17936368619859722,-10246602898,3068.1163705467493,2802.835673540677,265.2806970060724,0.7652156698854014,0.7660741559870585,-782
1855,2022-01-30,2022,177784,177784,558106954.2000004,3190930.433333335,135893,0,69,0.8797923322683707,58943356,11816135239,178691,178691,43356,222047,512231082.5999998,3187587.716666594,136674,0,69,0.7107098947520116,10327064142,-907,-907,45875871.60000062,3342.716666740831,-781,0,0,0.1690824375163591,-10268120786,3139.2417439139654,2866.574604205023,272.66713970894216,0.7643713720019799,0.7648622482385794,-781
1856,2022-01-31,2022,178763,178763,558576793.1166666,3205437.4500000016,136948,0,102,0.881054804405834,59710941,11837735963,179927,179927,41077,221004,512812651.4333359,3201640.3499999624,137874,0,102,0.7209190783877244,10349608983,-1164,-1164,45764141.683330655,3797.1000000392087,-926,0,0,0.16013572601810955,-10289898042,3124.677887016142,2850.115054624019,274.5628323921228,0.7660869419286989,0.7662774347374213,-926
1857,2022-02-01,2022,178001,178001,558987148.1500003,3208821.449999995,136986,0,92,0.8863377172038356,59019358,11856647777,179003,179003,39436,218439,513343344.7999971,3204838.1666666223,137794,0,90,0.7288396302857945,10370421794,-1002,-1002,45643803.35000324,3983.2833333727904,-808,0,2,0.15749808691804112,-10311402436,3140.3595943281234,2867.7918515331985,272.5677427949249,0.7695799461800776,0.7697859812405379,-808
1858,2022-02-02,2022,182442,182442,560045751.0666659,3246679.583333331,139274,0,63,0.8793644007410579,59571255,11883315508,183596,183596,38137,221733,514441994.4833347,3242655.9666665867,140155,0,63,0.7303107791803711,10394321625,-1154,-1154,45603756.58333117,4023.616666744463,-881,0,0,0.1490536215606868,-10334750370,3069.7194235245497,2802.0326939766373,267.68672954791236,0.763387816401925,0.7633880912438179,-881
1859,2022-02-03,2022,184255,184255,561008663.6166672,3282449.899999998,140794,0,49,0.8777943610756825,60484655,11904550321,185323,185323,40191,225514,515435511.78333163,3278936.899999942,141661,0,49,0.7239151449577447,10424126884,-1068,-1068,45573151.83333552,3513.0000000558794,-867,0,0,0.15387921611793787,-10363642229,3044.7405151375383,2781.2819336149946,263.4585815225437,0.7641258039130553,0.7644005331232496,-867
1860,2022-02-04,2022,186599,186599,561775525.0166663,3267899.716666666,141812,0,49,0.8722822737528064,59862305,11924824898,187541,187541,40594,228135,516319269.3833314,3263526.4833333646,142652,0,49,0.7198457053937451,10447436112,-942,-942,45456255.633334875,4373.233333301265,-840,0,0,0.15243656835906128,-10387573807,3010.603084778945,2753.1007586785367,257.502326100408,0.7599826365628969,0.7606443391045158,-840
1861,2022-02-05,2022,182713,182713,562390226.0166668,3233224.466666664,138384,0,85,0.8712133236277665,58838518,11945578025,183896,183896,45109,229005,516980663.3833461,3228173.1666663922,139459,0,87,0.7027051811095704,10466896084,-1183,-1183,45409562.63332069,5051.30000027176,-1075,0,-2,0.16850814251819612,-10408057566,3077.9978765422643,2811.2664951023735,266.7313814398908,0.7573845320256358,0.7583579849480141,-1075
1862,2022-02-06,2022,186729,186729,562835424.6166664,3269260.0666666673,140493,0,102,0.8678566264479544,59139202,11962960051,187936,187936,43526,231462,517532703.10000247,3264048.350000047,141629,0,106,0.7082847292428038,10488683877,-1207,-1207,45302721.51666397,5211.716666620225,-1136,0,-4,0.15957189720515053,-10429544675,3014.1832528245022,2753.7709810786782,260.412271745824,0.7523898269684944,0.7536022901413247,-1136
1863,2022-02-07,2022,195119,195119,563928545.9499993,3360143.883333331,145825,0,218,0.8637805646810415,59675323,11989536219,196470,196470,42145,238615,518698598.91666996,3354559.1333333305,147020,0,218,0.7153238480397253,10516455960,-1351,-1351,45229947.03332937,5584.750000000466,-1195,0,0,0.1484567166413162,-10456780637,2890.1775119286144,2640.090593559678,250.0869183689365,0.747364428886987,0.7483076296635619,-1195
1864,2022-02-08,2022,200355,200355,564826112.1833326,3397664.783333325,148376,0,55,0.8549923885103943,59221599,12006002515,201446,201446,46374,247820,519762920.0333305,3393155.366666481,149353,0,50,0.6986925994673508,10539138857,-1091,-1091,45063192.15000206,4509.416666843928,-977,0,5,0.15629978904304342,-10479917258,2819.126611181815,2580.160043055362,238.96656812645278,0.7405654962441666,0.7414046444208373,-977
1865,2022-02-09,2022,212578,212578,565995706.3666675,3525729.9833333385,157087,0,73,0.8572523967673045,59876935,12030673827,214173,214173,48453,262626,520954959.81666785,3520354.5500000212,158307,0,39,0.7026075102998126,10561543979,-1595,-1595,45040746.549999654,5375.4333333172835,-1220,0,34,0.15464488646749186,-10501667044,2662.531900604331,2432.402589573232,230.12931103109895,0.7389616987646888,0.7391547954223922,-1220
1866,2022-02-10,2022,221219,221219,567466230.7166666,3654584.1666666577,163387,0,39,0.8554102495716908,61215622,12056184557,222927,222927,50985,273912,522513589.4999947,3649516.8833335224,164685,0,41,0.6993377435088765,10590683408,-1708,-1708,44952641.216671884,5067.283333135303,-1298,0,-2,0.1560725060628143,-10529467786,2565.178536729063,2343.877545115642,221.30099161342105,0.7385758004511367,0.7387395873985655,-1298
1867,2022-02-11,2022,222109,222109,568505189.8333334,3693379.599999995,164070,0,42,0.8583623356099925,61410428,12074255163,223920,223920,57505,281425,523658162.54999936,3689097.350000064,165532,0,42,0.6861046459980483,10616497832,-1811,-1811,44847027.28333402,4282.249999931082,-1462,0,0,0.1722576896119442,-10555087404,2559.577458965343,2338.594866693459,220.98259227188373,0.7386913632495756,0.7392461593426224,-1462
1868,2022-02-12,2022,218665,218665,569432507.0499994,3648821.6333333305,161151,0,68,0.8570964717718886,61691103,12097004424,220537,220537,58463,279000,524679736.7666803,3643097.949999318,162692,0,69,0.6819354838709766,10642187378,-1872,-1872,44752770.283319056,5723.683334012516,-1541,0,-1,0.17516098790091206,-10580496275,2604.1319234902676,2379.1007258041973,225.0311976860703,0.736976653785471,0.7377084117404336,-1541
1869,2022-02-13,2022,206916,206916,570236676.2666674,3526408.116666663,151801,0,58,0.8571014324653465,60427250,12123912213,208432,208432,59858,268290,525558652.01666474,3521176.750000309,153183,0,53,0.6711767117671138,10664355082,-1516,-1516,44678024.25000262,5231.366666353773,-1382,0,5,0.18592472069823274,-10603927832,2755.884882109974,2521.4873532694824,234.39752884049176,0.7336358715614065,0.7349303369924004,-1382
1870,2022-02-14,2022,211722,211722,571353337.6333331,3550609.1833333317,155893,0,56,0.8563871491861959,61068241,12152567870,213255,213255,55308,268563,526717723.80000633,3545277.683333327,157218,0,56,0.6848076615170227,10699274421,-1533,-1533,44635613.83332676,5331.500000004657,-1325,0,0,0.1715794876691732,-10638206180,2698.601645711514,2469.8962453401155,228.70540037139835,0.7363098780476285,0.7372300766687768,-1325
1871,2022-02-15,2022,214077,214077,572107761.2166665,3580935.3500000034,159195,0,50,0.8663237993805962,61266545,12172545716,215748,215748,51941,267689,527560973.21666867,3575528.7500001197,160576,0,50,0.7019899958533939,10724536267,-1671,-1671,44546787.999997795,5406.599999883678,-1381,0,0,0.16433380352720228,-10663269722,2672.4391747673335,2445.2647218823286,227.17445288500494,0.743634299808013,0.7442757290913473,-1381
1872,2022-02-16,2022,212687,212687,573150911.916666,3590525.1333333324,159040,0,71,0.8679044793522872,61475397,12198855687,214142,214142,54621,268763,528658983.70000565,3585319.6500000744,160288,0,71,0.6948649925771113,10751427596,-1455,-1455,44491928.21666038,5205.483333257958,-1248,0,0,0.1730394867751759,-10689952199,2694.8093297506007,2468.7309528257215,226.0783769248792,0.7477654957754822,0.7485126691634523,-1248
1873,2022-02-17,2022,214828,214828,574051334.533333,3613148.5333333383,159009,0,48,0.8609166402889752,60093837,12218801021,216101,216101,55467,271568,529596448.30000126,3607152.9000000907,160109,0,48,0.6889766099098674,10778362923,-1273,-1273,44454886.23333168,5995.633333247621,-1100,0,0,0.17194003037910777,-10718269086,2672.1439222695967,2450.6894845465836,221.45443772301314,0.740168879289478,0.7408989315181327,-1100
1874,2022-02-18,2022,213816,213816,574844593.6666667,3595218.349999998,158791,0,76,0.8613433980618842,61666731,12240260332,215070,215070,55636,270706,530403758.5499993,3590417.066666727,159903,0,76,0.6872843601545472,10801570712,-1254,-1254,44440835.11666745,4801.283333271276,-1112,0,0,0.174059037907337,-10739903981,2688.501298624363,2466.1912798158705,222.31001880849226,0.7426525610805552,0.74349281629237,-1112
1875,2022-02-19,2022,207264,207264,575243482.7833343,3524077.983333337,155470,0,66,0.8685975374401728,61906138,12254170606,208448,208448,58967,267415,530857734.2666683,3519344.6333330106,156514,0,66,0.6800329076529198,10825955124,-1184,-1184,44385748.516665936,4733.350000326522,-1044,0,0,0.18856462978725297,-10764048986,2775.414364208614,2546.7154123170685,228.69895189154568,0.7501061448201328,0.7508539299969297,-1044
1876,2022-02-20,2022,201177,201177,575987711.6000001,3494165.0833333335,151022,0,32,0.8675792958439579,60506166,12278578511,202244,202244,55902,258146,531679297.8666633,3489171.6499997163,152039,0,32,0.6828151511160445,10840432751,-1067,-1067,44308413.733336866,4993.433333617169,-1017,0,0,0.18476414472791336,-10779926585,2863.089277601317,2628.9002287665558,234.18904883476125,0.7506921765410559,0.7517602499950555,-1017
1877,2022-02-21,2022,210577,210577,576978572.9666657,3567415.1,156957,0,31,0.8618652559396319,60402008,12298182073,211919,211919,49633,261552,532768635.2333351,3563147.0666668154,158153,0,31,0.7022504129197924,10865693226,-1342,-1342,44209937.73333067,4268.033333184663,-1196,0,0,0.15961484301983953,-10805291218,2739.9885693435926,2514.020145590226,225.96842375336655,0.7453663030625377,0.7462898560298982,-1196
1878,2022-02-22,2022,210936,210936,577791173.6833328,3580105.0333333355,157432,0,35,0.8624985777676641,61284409,12318210418,212492,212492,50918,263410,533783331.9333285,3575402.383333441,158741,0,35,0.6999772218215163,10889151231,-1556,-1556,44007841.75000429,4702.649999894667,-1309,0,0,0.1625213559461478,-10827866822,2739.177635317503,2512.0161320582824,227.16150325922035,0.7463496036712557,0.7470445946200328,-1309
1879,2022-02-23,2022,213690,213690,578548601.8166667,3600992.533333331,160232,0,43,0.8690439421592022,63065826,12337668952,215105,215105,52696,267801,534643918.8333369,3596092.0333328424,161436,0,43,0.7021108957770915,10907905018,-1415,-1415,43904682.98332983,4900.500000488479,-1204,0,0,0.1669330463821107,-10844839192,2707.4201030308705,2485.502051711196,221.9180513196743,0.7498338714960925,0.7504985937100486,-1204
1880,2022-02-24,2022,221935,221935,579423530.2500005,3677999.4999999977,162426,0,43,0.8473381846036009,63099775,12360817409,223440,223440,54656,278096,535564984.4166685,3672453.566666054,163708,0,43,0.6840803175881713,10934321955,-1505,-1505,43858545.833332,5545.933333943598,-1282,0,0,0.16325786701542955,-10871222180,2610.780319688199,2396.9073774466005,213.8729422415986,0.7318629328406966,0.7326709631220909,-1282
1881,2022-02-25,2022,233524,233524,580211648.0499996,3766668.0166666615,172954,0,36,0.8564944074270742,63168931,12381831349,234954,234954,55768,290722,536400529.6166653,3761923.1666671014,174165,0,35,0.6957299413184943,10960832905,-1430,-1430,43811118.43333429,4744.849999560043,-1211,0,1,0.16076446610857986,-10897663974,2484.591082929376,2283.002330739912,201.58875218946423,0.7406262311368425,0.7412727597742537,-1211
1882,2022-02-26,2022,232787,232787,581007816.2666669,3812102.933333331,172671,0,38,0.8634245039456665,62912632,12398252770,234092,234092,63505,297597,537275195.9166706,3807114.9499994344,173920,0,38,0.6828193832598994,10982502401,-1305,-1305,43732620.34999633,4987.98333389638,-1249,0,0,0.18060512068576706,-10919589769,2495.877416980617,2295.1454809078077,200.73193607280928,0.7417553385713119,0.7429557609828614,-1249
1883,2022-02-27,2022,232875,232875,581958475.3666666,3831759.883333333,172288,0,49,0.8619130434782608,63195463,12418528109,234297,234297,63070,297367,538269798.1666632,3826402.8666670336,173526,0,33,0.6824429072492774,11003059826,-1422,-1422,43688677.200003386,5357.016666299198,-1238,0,16,0.17947013622898345,-10939864363,2499.0165340490244,2297.382374365285,201.6341596837392,0.7398303811057434,0.7406240796937221,-1238
1884,2022-02-28,2022,244084,244084,583353028.933333,3919507.5833333326,180131,0,75,0.8669597351731372,63587535,12447008635,245452,245452,62295,307747,539744001.966669,3913970.4666669415,181360,0,75,0.6947362606296874,11029100833,-1368,-1368,43609026.966664076,5537.116666391026,-1229,0,0,0.17222347454344977,-10965513298,2389.9683262046387,2198.9798492848663,190.98847691977244,0.7379877419249111,0.738881736551342,-1229
1885,2022-03-01,2022,239384,239384,583850391.7000008,3866906.633333337,177469,0,42,0.8601953346923773,63618043,12454558437,240872,240872,68017,308889,540337239.7000006,3861409.56666693,178727,0,42,0.6736076713641441,11049065746,-1488,-1488,43513152.00000012,5497.066666407045,-1258,0,0,0.18658766332823318,-10985447703,2438.969988386863,2243.254673436517,195.71531495034606,0.7413569829228353,0.741999900362018,-1258
1886,2022-03-02,2022,249928,249928,584338873.1166668,3941735.4333333313,186647,0,48,0.8677939246503007,64448697,12465558250,251407,251407,66829,318236,540932328.5833335,3936426.133333567,188050,0,40,0.6894883042773329,11073317691,-1479,-1479,43406544.5333333,5309.299999764189,-1403,0,8,0.17830562037296782,-11008868994,2338.028844773962,2151.6199969902727,186.40884778368945,0.7468030792868346,0.7479903105323241,-1403
1887,2022-03-03,2022,247866,247866,585203779.2166667,3983665.183333331,183112,0,48,0.859629799972566,64384598,12482774137,249587,249587,74271,323858,541962385.600003,3978054.6500003194,184596,0,36,0.6662333491839131,11085725479,-1721,-1721,43241393.616663694,5610.533333011437,-1484,0,12,0.19339645078865297,-11021340881,2360.968342639437,2171.436755920793,189.53158671864412,0.7387540041796777,0.7396058288292259,-1484
1888,2022-03-04,2022,238612,238612,585689722.9333344,3898912.3166666655,178236,0,55,0.8705723098586821,63440414,12494731368,242373,242373,69609,311982,542538978.0333245,3894014.533333371,180512,0,59,0.6767057073805511,11103617347,-3761,-3761,43150744.90000987,4897.783333294559,-2276,0,-4,0.19386660247813092,-11040176933,2454.569438810011,2238.4464360028737,216.12300280713725,0.7469699763633011,0.744769425637344,-2276
1889,2022-03-05,2022,229891,229891,585716672.3833327,3814685.0166666666,172235,0,52,0.862965492342023,62145425,12506164491,236324,236324,70401,306725,542576059.6166571,3815031.0666669067,175208,0,52,0.6607025837476577,11111861399,-6433,-6433,43140612.76667559,-346.05000024009496,-2973,0,0,0.20226290859436535,-11049715974,2547.801664194478,2295.899102996975,251.90256119750256,0.7492028831054717,0.7413889406069634,-2973
1890,2022-03-06,2022,226316,226316,585730931.5166662,3777766.583333332,170332,0,98,0.8703715159334734,63644745,12516482255,227896,227896,68414,296310,540998831.7166646,3772645.2166667455,171743,0,98,0.6735749721575428,11059830578,-1580,-1580,44732099.80000162,5121.366666586604,-1411,0,0,0.1967965437759306,-10996185833,2588.1110107843288,2373.8847181024,214.22629268192895,0.7526290673217978,0.7536025204479236,-1411
1891,2022-03-07,2022,238577,238577,586943622.8833328,3885511.633333338,183354,0,74,0.8867242022491699,64999455,12546580485,240311,240311,60785,301096,542234105.3666661,3880113.2166670267,184872,0,75,0.7114043361585763,11073983148,-1734,-1734,44709517.51666677,5398.416666311212,-1518,0,-1,0.17531986609059358,-11008983693,2460.185277220071,2256.384873629031,203.80040359103987,0.7685317528512807,0.7693031113848305,-1518
1892,2022-03-08,2022,239277,239277,588197828.1833334,3948544.4666666663,179495,0,64,0.8656703318747713,64839860,12572770068,241116,241116,63415,304531,543588766.7500037,3943283.9666669215,181091,0,64,0.6896801967615733,11101002821,-1839,-1839,44609061.4333297,5260.499999744818,-1596,0,0,0.17599013511319794,-11036162961,2458.229701071701,2254.4699097115235,203.7597913601776,0.7501556773112334,0.7510534348612287,-1596
1893,2022-03-09,2022,244216,244216,589432709.3333341,3987334.916666669,181859,0,44,0.860484161561896,65935564,12603104216,245990,245990,62300,308290,544820318.1333321,3980965.483333718,183398,0,33,0.6909954912582369,11132612935,-1774,-1774,44612391.200001955,6369.433332950808,-1539,0,11,0.1694886703036591,-11066677371,2413.5712211048176,2214.8067731750566,198.764447929761,0.7446645592426376,0.7455506321395179,-1539
1894,2022-03-10,2022,241205,241205,590195588.966666,3957002.1166666667,179473,0,47,0.8617648887875453,64623199,12617236412,242996,242996,67704,310700,545635305.6499957,3951507.8833334954,181161,0,36,0.6788027035725777,11160020815,-1791,-1791,44560283.3166703,5494.233333171345,-1688,0,11,0.18296218521496765,-11095397616,2446.8629960683484,2245.449742588338,201.41325348001055,0.7440683236251322,0.7455307906302985,-1688
1895,2022-03-11,2022,243926,243926,591128411.7666668,4002583.3666666644,183026,0,52,0.8778195026360456,65360241,12638221545,245344,245344,65186,310530,546661475.9833345,3996996.2000003005,184467,0,34,0.6993720413486757,11179618087,-1418,-1418,44466935.78333223,5587.166666363832,-1441,0,18,0.17844746128736988,-11114257846,2423.392388538601,2228.142836113109,195.2495524254923,0.7503341177242279,0.751870842572062,-1441
1896,2022-03-12,2022,236584,236584,591438299.4333336,3937343.8166666683,177625,0,51,0.8742264903797379,64248008,12653501058,238747,238747,67102,305849,547075906.083334,3932865.86666675,179366,0,38,0.6876432487927051,11206352278,-2163,-2163,44362393.349999666,4477.94999991823,-1741,0,13,0.18658324158703277,-11142104270,2499.908275425784,2291.4462007201514,208.4620747056324,0.7507904169343658,0.7512806443641177,-1741
1897,2022-03-13,2022,235802,235802,592387744.4833335,3892745.6166666695,177079,0,39,0.8731054019898047,64788521,12680370780,237071,237071,65868,302939,547998421.9499973,3886771.516666926,178359,0,36,0.6883795087459749,11226385712,-1269,-1269,44389322.53333616,5974.099999743514,-1280,0,3,0.18472589324382982,-11161597191,2512.2252757963606,2311.5371426703277,200.68813312603288,0.7509647924953987,0.752344234427661,-1280
1898,2022-03-14,2022,241678,241678,593604815.4666663,3933157.766666662,180622,0,62,0.8687509827125354,65320022,12711657211,243504,243504,65326,308830,549246336.9000078,3927943.2166668437,182301,0,62,0.691050092283786,11257244753,-1826,-1826,44358478.5666585,5214.549999818206,-1679,0,0,0.17770089042874937,-11191924731,2456.1806017372965,2255.5947208259736,200.58588091132287,0.7473663304065741,0.748657106248768,-1679
1899,2022-03-15,2022,240232,240232,594405466.6666667,3943146.749999997,179731,0,39,0.8666289253721409,66220066,12728143843,242050,242050,65603,307653,550179389.7499999,3937492.000000345,181306,0,32,0.6861691581099489,11280982563,-1818,-1818,44226076.916666865,5654.749999652151,-1575,0,7,0.18045976726219193,-11214762497,2474.297623408483,2272.998924808923,201.29869859955988,0.7481559492490593,0.749043586035943,-1575
1900,2022-03-16,2022,235283,235283,594694153.8833342,3821769.950000008,174232,0,35,0.8616007106335787,64801759,12743538651,236938,236938,68571,305509,550573808.30001,3816818.866666781,175650,0,31,0.6725333787220604,11302993357,-1655,-1655,44120345.583324194,4951.083333227318,-1418,0,4,0.18906733191151825,-11238191598,2527.569581666904,2323.704126395977,203.8654552709272,0.7405209896167594,0.7413331757675004,-1418
1901,2022-03-17,2022,222412,222412,594462471.8666664,3682338.699999995,164657,0,31,0.8594230527129824,62829533,12761427754,224058,224058,70864,294922,550363805.7999986,3677458.933332996,166032,0,31,0.6568177348587232,11322931277,-1646,-1646,44098666.066667795,4879.766666999087,-1375,0,0,0.20260531785425917,-11260101744,2672.798553435365,2456.345257924281,216.45329551108398,0.7403242630793303,0.7410224138392738,-1375
1902,2022-03-18,2022,226098,226098,594659997.2166667,3713315.6666666726,167748,0,31,0.8604764305743526,63447585,12776575002,227421,227421,64706,292127,550553302.1000026,3708147.5666668955,168902,0,31,0.6740527236441649,11345863985,-1323,-1323,44106695.11666405,5168.099999777041,-1154,0,0,0.18642370693018773,-11282416400,2630.098440572967,2420.855163331454,209.24327724151271,0.7419260674574742,0.742684272780438,-1154
1903,2022-03-19,2022,223446,223446,594705487.8833338,3738099.3833333333,168177,0,34,0.869592653258506,64075061,12788553830,225004,225004,64209,289213,550692874.2333468,3732543.566666388,169634,0,34,0.6824520336222692,11363818177,-1558,-1558,44012613.64998698,5555.816666945349,-1457,0,0,0.18714061963623674,-11299743116,2661.5177174052515,2447.480374719324,214.03734268592734,0.7526516473778899,0.7539154859469165,-1457
1904,2022-03-20,2022,223836,223836,595581107.4999987,3768482.0333333327,169589,0,33,0.8733000947121989,64512283,12813871778,225465,225465,60123,285588,551584762.1166844,3762568.6833330924,171036,0,31,0.6949416642155708,11376314524,-1629,-1629,43996345.38331425,5913.350000240374,-1447,0,2,0.17835843049662814,-11311802241,2660.7923099948116,2446.4318724266936,214.36043756811796,0.757648456905949,0.7585922426984233,-1447
1905,2022-03-21,2022,228699,228699,596314118.1333337,3784814.916666663,171254,0,40,0.8618140000612159,65482929,12837579589,230275,230275,60824,291099,552391191.466682,3779682.883333022,172706,0,40,0.6867697930944244,11406045665,-1576,-1576,43922926.666651726,5132.033333641011,-1452,0,0,0.17504420696679146,-11340562736,2607.4190011033443,2398.8326629754943,208.58633812785,0.7488183157775067,0.7499989143415482,-1452
1906,2022-03-22,2022,227833,227833,596823359.4000008,3794802.8499999987,170712,0,32,0.8604504176304576,63634111,12855864353,229182,229182,63384,292566,552978405.2833374,3789932.550000244,171986,0,32,0.6787938448076585,11422728537,-1349,-1349,43844954.116663456,4870.299999754876,-1274,0,0,0.18165657282279912,-11359094426,2619.565029648913,2412.835236987797,206.72979266111588,0.7492856609885311,0.7504341527694147,-1274
1907,2022-03-23,2022,231397,231397,597685923.616667,3846071.0333333253,174816,0,42,0.8703829349559414,65917669,12873827844,232757,232757,61083,293840,553886289.750009,3841191.2666663574,176104,0,42,0.6944970051728901,11448457180,-1360,-1360,43799633.86665809,4879.766666967887,-1288,0,0,0.1758859297830513,-11382539511,2582.9458619457773,2379.676184819399,203.26967712637816,0.7554808402874713,0.7566002311423502,-1288
1908,2022-03-24,2022,233401,233401,598673297.4333324,3836674.3000000017,175875,0,49,0.8716372252046909,65877388,12896910087,235289,235289,61051,296340,554999087.2000008,3831523.266666302,177476,0,39,0.696736856313684,11469862064,-1888,-1888,43674210.23333168,5151.033333699685,-1601,0,10,0.1749003688910069,-11403984676,2564.9988536181613,2358.7974244439847,206.2014291741766,0.7535314758719971,0.754289405794576,-1601
1909,2022-03-25,2022,228678,228678,599054976.2666668,3750634.8666666676,170865,0,59,0.8662617304681696,64635932,12914048795,230134,230134,68015,298149,555459348.6333454,3745503.5499997437,172153,0,60,0.6736195660558911,11492634865,-1456,-1456,43595627.633321404,5131.316666923929,-1288,0,-1,0.19264216441227844,-11427998933,2619.644112099401,2413.6344418180074,206.00967028139348,0.7471859995277202,0.7480554807199284,-1288
1910,2022-03-26,2022,228092,228092,599589598.3666677,3769407.733333334,171962,0,42,0.8758001157427706,64913073,12931374479,229542,229542,67974,297516,556036650.4833423,3764574.08333306,173292,0,35,0.681499482380773,11513808338,-1450,-1450,43552947.88332546,4833.650000273716,-1330,0,7,0.19430063336199765,-11448895265,2628.7182293402125,2422.3743388283724,206.34389051184007,0.7539150868947617,0.7549468071202655,-1330
1911,2022-03-27,2022,228703,228703,600507642.4833337,3817349.449999999,173888,0,47,0.8813570438516328,65560770,12957340753,230244,230244,63522,293766,556972594.3166562,3813040.916666802,175232,0,47,0.6950838422417752,11534136879,-1541,-1541,43535048.166677475,4308.53333319677,-1344,0,0,0.1862732016098576,-11468576109,2625.70951182684,2419.0536748695135,206.6558369573263,0.7603223394533521,0.7610708639530237,-1344
1912,2022-03-28,2022,236937,236937,601940964.0666673,3904575.283333338,176133,0,57,0.8629129262208945,64196413,12987195257,238191,238191,61850,300041,558430945.6999961,3899199.566666884,177339,0,57,0.6892924633633359,11563258320,-1254,-1254,43510018.366671205,5375.716666453984,-1206,0,0,0.1736204628575586,-11499061907,2540.5106170275953,2344.467027301603,196.0435897259922,0.7433748211549905,0.7445243523055027,-1206
1913,2022-03-29,2022,240885,240885,603009230.5833327,3963681.3999999994,180347,0,50,0.8737530356809272,64655884,13009005768,242413,242413,62389,304802,559507495.0333327,3958946.5333335632,181647,0,53,0.699001318888995,11587286042,-1528,-1528,43501735.54999995,4734.866666436195,-1300,0,-3,0.17475171679193224,-11522630158,2503.307514304887,2308.0754540116773,195.23206029320954,0.7486850571849638,0.7493286251149897,-1300
1914,2022-03-30,2022,238260,238260,604028421.5833335,3928761.766666666,178474,0,37,0.8750356753126844,65442056,13031991005,239718,239718,64060,303778,560617349.833327,3923497.2666669893,179798,0,37,0.6945565511656594,11610818241,-1458,-1458,43411071.75000644,5264.499999676831,-1324,0,0,0.18047912414702505,-11545376185,2535.165036444781,2338.6535422176353,196.5114942271457,0.7490724418702258,0.7500396298984641,-1324
1915,2022-03-31,2022,230719,230719,604600460.6000003,3851985.883333331,174408,0,75,0.8851460001126907,65327617,13049289829,232036,232036,66878,298914,561188766.5000114,3846936.066666385,175551,0,75,0.6906836079942624,11634781309,-1317,-1317,43411694.09998882,5049.816666945815,-1143,0,0,0.1944623921184283,-11569453692,2620.50572601303,2418.5418060129095,201.96392000012065,0.7559325413164932,0.756567946353152,-1143
1916,2022-04-01,2022,229342,229342,604962819.5499995,3855554.0166666727,174384,0,58,0.8890957609160114,64347086,13066090323,230706,230706,62855,293561,561585620.0499997,3850778.8333330806,175615,0,58,0.7028624374491417,11656238720,-1364,-1364,43377199.49999976,4775.183333592024,-1231,0,0,0.18623332346686972,-11591891634,2637.819586251099,2434.204658959887,203.61492729121164,0.7603666140523759,0.7612069040250362,-1231
1917,2022-04-02,2022,230645,230645,605248398.0000006,3912376.4666666654,176451,0,43,0.903232240022545,65263024,13071055571,232267,232267,58350,290617,562009501.5500021,3907223.93333302,177912,0,42,0.7267228001114683,11674831425,-1622,-1622,43238896.4499985,5152.533333645202,-1461,0,1,0.1765094399110767,-11609568401,2624.155728500512,2419.6700415900755,204.48568691043647,0.7650328426803096,0.7659805310267924,-1461
1918,2022-04-03,2022,234539,234539,606225451.1499997,3935217.7166666673,178338,0,42,0.8936040487935909,65572346,13090861723,236097,236097,57070,293167,563084512.0500178,3930470.549999728,179816,0,42,0.7245597219332334,11692395223,-1558,-1558,43140939.099981904,4747.166666939389,-1478,0,0,0.16904432686035753,-11626822877,2584.7532868733974,2384.9710587174673,199.78222815593017,0.7603767390497955,0.7616191650042143,-1478
1919,2022-04-04,2022,240471,240471,607274638.9833332,3969907.6333333347,179762,0,50,0.8718057478864398,65778107,13117688844,241966,241966,60928,302894,564164526.6499995,3964953.7333336426,181082,0,50,0.7009845028293833,11715127220,-1495,-1495,43110112.33333373,4953.899999692105,-1320,0,0,0.17082124505705654,-11649349113,2525.3549866026806,2331.5859527784874,193.76903382419323,0.7475412835643384,0.7483778712711703,-1320
1920,2022-04-05,2022,248873,248873,608134086.3333334,4078197.1833333294,186960,0,47,0.8815379731831092,66504346,13135293628,250569,250569,61546,312115,565069823.7000064,4073022.3833335675,188405,0,47,0.7110552200310786,11738334066,-1696,-1696,43064262.63332701,5174.799999761861,-1445,0,0,0.17048275315203065,-11671829720,2443.551877195732,2255.146581181257,188.40529601447497,0.7512265291936048,0.7519086558991734,-1445
1921,2022-04-06,2022,250128,250128,608974938.8666663,4102762.666666666,187855,0,42,0.8813887289707676,67156020,13159317962,251920,251920,65138,317058,565983370.0166637,4097163.816666958,189428,0,42,0.705230588725089,11762435560,-1792,-1792,42991568.85000265,5598.8499997081235,-1573,0,0,0.17615814024567855,-11695279540,2434.6532130215983,2246.678985458335,187.9742275632634,0.7510354698394422,0.7519371228961576,-1573
1922,2022-04-07,2022,250812,250812,609914631.8833338,4061615.0500000063,185921,0,59,0.8636070044495487,67122867,13181702884,252630,252630,66897,319527,566961710.7666622,4055754.95000009,187637,0,59,0.6880545306030429,11786844193,-1818,-1818,42952921.11667156,5860.099999916274,-1716,0,0,0.17555247384650585,-11719721326,2431.7601704995527,2244.237464935527,187.52270556402573,0.7412763344656556,0.7427344337568776,-1716
1923,2022-04-08,2022,248743,248743,610552218.2499988,4025125.483333332,186558,0,44,0.8744205867099777,66294402,13204961563,250381,250381,71557,321938,567614578.8000028,4019373.416666828,188015,0,44,0.684737433915852,11808263288,-1638,-1638,42937639.449995995,5752.0666665039025,-1457,0,0,0.18968315279412573,-11741968886,2454.5503521707096,2267.00340201534,187.5469501553698,0.7500030151602256,0.7509156046185613,-1457
1924,2022-04-09,2022,249923,249923,611363890.0666659,4069684.049999999,187840,0,40,0.8789467155884012,66637590,13230431507,251796,251796,69633,321429,568516229.7833389,4063839.116666772,189593,0,34,0.693792408276779,11832843621,-1873,-1873,42847660.28332698,5844.933333226945,-1753,0,6,0.1851543073116222,-11766206031,2446.2089926363956,2257.844563787109,188.36442884928647,0.7515914901789751,0.7529627158493384,-1753
1925,2022-04-10,2022,248511,248511,612373286.400001,4030200.733333331,186880,0,37,0.88133724462901,66587605,13255176055,250422,250422,68833,319255,569541110.19999,4024444.750000357,188525,0,34,0.69664061643514,11861068648,-1911,-1911,42832176.200011015,5755.983332973905,-1645,0,3,0.18469662819387,-11794481043,2464.1697405748682,2274.325379559264,189.84436101560414,0.7519989054810451,0.7528292242694332,-1645
1926,2022-04-11,2022,253031,253031,613782704.5666666,4089822.9166666684,192247,0,38,0.8896261722871902,66372547,13287829828,254980,254980,69891,324871,571000430.2833384,4084124.6000002734,193850,0,38,0.7023803294230628,11893526670,-1949,-1949,42782274.283328176,5698.316666394938,-1603,0,0,0.18724584286412738,-11827154123,2425.7213723483155,2239.393012327784,186.32836002053136,0.7597764700767891,0.7602557063299082,-1603
1927,2022-04-12,2022,253273,253273,614531568.8000001,4065047.566666673,190026,0,56,0.8825417632357185,65978315,13308587854,255033,255033,69747,324780,571761205.7833327,4059600.749999904,191452,0,56,0.6966069339245098,11921311738,-1760,-1760,42770363.016667366,5446.816666768864,-1426,0,0,0.18593482931120875,-11855333423,2426.3603652975253,2241.9106773763892,184.44968792113605,0.7502813169978639,0.7506950080969914,-1426
1928,2022-04-13,2022,249064,249064,615034606.483333,4007924.2833333327,185824,0,48,0.8828333279799571,65616139,13327182850,250769,250769,71705,322474,572376422.3999957,4002200.7166668256,187278,0,48,0.6904091492647392,11944470310,-1705,-1705,42658184.08333731,5723.566666507162,-1454,0,0,0.1924241787152179,-11878854171,2469.383798876325,2282.4847664583567,186.8990324179681,0.7460893585584428,0.7468147976823292,-1454
1929,2022-04-14,2022,246313,246313,615531559.416667,3971402.3666666644,185678,0,75,0.8860068287098116,66601322,13355246670,248001,248001,73133,321134,572889879.0333449,3965809.8999997415,187174,0,75,0.6883575080807395,11971034771,-1688,-1688,42641680.38332212,5592.466666922905,-1496,0,0,0.19764932062907214,-11904433449,2498.9812125899443,2310.03052017268,188.95069241726424,0.753829477128694,0.7547308276982754,-1496
1930,2022-04-15,2022,243392,243392,615515237.8333338,3951257.299999999,184783,0,56,0.8841416316066262,67673457,13367922183,244695,244695,71135,315830,572980765.9333266,3946331.3166663377,185936,0,56,0.688430484754466,11997944280,-1303,-1303,42534471.90000725,4925.983333661221,-1153,0,0,0.19571114685216018,-11930270823,2528.9049674325115,2341.6120718990032,187.29289553350827,0.7591991519852748,0.759868407609473,-1153
1931,2022-04-16,2022,245250,245250,616195521.1500001,3998247.083333331,186928,0,59,0.8914006116207941,68177856,13391763475,247062,247062,67188,314250,573685606.0166669,3993072.9666663944,188610,0,60,0.7050596658711259,12015752140,-1812,-1812,42509915.133333206,5174.116666936781,-1682,0,-1,0.1863409457496682,-11947574284,2512.5199639143734,2322.030931574531,190.4890323398422,0.7621936799184506,0.7634116132792579,-1682
1932,2022-04-17,2022,244252,244252,616971425.1166666,3996455.4833333325,182441,0,55,0.870187347493572,67669360,13412094718,245941,245941,66899,312840,574553025.399992,3991094.9666663916,184012,0,55,0.6889336401994494,12039218139,-1689,-1689,42418399.716674566,5360.516666940879,-1571,0,0,0.1812537072941226,-11971548779,2525.9626333322412,2336.1416982121405,189.82093512010078,0.7469375890473773,0.7481957054740771,-1571
1933,2022-04-18,2022,256460,256460,618410764.0999995,4153171.1333333314,194357,0,69,0.888637604304765,69143902,13440601787,258388,258388,64602,322990,576056863.4666564,4148438.3499995726,196019,0,69,0.7148951979937564,12067952204,-1928,-1928,42353900.6333431,4732.783333758824,-1662,0,0,0.17374240631100857,-11998808302,2411.3341811588534,2229.4257607422032,181.9084204166502,0.7578452780160649,0.7586226914562596,-1662
1934,2022-04-19,2022,256826,256826,619334968.649999,4158818.433333331,192501,0,70,0.8806117760662866,68175176,13465404949,259431,259431,71531,330962,577010268.9333237,4154592.7333335206,194527,0,70,0.6934089109928072,12097879345,-2605,-2605,42324699.71667528,4225.6999998101965,-2026,0,0,0.18720286507347939,-12029704169,2411.496377508504,2224.1377049516973,187.3586725568066,0.7495385981170131,0.7498217252371536,-2026
1935,2022-04-20,2022,262100,262100,620059911.7500002,4170593.3499999996,196516,0,57,0.8772987409385727,68787802,13482439072,263820,263820,73042,336862,577049328.4833285,4165349.8833334697,197996,0,57,0.6903895363680046,12105403124,-1720,-1720,43010583.26667178,5243.466666529886,-1480,0,0,0.18690920457056814,-12036615322,2365.737931133156,2187.284241086076,178.45369004708027,0.7497748950782144,0.7504965506784929,-1480
1936,2022-04-21,2022,263781,263781,620584412.3500003,4195357.033333337,197390,0,116,0.8742858659266592,68128988,13500160862,265531,265531,75686,341217,577618920.5999889,4189654.9333336437,198863,0,116,0.6836470633057657,12114811884,-1750,-1750,42965491.750011325,5702.099999693222,-1473,0,0,0.1906388026208935,-12046682896,2352.6501618767093,2175.335160866298,177.31500101041138,0.748310151223932,0.7489257374845122,-1473
1937,2022-04-22,2022,266734,266734,621464449.8833336,4238067.683333331,203287,0,70,0.8948428021924464,68570465,13520564541,268505,268505,78427,346932,578619330.0833302,4232532.733333656,204842,0,71,0.6962661270796543,12134498502,-1771,-1771,42845119.80000341,5534.949999675155,-1555,0,-1,0.1985766751127921,-12065928037,2329.9033864574203,2154.9666862193635,174.9367002380568,0.7621338112126688,0.762898270050837,-1555
1938,2022-04-23,2022,262868,262868,621843812.0166662,4180040.583333339,198804,0,45,0.883633610785642,65549404,13535940252,264575,264575,78227,342802,579055491.1499977,4173747.733333571,200330,0,45,0.6854423253073243,12154173432,-1707,-1707,42788320.86666846,6292.849999768194,-1526,0,0,0.19819128547831766,-12088624028,2365.6124443320077,2188.625120098262,176.98732423374577,0.7562883272212669,0.7571766039875272,-1526
1939,2022-04-24,2022,257547,257547,613151059.6666671,4138301.7833333304,196388,0,79,0.8954715061716888,67434529,13332874122,261668,261667,76906,338574,571046317.3833336,4133016.1500002877,198434,0,67,0.6906436997524854,11965967877,-4121,-4120,42104742.28333354,5285.63333304273,-2046,0,12,0.2048278064192034,-11898533348,2380.734621900729,2182.3398341530783,198.39478774765075,0.7625326639409505,0.7583426326490056,-2046
1940,2022-04-25,2022,257288,257288,614361617.6833335,4147363.716666663,195334,0,47,0.8918177295482105,68022298,13363632809,267522,267522,77473,344995,571817558.0166606,4172204.883333601,200305,0,47,0.6825200365222553,11971335703,-10234,-10234,42544059.666672945,-24841.166666937992,-4971,0,0,0.20929769302595513,-11903313405,2387.8362678528865,2137.4599398055507,250.37632804733585,0.7592036939149902,0.7487421595233289,-4971
1941,2022-04-26,2022,263390,263390,614963138.7500004,4194922.183333334,202297,0,36,0.9057671134059754,68699171,13379201320,268278,268278,79641,347919,571507228.5666668,4189699.2000001115,205358,0,38,0.698102144464678,11961256101,-4888,-4888,43455910.183333516,5222.983333222102,-3061,0,-2,0.20766496894129738,-11892556930,2334.8006330916146,2130.279890884332,204.52074220728264,0.7680511788602452,0.7654671646575567,-3061
1942,2022-04-27,2022,266543,266543,616163228.2333332,4268206.750000005,202647,0,37,0.897269858897064,69063521,13407854819,268559,268559,75615,344174,571000799.633341,4262912.800000439,204293,0,37,0.7031646783312981,11888034073,-2016,-2016,45162428.599992275,5293.949999565259,-1646,0,0,0.19410518056576587,-11818970552,2311.6841493992833,2126.1651988328113,185.51895056647209,0.7602788293070911,0.7607006281673673,-1646
1943,2022-04-28,2022,262862,262862,617127748.1666662,4219881.816666661,199629,0,49,0.8893792179927112,68823225,13434342827,264729,264729,75581,340310,571999015.7166705,4214137.916667094,201114,0,49,0.6941994064235543,11915978400,-1867,-1867,45128732.44999564,5743.899999566376,-1485,0,0,0.19517981156915698,-11847155175,2347.7252252766325,2160.6964696601826,187.02875561644987,0.7594441189673669,0.7596976530716317,-1485
1944,2022-04-29,2022,253455,253455,617223242.316667,4109249.8333333326,193510,0,38,0.88883233710126,68414037,13449904015,255148,255148,79752,334900,572199398.8333482,4103842.816666599,195010,0,38,0.6807644072857485,11944009068,-1693,-1693,45023843.483318806,5407.01666673366,-1500,0,0,0.20806792981551148,-11875595031,2435.237980377846,2242.6176134374878,192.62036694035805,0.7634885877177409,0.76430150344114,-1500
1945,2022-04-30,2022,247962,247962,617181518.9166662,4042742.8,191498,0,35,0.8899670110742767,69392220,13470225040,249585,249585,73419,323004,572240066.8000072,4037674.8166663754,192989,0,35,0.691452737427404,11962662545,-1623,-1623,44941452.116658926,5067.983333624434,-1491,0,0,0.19851427364687269,-11893270325,2489.016538488422,2292.766259190285,196.25027929813723,0.7722876892427065,0.7732395776989803,-1491
1946,2022-05-01,2022,233912,233912,616333482.0833317,3885873.733333336,180558,0,46,0.8813186155477267,69198732,13489827119,235022,235022,75299,310321,571504172.983326,3881412.0499997535,181630,0,46,0.6707667222005532,11984954592,-1110,-1110,44829309.100005746,4461.6833335827105,-1072,0,0,0.2105518933471735,-11915755860,2634.8946701466007,2431.7050020139645,203.18966813263614,0.7719056739286569,0.7728212677962063,-1072
1947,2022-05-02,2022,231869,231869,616613636.1166667,3870362.149999996,178603,0,39,0.876007573241787,69399320,13518048151,233127,233127,68140,301267,571792377.6666646,3866201.366666381,179679,0,40,0.6806122144144533,12011662881,-1258,-1258,44821258.450002074,4160.7833336154,-1076,0,-1,0.19539535882733372,-11942263561,2659.318995280381,2452.7076557698792,206.6113395105017,0.770275457262506,0.7707344065680938,-1076
1948,2022-05-03,2022,233333,233333,617140188.7000004,3882000.5333333337,178268,0,33,0.866538380769116,67903548,13546304349,234526,234526,62251,296777,572324077.2333275,3877878.099999701,179249,0,36,0.687735235547222,12034359098,-1193,-1193,44816111.4666729,4122.433333632536,-981,0,-3,0.178803145221894,-11966455550,2644.890301414718,2440.3438306768867,204.54647073783144,0.7640068057240081,0.7643033181822058,-981
1949,2022-05-04,2022,238526,238526,618145505.6833322,3942872.5333333337,183550,0,32,0.8722235731115263,68835344,13569654196,239798,239798,63415,303213,573322025.050001,3938549.149999716,184583,0,33,0.6924142434526157,12065441217,-1272,-1272,44823480.63333118,4323.383333617821,-1033,0,-1,0.1798093296589106,-11996605873,2591.5225412882965,2390.8540732199644,200.668468068332,0.7695177884171956,0.7697437009482981,-1033
1950,2022-05-05,2022,239120,239120,618642723.9500005,3961244.1499999994,185575,0,49,0.8832176313148213,68642586,13585624582,240231,240231,64415,304646,573883745.0833244,3957236.0666664983,186522,0,49,0.6990342889780339,12091104439,-1111,-1111,44758978.86667609,4008.0833335011266,-947,0,0,0.18418334233678746,-12022461853,2587.1642855051878,2388.8829713206223,198.28131418456542,0.7760747741719639,0.7764276883499631,-947
1951,2022-05-06,2022,240401,240401,619192458.0500005,3963971.9666666677,185139,0,48,0.8783865291741724,67887980,13602835194,241433,241433,64761,306194,574480880.250007,3959189.9833331164,186078,0,48,0.694954832557133,12113252228,-1032,-1032,44711577.799993515,4781.983333551325,-939,0,0,0.1834316966170394,-12045364248,2575.6650681569567,2379.462957632167,196.20211052478953,0.7701257482290007,0.770723140581445,-939
1952,2022-05-07,2022,237794,237794,619470123.9499997,3974044.2833333346,184782,0,36,0.8850307408933789,69432345,13616785313,238838,238838,67112,305950,574827736.8500041,3969527.6833330565,185657,0,37,0.6928713842130919,12127826502,-1044,-1044,44642387.09999561,4516.600000278093,-875,0,-1,0.19215935668028694,-12058394157,2605.070455730589,2406.7683402557554,198.3021154748335,0.7770675458590208,0.7773344275199089,-875
1953,2022-05-08,2022,235975,235975,620233497.2500001,3926786.716666664,182975,0,30,0.8827545290814708,69257213,13638419596,236972,236972,65946,302918,575632232.1833322,3922522.783333013,183823,0,31,0.692718821595291,12149726255,-997,-997,44601265.066667914,4263.933333651163,-848,0,-1,0.19003570748617982,-12080469042,2628.3864699650394,2429.114967942762,199.27150202227722,0.7753999364339442,0.775716118359975,-848
1954,2022-05-09,2022,237152,237152,621126318.3333343,3960629.9999999986,183018,0,57,0.8827713871272436,69684375,13662144615,238192,238192,65889,304081,576598502.2999922,3956356.666666435,183913,0,57,0.6938447321601725,12175316392,-1040,-1040,44527816.03334212,4273.333333563525,-895,0,0,0.18892665496707106,-12105632017,2619.1063888701524,2420.7299250184396,198.37646385171274,0.7717328970449332,0.7721208101027742,-895
1955,2022-05-10,2022,241414,241414,621975016.2166672,3999552.000000005,183193,0,38,0.8786524393779976,69513132,13682042847,242579,242579,61872,304451,577556679.45001,3995115.6499998523,184178,0,38,0.7023888901662434,12197525600,-1165,-1165,44418336.76665723,4436.35000015283,-985,0,0,0.17626354921175424,-12128012468,2576.3833755153687,2380.9013948033835,195.48198071198522,0.7588333733751977,0.7592495640595435,-985
1956,2022-05-11,2022,240534,240534,622945189.3166664,4017531.116666664,184442,0,30,0.8820249943874878,68841507,13703321722,241648,241648,63965,305613,578572823.5499908,4013100.999999814,185378,0,30,0.70020908796419,12220431724,-1114,-1114,44372365.76667559,4430.116666849703,-936,0,0,0.1818159064232978,-12151590217,2589.842555799456,2394.2793797175677,195.5631760818883,0.7668021984418003,0.767140634311064,-936
1957,2022-05-12,2022,239936,239936,623665352.3499997,3983219.183333336,182661,0,69,0.8726160309415849,69330023,13727110981,240938,240938,63950,304888,579252602.5499971,3978055.9833330708,183545,0,69,0.6922476450368577,12249715937,-1002,-1002,44412749.800002575,5163.2000002651475,-884,0,0,0.18036838590472726,-12180385914,2599.298781133301,2404.1562665498886,195.14251458341232,0.7612905108028808,0.7617934904415243,-884
1958,2022-05-13,2022,239655,239655,624257899.3166655,3939265.966666669,184626,0,166,0.8796895537334913,69652716,13741588997,240229,240229,65299,305528,579922201.8500023,3931917.9999997383,185257,0,169,0.6946302793852136,12267442977,-574,-574,44335697.46666324,7347.966666930821,-631,0,-3,0.18505927434827774,-12197790261,2604.8190078098332,2414.0391120555896,190.77989575424363,0.7703824247355574,0.7711683435388733,-631
1959,2022-05-14,2022,234907,234907,624358812.2000004,3947880.533333328,184388,0,121,0.8887772607883112,70151573,13759474461,235931,235931,66858,302789,580182957.7166761,3943722.1666663624,185315,0,124,0.6954149589318028,12287795673,-1024,-1024,44175854.48332429,4158.366666965652,-927,0,-3,0.19336230185650838,-12217644100,2657.8978583013723,2459.1213435990867,198.77651470228557,0.7849404232313213,0.785462698839915,-927
1960,2022-05-15,2022,233953,233953,625023746.7666668,3917729.3833333333,183624,0,34,0.8898582193859447,69919070,13779161811,235001,235001,63511,298512,580909299.8499926,3913489.266666471,184568,0,34,0.7038142520233698,12309870201,-1048,-1048,44114446.91667414,4240.116666862275,-944,0,0,0.1860439673625749,-12239951131,2671.5782518995984,2471.9439485363578,199.63430336324063,0.7848755946707244,0.7853924025855209,-944
1961,2022-05-16,2022,236961,236961,625905263.1000007,3969122.6833333336,183023,0,61,0.8802123556197017,70139486,13807037795,237948,237948,66189,304137,581756329.0166591,3964988.066666476,183941,0,61,0.6914811417223058,12336429735,-987,-987,44148934.0833416,4134.616666857619,-918,0,0,0.1887312138973959,-12266290249,2641.3851355286342,2444.8885009189366,196.4966346096976,0.7723760450031861,0.773030241901592,-918
1962,2022-05-17,2022,242086,242086,626780796.1999995,3994436.8333333326,185721,0,33,0.8759862197731384,71656703,13818623490,243184,243184,61438,304622,582814606.8833306,3989975.3666664185,186587,0,33,0.7017122860463333,12359846478,-1098,-1098,43966189.31666887,4461.466666914057,-866,0,0,0.1742739337268051,-12288189775,2589.083202663514,2396.5993111525863,192.4838915109276,0.7671695182703667,0.7672667609711166,-866
1963,2022-05-18,2022,241492,241492,627476188.0333333,3993862.016666671,185042,0,42,0.8690267172411511,70611373,13841162449,242397,242397,67469,309866,583611495.2166666,3989861.8333330657,185869,0,33,0.6821916570388499,12379149104,-905,-905,43864692.81666672,4000.183333605062,-827,0,9,0.18683506020230123,-12308537731,2598.3311581059966,2407.6679794579413,190.66317864805524,0.766244844549716,0.7667957936773145,-827
1964,2022-05-19,2022,246855,246855,628281917.1000003,4048187.066666669,189045,0,52,0.8707135767960946,69289343,13862159848,247879,247879,65512,313391,584469661.100019,4044054.566666407,189948,0,52,0.6903197602994441,12401334157,-1024,-1024,43812255.999981284,4132.500000262167,-903,0,0,0.18039381649665054,-12332044814,2545.145600048613,2357.8829231198247,187.2626769287881,0.7658139393571125,0.766293231778408,-903
1965,2022-05-20,2022,251200,251200,628509553.6833335,4068989.2833333304,191781,0,77,0.8678742038216565,67990071,13873585433,251917,251917,68319,320236,584796461.0499982,4064544.5166665083,192524,0,76,0.6853445583881864,12423985128,-717,-717,43713092.63333535,4444.766666822135,-743,0,1,0.18252964543347006,-12355995057,2502.0284780387483,2321.3854604889634,180.64301754978487,0.7634593949044586,0.7642358395820846,-743
1966,2022-05-21,2022,249106,249106,628549744.8666663,4066691.6000000066,191576,0,55,0.8731503857795478,68581488,13876108295,250040,250040,71578,321618,584965656.3166525,4062054.066666387,192555,0,56,0.6822565901162236,12438107457,-934,-934,43584088.55001378,4637.533333619591,-979,0,-1,0.1908937956633242,-12369525969,2523.222021415246,2339.488307137468,183.7337142777783,0.7690541375960435,0.7700967845144777,-979
1967,2022-05-22,2022,247831,247831,629323309.1333326,4012054.683333335,190186,0,49,0.8702583615447617,68723415,13889394873,249199,249199,71303,320502,585787934.2833376,4007639.983333131,191333,0,49,0.6793530149577901,12448187719,-1368,-1368,43535374.84999502,4414.700000204146,-1147,0,0,0.19090534658697156,-12379464304,2539.324415159252,2350.6833265114933,188.6410886477588,0.7674019795747908,0.7677920055858972,-1147
1968,2022-05-23,2022,245518,245518,630309874.9666669,4021531.099999997,186642,0,40,0.8622219144828485,67518729,13916557106,246591,246591,75536,322127,586791116.0500026,4018373.349999781,187565,0,41,0.6622046584111315,12466865629,-1073,-1073,43518758.91666436,3157.750000215601,-923,0,-1,0.20001725607171694,-12399346900,2567.2654345777783,2379.6128652302905,187.65256934748777,0.7601968083806483,0.7606319776471971,-923
1969,2022-05-24,2022,245255,245255,631140656.1166666,4020460.649999994,186784,0,54,0.8700006116083255,66868995,13935729982,246273,246273,69350,315623,587650956.9500036,4015760.4999996945,187699,0,55,0.6810530284548237,12489969443,-1018,-1018,43489699.16666293,4700.150000299327,-915,0,-1,0.1889475831535018,-12423100448,2573.4058678382357,2386.1769538276776,187.22891401055813,0.7615909971254409,0.7621582552695586,-915
1970,2022-05-25,2022,248772,248772,631770968.1333336,4080394.9999999986,191248,0,52,0.8765455919476474,67553265,13943869202,249760,249760,67183,316943,588347778.0833383,4076142.61666635,192145,0,53,0.6931814237891271,12507747103,-988,-988,43423190.0499953,4252.383333648555,-897,0,-1,0.1833641681585203,-12440193838,2539.558182324914,2355.652538770573,183.90564355434117,0.7687681893460678,0.7693185458039719,-897
1971,2022-05-26,2022,255380,255380,632729962.0500002,4132180.9500000016,194773,0,55,0.8649189443182709,68674439,13963028733,256426,256426,67862,324288,589308620.4833326,4127610.3666663994,195711,0,55,0.6858934033945108,12525716510,-1046,-1046,43421341.56666756,4570.583333602175,-938,0,0,0.1790255409237601,-12457042071,2477.601856253427,2298.1625127067173,179.43934354670955,0.7626791448038217,0.7632260379212716,-938
1972,2022-05-27,2022,257989,257989,633569688.8166664,4153167.5000000014,195873,0,54,0.8645446123671946,69654519,13986318355,259116,259116,71305,330421,589971917.0833242,4148064.4166668397,196902,0,54,0.6806256260951864,12542861956,-1127,-1127,43597771.73334217,5103.0833331616595,-1029,0,0,0.1839189862720082,-12473207437,2455.8011729828263,2276.8640959389777,178.9370770438486,0.759230044691828,0.759899041355995,-1029
1973,2022-05-28,2022,253136,253136,633996347.6166675,4144117.3833333347,195639,0,47,0.8802027368687195,69330873,14002459942,254250,254250,74961,329211,590446436.6166717,4139037.583332972,196700,0,48,0.6826989377633269,12567495354,-1114,-1114,43549910.99999583,5079.800000362564,-1061,0,-1,0.19750379910539262,-12498164481,2504.5680883662044,2322.306535365474,182.2615530007306,0.7728612287466026,0.7736479842674533,-1061
1974,2022-05-29,2022,250701,250701,634632322.9666667,4099285.5999999978,193874,0,49,0.8775393795796588,68028440,14022736178,251617,251617,72012,323629,591075099.6833354,4094554.7166663045,194709,0,49,0.6842155678261134,12587410350,-916,-916,43557223.283331275,4730.8833336932585,-835,0,0,0.1933238117535454,-12519381910,2531.431158897119,2349.106378676065,182.32478022105397,0.7733275894392124,0.7738308619846831,-835
1975,2022-05-30,2022,253458,253458,635673822.3166654,4116248.8499999996,192794,0,38,0.8665064823363248,67278282,14047806554,254587,254587,72847,327434,592059003.033328,4111638.3166664424,193909,0,38,0.6769119883701832,12607582829,-1129,-1129,43614819.283337355,4610.533333557192,-1115,0,0,0.1895944939661416,-12540304547,2508.0045700536793,2325.566517667155,182.4380523865243,0.7606546252239029,0.7616610431797382,-1115
1976,2022-05-31,2022,253948,253948,636605500.1666676,4110504.550000002,191751,0,57,0.8649093515207839,68574310,14069187040,255235,255235,70054,325289,593075800.5333372,4105798.933333013,192818,0,57,0.6807915422900842,12631210395,-1287,-1287,43529699.633330345,4705.616666988935,-1067,0,0,0.18411780923069965,-12562636085,2506.8340769238885,2323.6460537674584,183.18802315643006,0.755079780112464,0.755452817991263,-1067
1977,2022-06-01,2022,251465,251465,637404561.7166663,4095908.1999999997,193423,0,43,0.8753424929910723,68813032,14086975634,252775,252775,71846,324621,593905133.6499921,4090917.8833331284,194548,0,43,0.6847954999830644,12658278879,-1310,-1310,43499428.06667423,4990.316666871309,-1125,0,0,0.19054699300800781,-12589465847,2534.7645267399694,2349.5406335673706,185.22389317259876,0.7691845783707474,0.769648897240629,-1125
1978,2022-06-02,2022,251166,251166,638089969.3499998,4126700.4666666696,193585,0,43,0.8797687585103078,68480645,14103295524,252403,252403,70015,322418,594690194.6833532,4121826.4333330663,194700,0,43,0.6920333232015696,12679006221,-1237,-1237,43399774.6666466,4874.033333603293,-1115,0,0,0.18773543530873815,-12610525576,2540.5109344019484,2356.1138127651143,184.39712163683407,0.7707452441811392,0.7713854431207237,-1115
1979,2022-06-03,2022,257939,257939,638910935.9499995,4128453.950000005,196522,0,46,0.863963960471274,68702379,14121358225,259223,259223,68884,328107,595558960.0500041,4123640.8999997484,197590,0,43,0.6858860066990365,12692008264,-1284,-1284,43351975.89999533,4813.050000256393,-1068,0,3,0.17807795377223745,-12623305885,2476.984620200898,2297.4773073762904,179.50731282460765,0.7618933158615021,0.7622394617761541,-1068
1980,2022-06-04,2022,251434,251434,639094080.8333323,4098183.266666665,193545,0,53,0.876754933700295,67521012,14135517462,252474,252474,75289,327763,595753231.2833391,4093289.48333308,194597,0,53,0.6784780466373584,12710206832,-1040,-1040,43340849.54999316,4893.783333585132,-1052,0,0,0.19827688706293656,-12642685820,2541.796578160998,2359.6617128232574,182.1348653377404,0.7697646300818505,0.770760553561951,-1052
1981,2022-06-05,2022,248481,248481,639807258.5000005,4045686.966666663,191540,0,43,0.8838905187921798,68113673,14158679396,249545,249545,72015,321560,596463710.366681,4040855.8833331303,192554,0,45,0.689037815648701,12729301132,-1064,-1064,43343548.1333195,4831.083333532792,-1014,0,-2,0.1948527031434788,-12661187459,2574.8739682309733,2390.2050145932835,184.6689536376898,0.7708436459930538,0.7716203490352441,-1014
1982,2022-06-06,2022,247997,247997,640758370.5833333,4022483.616666663,190655,0,37,0.8761517276418674,66891034,14183528364,249091,249091,74249,323340,597412723.6833428,4017768.4666663324,191614,0,37,0.6772623244881695,12753388766,-1094,-1094,43345646.89999044,4715.150000330526,-959,0,0,0.19888940315369796,-12686497732,2583.734362042014,2398.3713730457657,185.36298899624808,0.7687794610418675,0.7692530039222614,-959
1983,2022-06-07,2022,243275,243275,641031679.3666661,4022161.150000002,186834,0,47,0.8726379611550711,66544363,14197082336,244451,244451,71047,315498,597828439.166668,4017875.78333301,187836,0,47,0.6784480408750622,12774366131,-1176,-1176,43203240.19999802,4285.366666991729,-1002,0,0,0.19418992028000892,-12707821768,2635.0084446271344,2445.5962101470973,189.4122344800371,0.7679950673106567,0.7683993929253715,-1002
1984,2022-06-08,2022,244509,244509,641050164.350001,4032111.4000000004,187439,0,67,0.8755137847686586,67136426,14202743042,245590,245590,66350,311940,597980182.0500023,4027606.5499997437,188360,0,68,0.6919631980509036,12782643241,-1081,-1081,43069982.29999864,4504.8500002566725,-921,0,-1,0.18355058671775504,-12715506815,2621.785555337435,2434.871867950659,186.91368738677602,0.7665934587274906,0.7669693391424732,-921
1985,2022-06-09,2022,247182,247182,641870538.7166666,4059219.8,191006,0,79,0.8795179260625776,68049118,14216573829,248479,248479,65732,314211,598890545.8500056,4054174.399999723,192089,0,63,0.6982473560760137,12805874412,-1297,-1297,42979992.86666095,5045.400000276975,-1083,0,16,0.18127056998656388,-12737825294,2596.7527518859247,2410.2259983741305,186.52675351179414,0.7727342605853177,0.773059292737012,-1083
1986,2022-06-10,2022,245865,245865,642007733.8833331,4062303.2000000034,191198,0,73,0.884664348321234,68003140,14225363712,246787,246787,68121,314908,599099455.0666655,4057756.9999997113,192052,0,73,0.6954888411853799,12823561206,-922,-922,42908278.81666756,4546.200000292156,-854,0,0,0.18917550713585407,-12755558066,2611.220522983479,2427.597300776238,183.62322220724081,0.7776544038395055,0.7782095491253591,-854
1987,2022-06-11,2022,246877,246877,642284672.5000013,4090012.583333331,192537,0,88,0.8920717604313071,69258451,14232409350,247942,247942,67592,315534,599509781.1833366,4085479.2166664205,193533,0,89,0.7034772797860199,12837330869,-1065,-1065,42774891.316664696,4533.366666910704,-996,0,-1,0.18859448064528717,-12768072418,2601.6383563474983,2417.943636751081,183.69471959641714,0.7798903907613913,0.7805575497495382,-996
1988,2022-06-12,2022,248078,248078,643093588.7499998,4073948.2666666596,192872,0,72,0.8864268496198785,68250548,14250884612,249218,249218,66152,315370,600312505.2833419,4069139.7999996776,193864,0,74,0.7030694105336702,12850760403,-1140,-1140,42781083.46665788,4808.4666669820435,-992,0,-2,0.18335743908620827,-12782509855,2592.303988060206,2408.7846996739477,183.51928838625827,0.7774651520892623,0.7778892375350095,-992
1989,2022-06-13,2022,245365,245365,644139980.3166662,4049227.216666663,188889,0,67,0.8729892201414219,67255747,14277160630,246390,246390,70590,316980,601415155.516671,4044667.116666408,189740,0,68,0.6809577891349675,12875219181,-1025,-1025,42724824.7999953,4560.1000002552755,-851,0,-1,0.19203143100645437,-12807963434,2625.231717305509,2440.9073238226833,184.3243934828256,0.7698286226641942,0.7700799545436098,-851
1990,2022-06-14,2022,249493,249493,644559662.2500004,4097852.6999999993,193886,0,83,0.8775075853831567,68157661,14289516048,250440,250440,65890,316330,601866927.6666726,4093561.583333042,194642,0,83,0.6970442259665564,12894196891,-947,-947,42692734.58332777,4291.11666695727,-756,0,0,0.1804633594166003,-12826039230,2583.477942266919,2403.2380117659823,180.23993050093668,0.7771199993586995,0.7772001277751158,-756
1991,2022-06-15,2022,255568,255568,645743016.3000003,4158987.6166666723,196929,0,71,0.8703750078257051,69592241,14314348663,256582,256582,65801,322383,603021046.5166568,4154223.5499997493,197801,0,72,0.6950676679601595,12913785578,-1014,-1014,42721969.78334355,4764.066666922998,-872,0,-1,0.17530733986554559,-12844193337,2526.6974593845875,2350.2079121553998,176.4895472291878,0.7705542164903274,0.7709075461256051,-872
1992,2022-06-16,2022,259959,259959,646583652.4500005,4174806.949999997,198051,0,86,0.8646632738239493,70938832,14326856292,261055,261055,69320,330375,603944378.9333366,4171427.583333085,198998,0,86,0.6846220204313326,12936728025,-1096,-1096,42639273.51666391,3379.366666912101,-947,0,0,0.18004125339261667,-12865789193,2487.2524223050577,2313.475623655309,173.7767986497488,0.761854754018903,0.7622838099251116,-947
1993,2022-06-17,2022,260778,260778,647585042.2999991,4180572.1000000006,201244,0,47,0.879955364332881,70232269,14352893757,261835,261835,73221,335056,605010173.5166678,4175470.816666588,202226,0,47,0.6896399407860215,12954899284,-1057,-1057,42574868.783331275,5101.283333412372,-982,0,0,0.19031542354685949,-12884667015,2483.2809604337754,2310.654318623056,172.62664181071932,0.7717062022103092,0.7723413600168044,-982
1994,2022-06-18,2022,257050,257050,647807172.1666677,4160519.2499999986,199734,0,52,0.8874965959929966,69542723,14362507821,258184,258184,75590,333774,605312878.0666729,4155503.8833330423,200768,0,53,0.6895833707838478,12981671780,-1134,-1134,42494294.09999478,5015.366666956339,-1034,0,-1,0.19791322520914878,-12912129057,2520.16017182131,2344.5018981295234,175.6582736917867,0.7770239253063607,0.7776159638087565,-1034
1995,2022-06-19,2022,249386,249386,648087991.3666666,4082577.5500000017,194122,0,53,0.8886625552356581,67879811,14377904954,250440,250440,75479,325919,605647423.6166743,4077360.1166665303,195051,0,53,0.6853113810486707,12995251062,-1054,-1054,42440567.74999225,5217.433333471417,-929,0,0,0.20335117418698734,-12927371251,2598.7344572937795,2418.333427634061,180.40102965971846,0.7783997497854731,0.778833253473886,-929
1996,2022-06-20,2022,254039,254039,648900859.2500017,4142238.1000000015,195324,0,41,0.87476332374163,67718849,14400736332,255105,255105,71896,327001,606506935.3000075,4137408.9499996947,196225,0,41,0.6844566224568145,13009739210,-1066,-1066,42393923.94999421,4829.150000306778,-901,0,0,0.19030670128481553,-12942020361,2554.335591188761,2377.479607612581,176.85598357618028,0.7688740705167317,0.7691930773603026,-901
1997,2022-06-21,2022,256075,256075,649846101.0666666,4174049.5833333307,196581,0,38,0.879539197500732,69020172,14419690182,257245,257245,69292,326537,607464970.0000011,4169228.416666444,197567,0,38,0.6951677757803636,13034662188,-1170,-1170,42381131.06666553,4821.166666886769,-986,0,0,0.18437142172036836,-12965642016,2537.7178602622926,2361.425761433657,176.29209882863552,0.7676696280386606,0.7680110400590876,-986
1998,2022-06-22,2022,257464,257464,649922430.1499999,4163821.666666669,197326,0,33,0.8723976944349504,68330197,14413554195,258491,258491,70939,329430,607510839.9833257,4159233.649999849,198103,0,33,0.6855416932276978,13037069454,-1027,-1027,42411590.16667414,4588.016666819807,-777,0,0,0.18685600120725265,-12968739257,2524.323517656837,2350.2204718281323,174.10304582870458,0.7664217133269117,0.7663825819854463,-777
1999,2022-06-23,2022,255221,255221,650486298.8000003,4138484.116666665,198694,0,43,0.8922306550009607,68850692,14427921358,256404,256404,73067,329471,608007291.8166537,4133436.1499996246,199741,0,43,0.6963920952071575,13045708960,-1183,-1183,42479006.98334658,5047.966667040251,-1047,0,0,0.19583855979380316,-12976858268,2548.7177732239916,2371.2862974706077,177.4314757533839,0.7785174417465648,0.7790089078173508,-1047
2000,2022-06-24,2022,255376,255376,650652415.100001,4166138.6166666644,199525,0,109,0.8940660046363013,68720554,14428662723,256881,256881,71845,328726,608163317.200014,4161499.549999727,200809,0,109,0.7016055924995398,13049571677,-1505,-1505,42489097.89998698,4639.066666937433,-1284,0,0,0.19246041213676146,-12980851123,2547.8213109297703,2367.4904613420767,180.3308495876936,0.7812989474343712,0.7817199403614904,-1284
2001,2022-06-25,2022,256921,256921,650904101.7833331,4189312.7166666654,201751,0,49,0.89529077031461,69292217,14433189770,258134,258134,70658,328792,608416043.6666758,4184831.6666668607,202824,0,50,0.705388208958859,13055804165,-1213,-1213,42488058.11665726,4481.049999804702,-1073,0,-1,0.189902561355751,-12986511948,2533.4795590213844,2356.977553002223,176.5020060191614,0.7852647311819586,0.7857314418092929,-1073
2002,2022-06-26,2022,253593,253593,651287054.6000005,4107136.266666666,197207,0,37,0.8891373184591063,68360820,14447545297,254584,254584,72487,327071,608863607.6333307,4102651.71666639,198197,0,37,0.695066208865969,13068225135,-991,-991,42423446.9666698,4484.550000275951,-990,0,0,0.19407110959313723,-12999864315,2568.237508921778,2391.602015968524,176.63549295325402,0.7776515913294136,0.778513182289539,-990
2003,2022-06-27,2022,248680,248680,651509948.3666667,4097565.449999998,191956,0,63,0.8826403410004818,67927552,14464564321,249886,249886,75018,324904,609110985.7166713,4092721.099999743,193020,0,63,0.6819152734346036,13085506670,-1206,-1206,42398962.64999533,4844.35000025481,-1064,0,0,0.20072506756587827,-13017579118,2619.872721435848,2437.5554681601666,182.3172532756812,0.7718996300466463,0.772432229096468,-1064
2004,2022-06-28,2022,248575,248575,651211816.2999988,4092589.5833333344,192698,0,81,0.882184451372824,67422419,14460776089,249747,249747,68445,318192,608947899.0166858,4087963.8999997303,193697,0,81,0.6945492029969316,13097960345,-1172,-1172,42263917.28331292,4625.683333604131,-999,0,0,0.1876352483758924,-13030537926,2619.7800112642008,2438.2591142904053,181.52089697379552,0.7752107009956754,0.7755728797543113,-999
2005,2022-06-29,2022,251427,251427,651680251.4166672,4122974.8500000015,195222,0,41,0.882295855258186,68548212,14474527705,252616,252616,67555,320171,609513905.5333353,4118475.94999982,196197,0,42,0.6985329714433856,13102327187,-1189,-1189,42166345.883331895,4498.900000181515,-975,0,-1,0.18376288381480044,-13033778975,2591.9262904010598,2412.8079992294047,179.11829117165507,0.776455989213569,0.7766610190961776,-975
2006,2022-06-30,2022,255725,255725,652454310.1166668,4121757.2833333313,194989,0,63,0.8711623814644628,67889561,14492003836,256674,256674,68721,325395,610291706.0333307,4118661.8833330167,195804,0,63,0.6888735229490431,13118427372,-949,-949,42162604.083336115,3095.400000314694,-815,0,0,0.18228885851541965,-13050537811,2551.3904002998015,2377.691959580365,173.69844071943635,0.7624948675334833,0.7628509315318264,-815
2007,2022-07-01,2022,257755,257755,652512118.0000012,4143915.316666667,197031,0,39,0.8699617854163832,69034309,14497722888,258562,258562,71790,330352,610472576.3166759,4138930.3833330306,197752,0,39,0.682623383542414,13132573652,-807,-807,42039541.68332529,4984.9333336362615,-721,0,0,0.18733840187396922,-13063539343,2531.5206998894346,2361.0297581109207,170.49094177851384,0.7644119415724234,0.7648146285997169,-721
2008,2022-07-02,2022,258709,258709,652560013.2833333,4179577.033333334,197902,0,55,0.8760074060044301,69507448,14511785633,259719,259719,75942,335661,610540911.1166615,4174132.36666638,198751,0,56,0.6797989638355227,13146783059,-1010,-1010,42019102.16667175,5444.66666695429,-849,0,-1,0.19620844216890732,-13077275611,2522.3707458315453,2350.774918726245,171.5958271053005,0.764959858373694,0.7652539860387573,-849
2009,2022-07-03,2022,261521,261521,652921582.816667,4181709.0833333354,199344,0,57,0.8721288156591633,69222646,14521741460,262436,262436,74988,337424,610978291.8000088,4176681.3500001696,200181,0,57,0.6804880506425259,13157473540,-915,-915,41943291.01665819,5027.733333165757,-837,0,0,0.1916407650166374,-13088250894,2496.631562347448,2328.1039636330715,168.52759871437638,0.7622485383582963,0.7627802588059565,-837
2010,2022-07-04,2022,262712,262712,654055188.2999989,4224042.45,198826,0,36,0.862857425621974,67111741,14541776218,263515,263515,78270,341785,612153967.0333227,4219468.666666307,199564,0,36,0.667039220562641,13174855093,-803,-803,41901221.26667619,4573.783333693631,-738,0,0,0.195818205059333,-13107743352,2489.6281414628907,2323.0327193265002,166.59542213639043,0.756821157769725,0.7573155228355122,-738
2011,2022-07-05,2022,263707,263707,654988831.0166677,4243690.53333333,198682,0,47,0.8588130007925459,68928418,14557696501,264605,264605,74014,338619,613148611.2999904,4238470.099999767,199440,0,47,0.6729185308562068,13190516979,-898,-898,41840219.71667731,5220.433333563618,-758,0,0,0.18589446993633907,-13121588561,2483.774913129601,2317.22231741649,166.5525957131108,0.7534195148403342,0.7537272538311823,-758
2012,2022-07-06,2022,259630,259630,655678880.4666668,4239347.016666669,199539,0,47,0.8717367022300954,69311829,14574800363,260631,260631,76731,337362,613919021.5833393,4234493.699999744,200396,0,48,0.6750493535134381,13211623680,-1001,-1001,41759858.883327484,4853.316666925326,-857,0,-1,0.19668734871665727,-13142311851,2525.435737267137,2355.5103636303406,169.9253736367964,0.7685514000693294,0.7688878145730937,-857
2013,2022-07-07,2022,262080,262080,656849143.9333333,4251298.049999999,201728,0,36,0.8792925824175829,68888663,14594569264,263122,263122,71461,334583,615073402.7666707,4246342.766666436,202635,0,36,0.6934482624640127,13232285068,-1042,-1042,41775741.166662574,4955.283333563246,-907,0,0,0.1858443199535702,-13163396405,2506.292521113146,2337.5977788503837,168.69474226276225,0.7697191697191698,0.7701180441012154,-907
2014,2022-07-08,2022,264337,264337,657417309.1666656,4261707.783333338,205008,0,35,0.8847796562721065,69860715,14606233823,265442,265442,73433,338875,615715667.3833401,4256590.599999968,206004,0,36,0.6953566949465065,13255706952,-1105,-1105,41701641.783325434,5117.183333369903,-996,0,-1,0.1894229613256,-13185846237,2487.042332956285,2319.58645347511,167.4558794811751,0.7755554462674541,0.7760791434663693,-996
2015,2022-07-09,2022,260459,260459,657658264.5833335,4289212.749999994,203945,0,33,0.8966401621752365,70630734,14617663971,261446,261446,74929,336375,616004645.733331,4283661.849999918,204849,0,33,0.6993236714975828,13268044850,-987,-987,41653618.85000253,5550.900000076741,-904,0,0,0.19731649067765367,-13197414116,2524.9972724433924,2356.1448472469688,168.8524251964236,0.7830215120230055,0.783523174957735,-904
2016,2022-07-10,2022,257979,257979,658661587.0333344,4231542.766666657,203048,0,43,0.8959954104791481,70159148,14638414368,259014,259014,71935,330949,617077565.6499915,4226676.966666493,203988,0,44,0.7035857488616136,13284235180,-1035,-1035,41584021.38334286,4865.800000164658,-940,0,-1,0.19240966161753448,-13214076032,2553.159703050769,2382.4100845899893,170.74961846077986,0.7870718159230015,0.7875558850100767,-940
2017,2022-07-11,2022,259768,259768,659687931.8499998,4242880.633333333,203127,0,80,0.8928659419174044,70020307,14666799232,260696,260696,73668,334364,618117231.2333316,4238028.083333117,203981,0,79,0.6987654173296087,13312352303,-928,-928,41570700.616668224,4852.550000215881,-854,0,1,0.1941005245877957,-13242331996,2539.527316105139,2371.026909631646,168.50040647349306,0.7819554371593114,0.7824477552398196,-854
2018,2022-07-12,2022,258479,258479,660498516.7500008,4237511.400000003,201161,0,47,0.8869192468246946,70174597,14685061810,259342,259342,69454,328796,619046518.8333449,4232862.749999805,201961,0,47,0.7016539130646234,13340570599,-863,-863,41451997.9166559,4648.650000197813,-800,0,0,0.18526533376007115,-13270396002,2555.327576901802,2386.9890678461065,168.33850905569534,0.7782489099694753,0.7787438980188323,-800
2019,2022-07-13,2022,258019,258019,661212074.5833336,4231782.166666663,201742,0,46,0.8914886113038182,69707567,14704073893,259060,259060,70563,329623,619828712.0833383,4226753.899999885,202722,0,47,0.7034278554591246,13364011505,-1041,-1041,41383362.49999535,5028.266666778363,-980,0,-1,0.18806075584469362,-13294303938,2562.648776188318,2392.6067786742,170.04199751411807,0.7818881555234305,0.7825291438276847,-980
2020,2022-07-14,2022,261549,261549,662149507.9666662,4270055.999999998,206197,0,78,0.9010931030132014,71991442,14725079980,262718,262718,69279,331997,620807609.5666636,4265142.116666613,207256,0,77,0.7167384042626762,13383235965,-1169,-1169,41341898.4000026,4913.883333384991,-1059,0,1,0.18435469875052524,-13311244523,2531.64610824995,2363.018938811439,168.62716943851092,0.7883685275034505,0.788891511049871,-1059
2021,2022-07-15,2022,266325,266325,663197388.8333333,4296210.116666664,211666,0,58,0.9110597953628092,74546237,14750200831,267507,267507,70759,338266,621844707.733338,4291081.233333293,212793,0,59,0.7248467182631322,13410865430,-1182,-1182,41352681.099995255,5128.883333371021,-1127,0,-1,0.18621307709967705,-13336319193,2490.1807522137738,2324.59228256957,165.58846964420354,0.7947657936731437,0.7954670345075082,-1127
2022,2022-07-16,2022,262493,262493,663733681.0333332,4312251.166666665,211411,0,57,0.9198302430921965,75597092,14773044047,263733,263733,74216,337949,622398447.2833385,4307061.56666665,212550,0,57,0.7221858919541229,13439243667,-1240,-1240,41335233.749994636,5189.60000001546,-1139,0,0,0.19764435113807366,-13363646575,2528.576689791092,2359.9566504128743,168.62003937821783,0.8053967153409806,0.8059287233679516,-1139
2023,2022-07-17,2022,263299,263299,664748482.766666,4267195.233333337,210964,0,43,0.9151990702585275,75762960,14805018157,264412,264412,72030,336442,623498285.6166571,4262156.783333074,211971,0,45,0.7230488464579313,13466490690,-1113,-1113,41250197.15000892,5038.450000262819,-1007,0,-2,0.1921502238005962,-13390727730,2524.69049546966,2358.0559339843016,166.63456148535852,0.8012335785551787,0.80166936447665,-1007
2024,2022-07-18,2022,262920,262920,665449093.750001,4280457.8333333405,209057,0,30,0.9093260307317814,75224489,14831740985,264064,264064,76451,340515,624279661.5833244,4275273.166666583,210147,0,30,0.7085179801183455,13499873697,-1144,-1144,41169432.16667652,5184.666666757315,-1090,0,0,0.20080805061343587,-13424649208,2530.9945753461166,2364.122567193273,166.8720081528436,0.795135402403773,0.7958184379544353,-1090
2025,2022-07-19,2022,265871,265871,666384599.0666673,4322215.483333335,210117,0,48,0.9031936540653173,76255860,14858996651,274997,274997,70917,345914,625291235.7333275,4321980.949999938,214261,0,49,0.7101447180513062,13528446243,-9126,-9126,41093363.33333981,234.53333339747041,-4144,0,-1,0.19304893601401107,-13452190383,2506.420779500838,2273.8111169697395,232.60966253109837,0.7902967980712451,0.7791394087935505,-4144
2026,2022-07-20,2022,268734,268734,667625151.6000001,4325943.25,209920,0,89,0.8917256469222355,76790334,14888820125,269700,269700,80755,350455,624960485.5000086,4321172.283333355,210811,0,89,0.6885220641737154,13488400281,-966,-966,42664666.09999156,4770.96666664537,-891,0,0,0.20320358274852013,-13411609947,2484.3345151711364,2317.2431794586896,167.09133571244683,0.7811441797465152,0.7816499814608825,-891
2027,2022-07-21,2022,270193,270193,668196503.4333344,4315857.416666664,210194,0,124,0.891100065508729,75117695,14897667625,271514,271514,76483,347997,625510926.8666615,4311191.433333154,211268,0,125,0.6977071641422182,13507305694,-1321,-1321,42685576.5666728,4665.983333510347,-1074,0,-1,0.19339290136651077,-13432187999,2473.0341031534285,2303.7888538589596,169.24524929446898,0.7779402131069273,0.7781108893095752,-1074
2028,2022-07-22,2022,272048,272048,669169029.4000001,4348779.133333336,214609,0,122,0.9019364229841799,75452105,14917757894,273098,273098,78281,351379,626437742.2666675,4343981.516666647,215549,0,123,0.7034654888311498,13522402946,-1050,-1050,42731287.13333261,4797.616666688584,-940,0,-1,0.19847093415303008,-13446950841,2459.7461822913606,2293.8203218868957,165.92586040446486,0.7888644650943951,0.7892734476268592,-940
2029,2022-07-23,2022,270044,270044,669183835.1166663,4367726.083333336,214276,0,135,0.9047229340403786,75939501,14925619865,270946,270946,77246,348192,626463629.9666538,4362348.900000089,215125,0,136,0.7064694191710411,13531747017,-902,-902,42720205.15001249,5377.183333246969,-849,0,-1,0.1982535148693375,-13455807516,2478.0548174248133,2312.1346318700175,165.9201855547958,0.7934855060656781,0.7939773977102449,-849
2030,2022-07-24,2022,272731,272731,669849417.8666664,4357153.1,216396,0,126,0.907923925039691,76085369,14944811335,273903,273903,75916,349819,627271152.5333343,4351595.666666732,217448,0,127,0.7141293068701309,13550394594,-1172,-1172,42578265.33333218,5557.433333267458,-1052,0,-1,0.19379461816956012,-13474309225,2456.080965737912,2290.1215121168234,165.95945362108841,0.7934411563041972,0.7938868869636331,-1052
2031,2022-07-25,2022,270828,270828,670470996.3999995,4344496.483333328,210746,0,136,0.8923154179036137,75175428,14962585353,272166,272166,79566,351732,627899037.8166783,4339075.216666722,211860,0,137,0.6942558538887842,13567789683,-1338,-1338,42571958.58332121,5421.266666606069,-1114,0,-1,0.1980595640148295,-13492614255,2475.633968422761,2307.04436930652,168.58959911624106,0.7781544005789652,0.7784219924604837,-1114
2032,2022-07-26,2022,269036,269036,670362238.1666665,4336421.633333335,209638,0,131,0.8904793410547286,73664605,14965767534,270211,270211,77424,347635,627766291.4666672,4331316.166666664,210608,0,133,0.6945618249025588,13586298671,-1175,-1175,42595946.69999933,5105.466666670516,-970,0,-2,0.1959175161521698,-13512634066,2491.719465672499,2323.2447660038533,168.47469966864583,0.7792191379592323,0.779420526921554,-970
2033,2022-07-27,2022,273304,273304,670833512.1333338,4361546.200000009,212742,0,126,0.8942020607089541,73124812,14972830309,274342,274342,75051,349393,628375861.633341,4356515.266666697,213688,0,128,0.7050112623893706,13600192624,-1038,-1038,42457650.49999285,5030.93333331123,-946,0,-2,0.18919079831958352,-13527067812,2454.532360058154,2290.4836358754437,164.04872418271043,0.7784079267043292,0.7789109943063767,-946
2034,2022-07-28,2022,274521,274521,671316662.3333338,4363482.249999996,213446,0,129,0.8887480374907563,73501122,14979560439,275460,275460,76763,352223,628925460.1000168,4358398.883333263,214291,0,130,0.697714232176773,13605341921,-939,-939,42391202.23331702,5083.366666733287,-845,0,-1,0.19103380531398328,-13531840799,2445.410960667249,2283.1825314020793,162.22842926516978,0.77752157394152,0.7779387206853989,-845
2035,2022-07-29,2022,273619,273619,671712011.5666668,4339277.333333334,213712,0,124,0.8927267477770188,73225165,14994146090,292029,292028,78948,370977,629457814.7833359,4389083.533334411,223722,0,125,0.6907247619124626,13622260432,-18410,-18409,42254196.78333092,-49806.200001076795,-10010,0,-1,0.2020019858645562,-13549035267,2454.9172812073243,2155.470758911255,299.44652229606936,0.7810568710506215,0.766095148084608,-10010
2036,2022-07-30,2022,269299,269299,671700577.8666673,4337352.166666671,212241,0,130,0.9007311575609255,74525731,15000053164,270333,270333,93266,363599,621844451.1833417,4332563.333333254,213199,0,131,0.6730244032574322,13230609588,-1034,-1034,49856126.68332553,4788.833333416842,-958,0,-1,0.2277067543034933,-13156083857,2494.255744977394,2300.290571936618,193.96517304077588,0.7881239811510625,0.7886532535798442,-958
2037,2022-07-31,2022,268166,268166,672108376.7666668,4303070.166666664,211361,0,139,0.9034739676170729,73708388,15002254581,269256,269256,78664,347920,622089565.7000012,4297901.900000012,212470,0,139,0.7031817659231806,13209041689,-1090,-1090,50018811.06666553,5168.266666652635,-1109,0,0,0.20029220169389228,-13135333301,2506.3146587064234,2310.4018692248314,195.91278948159197,0.7881722515158521,0.789100335739965,-1109
2038,2022-08-01,2022,279072,279072,672769054.7499996,4402699.833333335,216670,0,123,0.8933859362458446,74271374,15024789925,280304,280304,78295,358599,622724927.7333428,4397440.266666735,217805,0,124,0.7022942060630449,13226271952,-1232,-1232,50044127.016656876,5259.566666600294,-1135,0,-1,0.19109173018279968,-13152000578,2410.736493628883,2221.6055701429264,189.13092348595683,0.7763946221763559,0.7770313659455448,-1135
2039,2022-08-02,2022,283361,283361,673345590.2000005,4475855.583333333,217094,0,130,0.8842889459029295,74803995,15040493560,284820,284820,77829,362649,623373459.7333308,4469809.900001715,218356,0,131,0.6973961047734819,13244354571,-1459,-1459,49972130.46666968,6045.6833316180855,-1262,0,-1,0.1868928411294476,-13169550576,2376.281810834944,2188.6576073777505,187.6242034571933,0.76613930639714,0.7666456007302858,-1262
2040,2022-08-03,2022,285845,285845,674134754.3333335,4500097.85,218421,0,132,0.8822438734279063,73608535,15057761366,287191,287191,80279,367470,624068036.466671,4493396.333335033,219608,0,133,0.692725936811169,13253216207,-1346,-1346,50066717.8666625,6701.516664966941,-1187,0,-1,0.18951793661673733,-13179607672,2358.392675517618,2173.0069412574594,185.38573426015864,0.7641239133096608,0.7646757732658753,-1187
2041,2022-08-04,2022,285415,285415,674787728.5666672,4484875.08333334,220047,0,130,0.887868542298057,73587399,15072876935,286799,286799,81365,368164,624618972.2333481,4479044.850000165,221233,0,130,0.6949375821644623,13269258389,-1384,-1384,50168756.33331907,5830.233333174139,-1186,0,0,0.19293096013359468,-13195670990,2364.23358466327,2177.8980130103246,186.33557165294542,0.7709720932676979,0.7713869295220694,-1186
2042,2022-08-05,2022,281980,281980,674891649.4666656,4455450.1499999985,219293,0,126,0.8936343003049865,73514348,15083836178,283378,283378,82744,366122,624696585.3499848,4449702.316668148,220414,0,126,0.6938042510419943,13279847152,-1398,-1398,50195064.11668086,5747.833331850357,-1121,0,0,0.1998300492629922,-13206332804,2393.402544388487,2204.463950447758,188.93859394072888,0.7776899070856089,0.7778091453817869,-1121
2043,2022-08-06,2022,279534,279534,674776949.0333334,4453340.349999997,219252,0,124,0.9003985203946555,74384955,15092076071,280922,280922,82673,363595,624880908.3999923,4448964.150001604,220607,0,125,0.6993275485086272,13299209501,-1388,-1388,49896040.633341074,4376.1999983927235,-1355,0,-1,0.2010709718860283,-13224824546,2413.935152909247,2224.392921878644,189.54223103060303,0.7843482367082358,0.7852962744106905,-1355
2044,2022-08-07,2022,270392,270392,675101531.1166668,4350718.649999998,212886,0,129,0.9024675286251073,73257203,15109745957,271710,271710,83333,355043,625351865.049998,4346224.000001129,214160,0,130,0.6943750475294344,13320727621,-1318,-1318,49749666.06666875,4494.649998868816,-1274,0,-1,0.2080924810956729,-13247470418,2496.751128423425,2301.541588642295,195.20953978112993,0.7873235894553093,0.7881932943211513,-1274
2045,2022-08-08,2022,273370,273370,675651696.0666666,4359672.483333333,213541,0,119,0.8975820316786774,73274407,15132583647,274588,274588,79365,353953,625906783.7166619,4354512.366667804,214586,0,119,0.6985418968055239,13343977018,-1218,-1218,49744912.35000467,5160.116665529087,-1045,0,0,0.19904013487315353,-13270702611,2471.564897635683,2279.4396831495255,192.12521448615735,0.7811427735303801,0.7814835316911154,-1045
2046,2022-08-09,2022,271345,271345,675889337.5000006,4345772.36666666,212138,0,124,0.8965965836849754,73911986,15148865747,272682,272682,78868,351550,626156407.9166697,4340775.700001168,213279,0,125,0.6979860617266321,13366388742,-1337,-1337,49732929.58333087,4996.666665491648,-1141,0,-1,0.19861052195834328,-13292476756,2490.8855423906857,2296.28801283792,194.59752955276554,0.7818017652803626,0.7821528373710036,-1141
2047,2022-08-10,2022,279602,279602,676147060.3666667,4404193.899999999,216248,0,128,0.89065528858878,74015290,15159244478,280969,280969,75443,356412,626553292.7666748,4399035.366667887,217468,0,130,0.7048724509836971,13383796878,-1367,-1367,49593767.59999192,5158.533332112245,-1220,0,-2,0.18578283760508285,-13309781588,2418.2482971032637,2229.973031781708,188.2752653215557,0.7734136379568101,0.7739928604223242,-1220
2048,2022-08-11,2022,280334,280334,676577461.6333339,4420519.8666666625,216292,0,126,0.8874271404824247,74970145,15173510070,281652,281652,80637,362289,626937959.7333355,4414483.150001612,217424,0,126,0.692717692229116,13400764242,-1318,-1318,49639501.89999843,6036.716665050946,-1132,0,0,0.1947094482533086,-13325794097,2413.469153343276,2225.9311481307977,187.5380052124783,0.7715510783565318,0.7719597233465412,-1132
2049,2022-08-12,2022,287223,287223,677527325.4833338,4437713.899999995,220495,0,125,0.8825477068340629,75532626,15195694839,299003,299003,82441,381444,627953882.8166617,4442554.083334948,226667,0,126,0.6850940111785733,13418016691,-11780,-11780,49573442.66667211,-4840.183334953152,-6172,0,-1,0.19745369565548965,-13342484065,2358.889523065123,2100.159138258351,258.7303848067718,0.7676787722431699,0.7580760059263619,-6172
2050,2022-08-13,2022,284877,284877,677854605.45,4452672.149999995,219570,0,131,0.8873162803595938,74883887,15207235049,297405,297405,90492,387897,625165609.0499477,4460504.166666313,226032,0,131,0.6722145311771045,13351540473,-12528,-12528,52688996.40005231,-7832.01666631829,-6462,0,0,0.21510174918248925,-13276656586,2379.4641387335587,2102.0682538960264,277.3958848375323,0.7707536936993861,0.7600141221566551,-6462
2051,2022-08-14,2022,284336,284336,678488940.1166667,4446095.433333336,219501,0,121,0.891501603736425,74821128,15222496573,285700,285700,93995,379695,617206236.4166662,4440518.533334904,220758,0,122,0.6738908861059624,13119585606,-1364,-1364,61282703.700000525,5576.899998432025,-1257,0,-1,0.21761071763046258,-13044764478,2386.222427398102,2160.3298439505293,225.89258344757263,0.7719775195543301,0.7726916345817291,-1257
2052,2022-08-15,2022,275595,275595,679111090.1333337,4363329.249999998,214380,0,66,0.8999328725122012,73101701,15247243250,276963,276963,91624,368587,617785771.1000013,4358106.966666586,215613,0,68,0.6792751779091439,12990985075,-1368,-1368,61325319.03333235,5222.283333412372,-1233,0,-2,0.22065769460305729,-12917883374,2464.163319847362,2230.5714882493376,233.59183159802433,0.7778805856419746,0.77849026765308,-1233
2053,2022-08-16,2022,284195,284195,679457143.0166656,4479838.533333328,218648,0,64,0.8899663963123913,72937837,15256193397,285813,285813,79770,365583,618164671.3833246,4474009.000001685,219871,0,64,0.6990095272482612,13007697496,-1618,-1618,61292471.633340955,5829.533331642859,-1223,0,0,0.19095686906413012,-12934759659,2390.813149480693,2162.8290923902155,227.98405709047756,0.7693590668379106,0.7692827128227198,-1223
2054,2022-08-17,2022,287994,287994,679774796.4999996,4549609.933333331,221069,0,73,0.8914664888851862,73359116,15264979760,289641,289641,80035,369676,618625735.1833401,4543947.983335307,222506,0,73,0.702631493524056,13019204691,-1647,-1647,61149061.31665957,5661.94999802392,-1437,0,0,0.18883499536113024,-12945845575,2360.3783290624096,2135.8362082140998,224.54212084830988,0.7676166864587457,0.7682130637582386,-1437
2055,2022-08-18,2022,286920,286920,680810990.516667,4576926.633333329,221806,0,61,0.8984351038617029,73966457,15284516360,288676,288676,80321,368997,619776677.2333332,4570725.066668675,223409,0,62,0.7075829884795802,13042395452,-1756,-1756,61034313.28333378,6201.56666465383,-1603,0,-1,0.19085211538212266,-12968428995,2372.82514469771,2146.9629523525796,225.86219234513055,0.7730586923184163,0.7739091576715764,-1603
2056,2022-08-19,2022,287597,287597,681237712.6666664,4523310.683333334,221711,0,52,0.8910002538274039,73785484,15297929873,289341,289341,83118,372459,620372994.2833403,4517116.983335188,223302,0,55,0.6966753387621114,13066440435,-1744,-1744,60864718.38332605,6193.699998145923,-1591,0,-3,0.19432491506529248,-12992654951,2368.7232921993846,2144.0894801750887,224.63381202429582,0.770908597794831,0.7717606561116468,-1591
2057,2022-08-20,2022,284494,284494,681325262.1166662,4529618.050000005,221242,0,49,0.8994565790491187,73963167,15308069791,286294,286294,85915,372209,620546735.9000049,4523669.100001879,222762,0,50,0.6954426142301762,13077574791,-1800,-1800,60778526.216661334,5948.949998126365,-1520,0,-1,0.20401396481894252,-13003611624,2394.866893912231,2167.515686322469,227.351207589762,0.7776684218296344,0.778088258922646,-1520
2058,2022-08-21,2022,282589,282589,681707830.0333334,4494206.700000003,220482,0,50,0.9027138352872901,74127431,15317610511,284407,284407,81527,365934,621095660.2166678,4488149.733335185,222080,0,52,0.7055315985943028,13093465304,-1818,-1818,60612169.81666565,6056.9666648181155,-1598,0,-2,0.1971822366929873,-13019337873,2412.3650603290766,2183.826910788651,228.53814954042582,0.7802214523566027,0.7808527919495653,-1598
2059,2022-08-22,2022,281228,281228,682620386.5166659,4490234.466666665,217418,0,58,0.899088995405863,74417247,15339647632,283029,283029,83605,366634,622149295.2666758,4484843.183334988,218936,0,58,0.6976603370118291,13119684444,-1801,-1801,60471091.249990106,5391.283331677318,-1518,0,0,0.2014286583940339,-13045267197,2427.2845752082508,2198.182148354677,229.1024268535739,0.7731022515538993,0.7735461737136478,-1518
2060,2022-08-23,2022,278877,278877,682879103.1500002,4443657.416666662,214509,0,47,0.8934225482918993,73149625,15354116209,280763,280763,80203,360966,622557374.466667,4437635.516668121,216071,0,49,0.6986198146085605,13141077655,-1886,-1886,60321728.68333316,6021.89999854099,-1562,0,-2,0.19480273368333878,-13067928030,2448.6748751241594,2217.3768426276506,231.29803249650877,0.769188567002657,0.7695850236676485,-1562
2061,2022-08-24,2022,274395,274395,682528502.8500001,4413204.966666663,212664,0,51,0.8949397765994284,73131915,15358419415,276143,276143,81004,357147,622222461.0333204,4407959.716668047,213989,0,51,0.6949071390771601,13151759698,-1748,-1748,60306041.816679716,5245.249998616055,-1325,0,0,0.2000326375222683,-13078627783,2487.3940955556777,2253.2617558052184,234.13233975045932,0.7750286995025419,0.7749209648624082,-1325
2062,2022-08-25,2022,281084,281084,682374687.6166679,4431609.349999996,218559,0,55,0.8961520399595846,73128555,15362138229,282170,282170,78497,360667,622234075.6499912,4425350.816668095,219501,0,59,0.7043782769147066,13166237977,-1086,-1086,60140611.96667671,6258.533331900835,-942,0,-4,0.19177376304487803,-13093109422,2427.653966845028,2205.174453875292,222.47951296973633,0.7775575984403239,0.7779033915724564,-942
2063,2022-08-26,2022,288611,288611,680904387.433333,4472928.250000003,223408,0,47,0.8834382611889356,73139012,15331882883,290060,290060,80758,370818,621848968.2499998,4467036.700001633,224760,0,47,0.6948206397747698,13161480724,-1449,-1449,59055419.18333328,5891.549998369999,-1352,0,0,0.18861762141416583,-13088341712,2359.2461390360486,2143.8632291594836,215.382909876565,0.7740799900211703,0.774874163966076,-1352
2064,2022-08-27,2022,284825,284825,680314803.033333,4525703.416666668,220625,0,50,0.8866988501711575,73852030,15327481873,286608,286608,86655,373263,621532640.2333267,4519634.066668446,222292,0,50,0.6851388967028548,13166802062,-1783,-1783,58782162.80000627,6069.349998221733,-1667,0,0,0.2015599534683027,-13092950032,2388.5361293191713,2168.5809196998225,219.9552096193488,0.7745984376371456,0.7755959359124658,-1667
2065,2022-08-28,2022,282179,282179,680594362.2666674,4451358.799999995,217394,0,61,0.880607699368131,73324343,15339655092,283850,283850,82361,366211,621830744.0333285,4445058.216668158,218813,0,61,0.6854490990166798,13180223250,-1671,-1671,58763618.23333883,6300.583331837319,-1419,0,0,0.19515860035145116,-13106898907,2411.9242121726543,2190.7019342375497,221.22227793510456,0.7704116890342655,0.7708754623921085,-1419
2066,2022-08-29,2022,286500,286500,681101555.649999,4487917.016666664,216434,0,38,0.8694938917975572,73345081,15364469306,288234,288233,85955,374189,622355026.8500217,4482225.550000064,217994,0,38,0.6741700049974684,13193056804,-1734,-1733,58746528.7999773,5691.466666599736,-1560,0,0,0.19532388680008883,-13119711723,2377.3178207678848,2159.2080950134846,218.1097257544002,0.7554415357766143,0.7563091099592693,-1560
2067,2022-08-30,2022,286086,286086,681549258.6166657,4501495.616666666,215359,0,43,0.8703956153044883,73513806,15373425638,287850,287850,83760,371610,622999107.5500001,4495371.433335032,216698,0,43,0.6776190091763012,13217173688,-1764,-1764,58550151.06666565,6124.183331633918,-1339,0,0,0.19277660612818703,-13143659882,2382.323002931516,2164.318594927914,218.00440800360184,0.7527771369448347,0.7528157026228939,-1339
2068,2022-08-31,2022,286244,286244,682082642.2833339,4474891.566666668,216656,0,71,0.8756410614720304,73210380,15389757105,287978,287978,86557,374535,623627704.0500003,4468803.216668287,218110,0,71,0.6764788337538639,13233344768,-1734,-1734,58454938.23333359,6088.349998380989,-1454,0,0,0.1991622277181665,-13160134388,2382.8714044078965,2165.539395544105,217.33200886379154,0.7568927208954598,0.7573842446297981,-1454
2069,2022-09-01,2022,287892,287892,681937257.3499997,4518696.966666668,217126,0,105,0.8681936281661172,73978589,15401097187,289470,289470,89074,378544,623588307.4999918,4513278.500001804,218387,0,105,0.6667177395494287,13253938385,-1578,-1578,58348949.85000789,5418.46666486375,-1261,0,0,0.20147588861668853,-13179959796,2368.7259713712074,2154.2415708017816,214.48440056942582,0.7541925444263821,0.7544374201126196,-1261
2070,2022-09-02,2022,283548,283548,682126009.0166663,4515067.650000003,217424,0,48,0.8804964238859032,73142706,15414967865,284935,284935,86772,371707,623914054.9833301,4509360.183335253,218520,0,38,0.6773399478621616,13270427985,-1387,-1387,58211954.03333616,5707.466664750129,-1096,0,10,0.20315647602374165,-13197285279,2405.6809041737774,2189.671521516592,216.0093826571856,0.7667978613850213,0.7669117518030428,-1096
2071,2022-09-03,2022,277498,277498,682228454.5333339,4489977.533333331,213474,0,54,0.8923667918327345,73117909,15427226510,279034,279034,82758,361792,624049360.4833277,4484348.216666723,214833,0,51,0.6913972669379007,13285362380,-1536,-1536,58179094.05000615,5629.316666608676,-1359,0,3,0.20096952489483377,-13212244471,2458.4986361463284,2236.463515139115,222.03512100721355,0.7692812200448291,0.7699169276862318,-1359
2072,2022-09-04,2022,274028,274028,682566528.6166668,4423098.883333336,211545,0,74,0.9009225334637331,73028329,15441459357,275585,275585,80381,355966,624503456.5833308,4416960.266668287,212957,0,45,0.701190563143646,13305683998,-1557,-1557,58063072.03333604,6138.616665048525,-1412,0,29,0.19973197032008705,-13232655669,2490.864176714302,2266.1010453519993,224.76313136230283,0.7719831550060577,0.7727452510114846,-1412
2073,2022-09-05,2022,271327,271327,682295323.1999992,4369896.299999993,206615,0,50,0.8905858981966407,71503645,15449703894,273042,273042,83570,356612,624323937.4833364,4364246.966667811,208135,0,50,0.6859976669321136,13329862464,-1715,-1715,57971385.716662765,5649.333332181908,-1520,0,0,0.20458823126452708,-13258358819,2514.660624265183,2286.5490931187746,228.1115311464082,0.7614981185064517,0.7622819932464603,-1520
2074,2022-09-06,2022,291863,291863,682333923.8000009,4555018.416666661,220681,0,49,0.8847507220853625,72739613,15453222138,293751,293750,76462,370213,624374446.9999903,4548776.333335436,222207,0,47,0.7060448984773731,13340763663,-1888,-1887,57959476.80001056,6242.08333122544,-1526,0,2,0.17870582360798948,-13268024050,2337.85688422308,2125.5300323403926,212.3268518826876,0.7561116003056229,0.7564467865641309,-1526
2075,2022-09-07,2022,291547,291547,682766739.1333331,4627701.766666664,222320,0,62,0.8888309603597355,73344260,15468142263,293606,293606,82851,376457,624832846.8166662,4621756.650002319,223969,0,34,0.6962946631354986,13329734191,-2059,-2059,57933892.31666684,5945.116664344445,-1649,0,28,0.19253629722423693,-13256389931,2341.8753721812714,2128.133780701574,213.7415914796975,0.7625528645467111,0.7628216044631241,-1649
2076,2022-09-08,2022,289899,289899,683346358.9500008,4592870.933333327,219751,0,40,0.8795304571592174,72832605,15476368551,291956,291956,84112,376068,625475519.8666657,4586703.18333551,221405,0,41,0.6870113915568457,13344290716,-2057,-2057,57870839.08333504,6167.74999781698,-1654,0,-1,0.19251906560237175,-13271458111,2357.18770658057,2142.3622733105867,214.82543326998348,0.7580260711489174,0.7583505733740701,-1654
2077,2022-09-09,2022,287832,287832,683553517.5666668,4556083.116666671,221948,0,63,0.8931043108479945,73003443,15482219384,289836,289835,84339,374175,625770764.1000032,4551065.416668821,223648,0,63,0.6956584485868886,13364296485,-2004,-2003,57782753.4666636,5017.699997849762,-1700,0,0,0.19744586226110583,-13291293042,2374.835034209771,2159.05865095659,215.77638325318094,0.7711025876205564,0.7716363736733877,-1700
2078,2022-09-10,2022,287041,287041,683125009.2333336,4593879.333333336,221972,0,45,0.8993175191000585,74407970,15487818317,289130,289130,83797,372927,625470097.2999963,4588202.650002154,223784,0,39,0.7028024251394943,13371158287,-2089,-2089,57654911.93333733,5676.6833311822265,-1812,0,6,0.1965150939605642,-13296750317,2379.8865292182427,2163.2832888320004,216.6032403862423,0.773311129768918,0.7739909383322381,-1812
2079,2022-09-11,2022,295558,295558,683790364.800001,4655110.383333328,227531,0,60,0.8976546058641621,74898871,15506578532,297713,297713,82083,379796,626365461.7666603,4648957.533336107,229269,0,60,0.7081222551053774,13391916385,-2155,-2155,57424903.03334069,6152.849997221492,-1738,0,0,0.18953235075878472,-13317017514,2313.557287571309,2103.9237848755693,209.63350269573994,0.7698353622639211,0.7701007346001014,-1738
2080,2022-09-12,2022,290836,290836,684839412.816667,4601080.333333327,221709,0,46,0.8899414102793326,73900436,15538143128,292715,292715,87966,380681,627490607.6999959,4595171.983335528,223238,0,36,0.6883926437095508,13415900278,-1879,-1879,57348805.116671085,5908.349997799844,-1529,0,10,0.20154876656978182,-13341999842,2354.727106742862,2143.691330133392,211.03577660946985,0.7623162194501368,0.7626462600140068,-1529
2081,2022-09-13,2022,282541,282541,684279055.1,4495583.599999997,214633,0,57,0.8880268704365039,72242898,15536082395,284268,284268,87231,371499,627179631.2666612,4490339.033335019,216062,0,42,0.6834042621918083,13431352255,-1727,-1727,57099423.83333886,5244.5666649779305,-1429,0,15,0.20462260824469558,-13359109357,2421.875250317653,2206.296984770221,215.57826554743178,0.7596525813952665,0.7600644462268,-1429
2082,2022-09-14,2022,271512,271512,683355479.4333335,4388098.049999997,206393,0,44,0.8859571584313018,72129713,15540491477,273052,273052,85842,358894,626402110.2166864,4382471.450000009,207820,0,44,0.6774395782598895,13445978418,-1540,-1540,56953369.21664715,5626.599999988452,-1427,0,0,0.2085175801714123,-13373848705,2516.8518497647747,2294.076257330788,222.77559243398673,0.7601616134830136,0.7611004497311867,-1427
2083,2022-09-15,2022,280007,280007,683346183.9833337,4449912.633333331,213261,0,73,0.8810529736756578,70676944,15551277485,281623,281623,78778,360401,626608112.2000028,4444239.349999448,214679,0,61,0.6920458045343914,13456057142,-1616,-1616,56738071.78333092,5673.2833338826895,-1418,0,12,0.18900716914126647,-13385380198,2440.4610741279103,2224.989124467827,215.47194966008328,0.7616273878867315,0.7622921423321248,-1418
2084,2022-09-16,2022,293829,293829,683514578.0333334,4628581.51666667,225151,0,109,0.8995742421612568,73421082,15546794346,295583,295583,79869,375452,626911649.3166504,4622548.816669049,226483,0,109,0.7103997315236078,13464471322,-1754,-1754,56602928.71668303,6032.699997621588,-1332,0,0,0.189174510637649,-13391050240,2326.2325299181953,2120.9326967946413,205.29983312355398,0.7662654128761966,0.766224715223812,-1332
2085,2022-09-17,2022,286102,286102,683428669.3333346,4606835.199999999,221940,0,113,0.9065543058070196,73205647,15552560938,288002,288002,85241,373243,626881677.816662,4600217.8833356295,223755,0,113,0.7040560707099831,13471503918,-1900,-1900,56546991.51667261,6617.316664369777,-1815,0,0,0.20249823509703646,-13398298271,2388.7587969791703,2176.6573767427376,212.10142023643266,0.7757373244507204,0.776921688043833,-1815
2086,2022-09-18,2022,275139,275139,683828760.983333,4406657.600000002,211908,0,220,0.9002685915119264,71023984,15571171697,276755,276755,86922,363677,627282154.6666626,4400413.883334592,213497,0,222,0.6893479653648794,13483682206,-1616,-1616,56546606.31667042,6243.716665410437,-1589,0,-2,0.21092062614704699,-13412658222,2485.3937863528363,2266.561235268243,218.83255108459343,0.7701852518181719,0.771429603801196,-1589
2087,2022-09-19,2022,271594,271594,683897817.2666664,4347763.533333336,208559,0,67,0.8938378609247633,70903870,15589749592,273138,273138,87024,360162,627512030.8000042,4341999.616667845,209837,0,70,0.6813600546420941,13511553169,-1544,-1544,56385786.46666217,5763.916665490717,-1278,0,-3,0.2124778062826691,-13440649299,2518.0888284228163,2297.417535458282,220.67129296453413,0.7679072439008225,0.7682453558274572,-1278
2088,2022-09-20,2022,289560,289560,684180579.2833323,4587906.266666662,224460,0,56,0.9058468020444805,72804672,15601321815,291706,291706,79228,370934,627915246.3499992,4581877.86666885,226276,0,56,0.7170601778214059,13529055087,-2146,-2146,56265332.93333316,6028.3999978117645,-1816,0,0,0.18878662422307468,-13456250415,2362.8283577957327,2152.5619848408987,210.26637295483397,0.775176129299627,0.7756988200448397,-1816
2089,2022-09-21,2022,287482,287482,684987622.8333331,4430382.283333338,219952,0,69,0.8892730675311837,70788132,15617621404,289281,289281,79099,368380,628840431.1833344,4424642.450001043,221560,0,53,0.7025082794939992,13539778980,-1799,-1799,56147191.649998784,5739.833332294598,-1608,0,16,0.18676478803718455,-13468990848,2382.714823304879,2173.804816712243,208.9100065926359,0.7650983365915084,0.7658989010685112,-1608
2090,2022-09-22,2022,284736,284736,684626150.8833326,4206023.200000001,215444,0,57,0.8798465947403914,69521589,15626583107,286064,286064,95077,381141,628607819.7833378,4201252.916667107,216392,0,49,0.6618784124510341,13558885904,-1328,-1328,56018331.09999478,4770.283332894556,-948,0,8,0.21796818228935733,-13489364315,2404.4242768154804,2197.4377054901624,206.98657132531798,0.7566447516295797,0.7564461099614073,-948
2091,2022-09-23,2022,291474,291474,684941863.8000002,4542516.200000001,221928,0,47,0.8881375354233999,71894127,15630989422,293283,293283,87566,380849,628993066.9333333,4536472.433335321,223418,0,38,0.6863927698378944,13568388601,-1809,-1809,55948796.86666691,6043.7666646800935,-1490,0,9,0.20174476558550547,-13496494474,2349.9243973733514,2144.6625509604487,205.26184641290274,0.7613989583976616,0.761782987762673,-1490
2092,2022-09-24,2022,287474,287474,684991887.5333332,4622899.549999995,220725,0,43,0.8980986106569648,72305928,15632814898,297885,297885,86697,384582,629122858.766661,4629579.550002494,226987,0,44,0.6933631839243423,13574090711,-10411,-10411,55869028.766672134,-6680.0000024987385,-6262,0,-1,0.20473542673262257,-13501784783,2382.795966011998,2111.965553037787,270.8304129742114,0.7678085670356276,0.761995400909747,-6262
2093,2022-09-25,2022,291697,291697,685221291.383333,4525439.999999997,223385,0,53,0.8862518298096999,70030875,15639185685,298554,298554,88709,387263,628158370.8499981,4525003.950001917,227682,0,43,0.6857871782225461,13537239677,-6857,-6857,57062920.53333485,436.0499980803579,-4297,0,10,0.20046465158715376,-13467208802,2349.0858369586695,2104.002528353323,245.08330860534625,0.7658117841458774,0.7626158081955023,-4297
2094,2022-09-26,2022,286708,286708,685666921.1666662,4557364.449999996,217973,0,51,0.8841887913835687,72062485,15657105137,288558,288558,92543,381101,627049720.9666655,4551126.483335405,219519,0,41,0.6731732532845711,13483808815,-1850,-1850,58617200.200000644,6237.966664591804,-1546,0,10,0.21101553809899753,-13411746330,2391.5165295934057,2173.045699535849,218.47083005755667,0.7602613111597862,0.7607448069365604,-1546
2095,2022-09-27,2022,282097,282097,685999466.9333329,4548453.3166666655,213748,0,50,0.8863086101589168,71868056,15666534825,284072,284072,81098,365170,627509801.2333292,4542435.3000020785,215437,0,50,0.6937700249198905,13495612237,-1975,-1975,58489665.70000374,6018.016664586961,-1689,0,0,0.19253858523902634,-13423744181,2431.7857578539756,2208.9815301519657,222.80422770200994,0.757711000116981,0.7583887183530936,-1689
2096,2022-09-28,2022,287195,287195,686816692.7000005,4598492.866666671,218087,0,69,0.8859485715280556,72210829,15681528799,289272,289272,78054,367326,628340563.4999993,4593018.100002429,219955,0,58,0.7023597567283514,13515198772,-2077,-2077,58476129.20000124,5474.766664241441,-1868,0,11,0.18358881479970424,-13442987943,2391.4646588554833,2172.144429810003,219.32022904548012,0.7593690697957833,0.7603743189800602,-1868
2097,2022-09-29,2022,290362,290362,686981215.7000004,4583286.150000008,221012,0,59,0.8857495126772797,72572027,15683977331,292471,292471,79687,372158,628667582.7333354,4577557.566668751,222740,0,40,0.7000951208895111,13527329143,-2109,-2109,58313632.96666503,5728.583331257105,-1728,0,19,0.18565439178776866,-13454757116,2365.94738877677,2149.5039943561424,216.44339442062756,0.7611602069141279,0.7615797805594401,-1728
2098,2022-09-30,2022,293244,293244,687234487.8833326,4611881.850000002,223246,0,45,0.8842977179413726,73851009,15685363118,295277,295272,83044,378321,629071294.199996,4605459.216668974,224971,0,51,0.6943495074288691,13538743588,-2033,-2028,58163193.683336616,6422.633331028745,-1725,0,-6,0.18994821051250343,-13464892579,2343.5585651652978,2130.480689669173,213.07787549612476,0.7612977588629264,0.7618981498728312,-1725
2099,2022-10-01,2022,287084,287084,687046661.8333338,4558450.383333331,219724,0,47,0.8874406097170162,74052100,15691071876,289217,289215,85336,374553,628987607.449996,4551620.833335536,221581,0,47,0.6903909460076675,13546740540,-2133,-2131,58059054.383337855,6829.549997795373,-1857,0,0,0.19704966370934873,-13472688440,2393.1903618220936,2174.80976937571,218.38059244638362,0.7653648409524738,0.7661409944781946,-1857
2100,2022-10-02,2022,275261,275261,686553902.7833327,4443402.8999999985,210683,0,41,0.8902060226475965,72219339,15701546916,277333,277333,86809,364142,628577994.7833322,4437240.9666682705,212573,0,41,0.6833625343959283,13564973332,-2072,-2072,57975908.00000048,6161.933331727982,-1890,0,0,0.2068434882516682,-13492753993,2494.192431122944,2266.5099168989345,227.68251422400954,0.765393571919015,0.7664901039544518,-1890
2101,2022-10-03,2022,274551,274551,686954382.949999,4396371.599999994,208492,0,69,0.8851943719017603,72134570,15723892990,276698,276698,81866,358564,629031599.3999987,4391414.516668092,210384,0,69,0.688412668310255,13587812939,-2147,-2147,57922783.55000031,4957.08333190158,-1892,0,0,0.19678170359150526,-13515678369,2502.1011868468845,2273.3507267851546,228.75046006172988,0.759392608294998,0.7603379858184736,-1892
2102,2022-10-04,2022,269454,269454,686807252.8500001,4318697.0666666655,205568,0,47,0.8917737350345506,71097024,15730178377,286841,286841,80627,367468,629040256.8166595,4333387.266667694,216159,0,39,0.688596013802567,13605084802,-17387,-17387,57766996.03334069,-14690.200001028366,-10591,0,8,0.20317772123198363,-13533987778,2548.8849779554216,2192.992831626788,355.89214632863377,0.7629057278793412,0.7535847385833964,-10591
2103,2022-10-05,2022,274826,274826,686611583.0999995,4398525.666666663,209891,0,69,0.8925611113941188,71164767,15738330168,276948,276948,87946,364894,613395050.7833395,4392041.283334761,211568,0,50,0.6809731045179952,13052415365,-2122,-2122,73216532.31666005,6484.383331902325,-1677,0,19,0.21158800687612356,-12981250598,2498.3501673786304,2214.8383479329677,283.5118194456627,0.7637232285154971,0.7639268021433626,-1677
2104,2022-10-06,2022,278624,278624,687146409.8833342,4501558.583333328,213338,0,57,0.8979664350522568,70722464,15741718455,280764,280764,75926,356690,614097117.4333388,4494657.816668472,215009,0,43,0.7115562533292171,13059898245,-2140,-2140,73049292.4499954,6900.7666648561135,-1671,0,14,0.1864101817230397,-12989175781,2466.214001246605,2187.235961281855,278.9780399647502,0.7656842195934306,0.7657997464062344,-1671
2105,2022-10-07,2022,279241,279241,687737108.2666658,4454352.700000003,212761,0,50,0.8946107484216143,70857509,15746148714,313398,313398,75956,389354,614871056.8166546,4488523.966668335,232773,0,51,0.7030542899263782,13071197492,-34157,-34157,72866051.45001125,-34171.26666833181,-20012,0,-1,0.19155645849523606,-13000339983,2462.8801224271,1961.9495236620992,500.9305987650009,0.7619260781905236,0.7427392644496774,-20012
2106,2022-10-08,2022,276943,276943,687577491.8166667,4417206.01666666,212298,0,146,0.8984159195213458,70481375,15744750316,278779,278779,91936,370715,582145828.599992,4411080.6500013955,213747,0,146,0.6786722954291128,11850997241,-1836,-1836,105431663.21667469,6125.366665264592,-1449,0,0,0.21974362409223303,-11780515866,2482.740101091801,2088.198281075662,394.5418200161389,0.7665765157451172,0.7667256141961912,-1449
2107,2022-10-09,2022,260539,260539,687213716.2666671,4225571.3999999985,200273,0,91,0.8925957342278887,69689742,15752575126,262205,262205,83340,345545,581914514.3833482,4219769.566666361,201757,0,92,0.6805191798463393,11842720766,-1666,-1666,105299201.8833189,5801.833333637565,-1484,0,-1,0.2120765543815495,-11773031024,2637.661602549588,2219.3112808045166,418.3503217450716,0.7686872214908325,0.7694628248889228,-1484
2108,2022-10-10,2022,282763,282763,687554692.2333325,4376768.600000003,221260,0,57,0.9169304329067098,71102916,15771457674,284314,284314,84732,369046,582404070.7833326,4371574.616667788,222535,0,48,0.7087951095527439,11860650265,-1551,-1551,105150621.44999993,5193.983332215808,-1275,0,9,0.2081353233539659,-11789547349,2431.5582032774178,2048.453719420544,383.1044838568737,0.7824927589536114,0.7827085546262231,-1275
2109,2022-10-11,2022,273668,273668,687536330.1166657,4403786.516666667,207818,0,55,0.8949310843796138,68717221,15771292949,275504,275504,85855,361359,582441323.699995,4397082.216667997,209433,0,56,0.6863202521592087,11873869886,-1836,-1836,105095006.41667068,6704.299998669885,-1615,0,-1,0.2086108322204051,-11805152665,2512.3007809340725,2114.0938922846676,398.20688864940485,0.7593799786602745,0.760181340379813,-1615
2110,2022-10-12,2022,276489,276489,687961221.8333337,4436862.033333338,208501,0,46,0.8870153966342242,68920396,15779237488,278408,278408,79727,358135,583047201.6166643,4431173.050001589,210145,0,41,0.6931966995686013,11887409904,-1919,-1919,104914020.21666944,5688.983331749216,-1644,0,5,0.19381869706562294,-11818489508,2488.204673000856,2094.218562744836,393.98611025601986,0.7541023331850454,0.7548094882330968,-1644
2111,2022-10-13,2022,289424,289424,688993605.0666664,4484152.41666667,222234,0,60,0.9016356625573549,70989771,15796501982,291237,291237,73789,365026,584286780.9999912,4476964.766668359,223814,0,49,0.7233210784985203,11905095609,-1813,-1813,104706824.06667519,7187.649998310953,-1580,0,11,0.1783145840588346,-11834105838,2380.568318683545,2006.2244186006283,374.34390008291666,0.7678492453977556,0.7684943877323279,-1580
2112,2022-10-14,2022,271509,271509,688886443.6666662,4305732.050000004,207123,0,75,0.8896979473976919,69202509,15803711398,273322,273322,87371,360693,584407962.4333365,4299654.216667662,208649,0,76,0.677892279584036,11918054776,-1813,-1813,104478481.23332965,6077.833332341164,-1526,0,-1,0.21180566781365595,-11848852267,2537.2508597013953,2138.1665670284006,399.0842926729947,0.7628586897671901,0.763381652409978,-1526
2113,2022-10-15,2022,259584,259584,688418865.1000005,4226839.233333333,195692,0,48,0.8764330621301767,70054623,15809320804,261277,261277,84050,345327,584124659.9999942,4220913.133333113,197243,0,34,0.6669475598490554,11941093236,-1693,-1693,104294205.10000634,5926.100000220351,-1551,0,14,0.20948550228112128,-11871038613,2652.008078695145,2235.6528129150065,416.3552657801383,0.7538677268244576,0.7549191088385124,-1551
2114,2022-10-16,2022,246888,246888,687567314.0666662,4026982.4000000036,187018,0,75,0.8802574446712668,68393994,15815718726,248127,248127,79179,327306,583504180.4333427,4021137.8666663226,188224,0,75,0.6703237948586331,11954288606,-1239,-1239,104063133.63332355,5844.533333681058,-1206,0,0,0.20993364981263363,-11885894612,2784.9361413542424,2351.635172445331,433.3009689089113,0.757501377142672,0.7585792759353073,-1206
2115,2022-10-17,2022,270713,270713,687176540.4833336,4270563.23333333,211220,0,96,0.9037504663610543,71348366,15830551727,271905,271905,80036,351941,583216562.5166457,4265797.366666429,212219,0,96,0.7012510619677633,11979371496,-1192,-1192,103959977.96668792,4765.866666900925,-999,0,0,0.20249940439329095,-11908023130,2538.395054848986,2144.9276862015986,393.4673686473875,0.7802358955794513,0.7804895092035822,-999
2116,2022-10-18,2022,288486,288486,688293163.083334,4798984.099999999,226814,0,53,0.9231539832088899,76036638,15845961088,289946,289946,65177,355123,584735780.8833276,4793072.98333625,228118,0,42,0.7570025033579866,11997070667,-1460,-1460,103557382.20000637,5911.116663748398,-1304,0,11,0.16615147985090328,-11921034029,2385.880642677059,2016.705803436942,369.17483924011685,0.7862218617194595,0.7867602932959931,-1304
2117,2022-10-19,2022,299088,299088,690025500.3000003,4901689.516666667,236547,0,46,0.9300540309206655,76569017,15875189668,300647,300647,70651,371298,586577259.4333262,4895488.250003478,238010,0,39,0.7560477029232552,12025529665,-1559,-1559,103448240.86667407,6201.266663189046,-1463,0,7,0.17400632799741034,-11948960648,2307.098580685284,1951.0497674459623,356.0488132393218,0.790894318728936,0.7916593213968541,-1463
2118,2022-10-20,2022,339698,339698,691220244.5499988,5128549.399999997,285329,0,177,1.1751997362363034,92353333,15899950381,350345,350343,75002,425347,588047253.2833258,5119576.150003632,295522,0,42,1.0788532656866059,12072692647,-10647,-10645,103172991.26667297,8973.249996365048,-10193,0,135,0.09634647054969747,-11980339314,2034.8081076426672,1678.4900890936192,356.318018549048,0.8399490135355522,0.843517104568354,-10193
2119,2022-10-21,2022,381554,381554,693438579.5000005,5541238.833333326,325280,0,231,1.3354492417849098,102143936,15942808691,400827,400827,88537,489364,590441641.8166581,5530374.250005507,344125,0,56,1.3652046329521537,12126358393,-19273,-19273,102996937.68334234,10864.583327818662,-18845,0,175,-0.029755391167243905,-12024214457,1817.4061325526675,1473.0585559771625,344.34757657550495,0.8525136677901424,0.8585374737729744,-18845
2120,2022-10-22,2022,382864,382864,695139906.7333342,5574012.866666668,324190,0,195,1.290980609302521,101569894,15985620841,401200,401200,117155,518355,592286275.783318,5562239.1833390305,342167,0,78,1.2361354670062332,12177575069,-18336,-18336,102853630.95001614,11773.683327637613,-17977,0,117,0.054845142296287674,-12076005175,1815.6314167258718,1476.286828971381,339.3445877544907,0.8467497597057964,0.8528589232303091,-17977
2121,2022-10-23,2022,367879,367879,695963574.4166669,5486050.183333333,314178,0,184,1.296265891774197,103016051,16021380047,384636,384636,128908,513544,593239869.616561,5474061.016666665,330780,0,49,1.205727259981629,12225429567,-16757,-16757,102723704.80010581,11989.166666667908,-16602,0,135,0.09053863179256783,-12122413516,1891.8274063392225,1542.3409915259128,349.4864148133097,0.8540253724730142,0.8599819049698936,-16602
2122,2022-10-24,2022,375390,375390,697227623.8500005,5505957.500000003,323136,0,189,1.3125309677934967,104478610,16071107959,392371,392371,123254,515625,594623516.1332314,5493853.14999994,339787,0,96,1.222239030303047,12278585841,-16981,-16981,102604107.7167691,12104.350000062957,-16651,0,93,0.09029193749044961,-12174107231,1857.3420278909948,1515.4624478700807,341.8795800209141,0.8608007672021099,0.8659839794480224,-16651
2123,2022-10-25,2022,382755,382755,698553175.6333336,5612963.333333332,327035,0,171,1.315528209951536,104491168,16108888539,401301,401301,118497,519798,596155964.3666716,5600786.10000569,345161,0,45,1.26389289685605,12321772352,-18546,-18546,102397211.266662,12177.233327642083,-18126,0,126,0.05163531309548586,-12217281184,1825.0661013790377,1485.5581330888076,339.5079682902301,0.8544238481535186,0.8601050084599839,-18126
2124,2022-10-26,2022,398267,398267,699856624.7499998,5825561.849999999,342130,0,196,1.3707462581634928,103942580,16143866394,417404,417404,118939,536343,597655886.1333181,5814488.133339814,360872,0,55,1.3031828512723873,12365140356,-19137,-19137,102200738.6166817,11073.716660184786,-18742,0,141,0.06756340689110552,-12261197776,1757.2548685931793,1431.8403420506704,325.41452654250884,0.8590468203491628,0.8645628695460513,-18742
2125,2022-10-27,2022,376907,376907,699724300.816667,5131288.64999999,315952,0,191,1.2794853902952181,99014408,16171753287,394414,394414,131935,526349,597630192.7499508,5119091.916665967,333423,0,86,1.192877729415287,12400755516,-17507,-17507,102094108.0667162,12196.733334023505,-17471,0,105,0.0866076608799311,-12301741108,1856.4905953369584,1515.235749111215,341.25484622574345,0.8382757550271022,0.8453629942142014,-17471
2126,2022-10-28,2022,344598,344598,695773684.8166659,4951698.633333332,287917,0,159,1.2717630398319169,95860385,16154457743,359801,359801,150028,509829,593742372.7833015,4940575.433332703,302782,0,67,1.0513740881746336,12415434306,-15203,-15203,102031312.03336442,11123.200000628829,-14865,0,92,0.22038895165728323,-12319573921,2019.0879947552392,1650.1965608302964,368.8914339249427,0.8355155862773435,0.8415262881426122,-14865
2127,2022-10-29,2022,355133,355133,695099420.9833338,5188980.700000007,298763,0,152,1.2705746861035165,101390506,16166151695,372208,372208,133965,506173,593029977.566672,5177767.733337648,315588,0,67,1.1232226926366706,12429172870,-17075,-17075,102069443.41666186,11212.966662358493,-16825,0,85,0.1473519934668459,-12327782364,1957.2932422031572,1593.2757425059965,364.0174996971607,0.8412707351893516,0.8478807548467524,-16825
2128,2022-10-30,2022,337500,337500,694750139.6833335,5199245.483333339,284937,0,146,1.2318370370370357,101603140,16183531119,352846,352846,115033,467879,593201607.13331,5189157.166665934,299741,0,139,1.0970913419922632,12431296176,-15346,-15346,101548532.55002356,10088.316667404957,-14804,0,7,0.13474569504477252,-12329693036,2058.518932395062,1681.1912481176207,377.32768427744145,0.8442577777777778,0.8494952472183332,-14804
2129,2022-10-31,2022,337746,337746,695127337.0333328,5195056.7166666705,286822,0,165,1.2414654799760758,103109655,16215438231,352454,352454,106004,458458,593704668.4666727,5184763.200004649,301054,0,122,1.122207486836341,12466692380,-14708,-14708,101422668.56666017,10293.516662021168,-14232,0,43,0.11925799313973484,-12363582725,2058.1364014180267,1684.4883827866124,373.6480186314143,0.8492239730448325,0.8541653662605616,-14232
2130,2022-11-01,2022,333206,333206,695449625.4333335,5205913.133333336,284060,0,159,1.2594581129991642,101019360,16240134389,347279,347279,103861,451140,594342393.1333245,5196342.833332725,297679,0,68,1.151930664538675,12511533273,-14073,-14073,101107232.30000901,9570.300000610761,-13619,0,91,0.10752744846048912,-12410513913,2087.1461661354642,1711.4262398052417,375.7199263302225,0.8525056571610355,0.8571753546860017,-13619
2131,2022-11-02,2022,354911,354911,696105594.4833336,5370155.633333326,302736,0,165,1.266675307330571,101054258,16272842665,371103,371103,94758,465861,595037134.6333399,5359629.766671681,318539,0,69,1.2131000448631568,12550884947,-16192,-16192,101068459.8499937,10525.866661645472,-15803,0,96,0.053575262467414175,-12449830689,1961.352548901932,1603.4285215515365,357.9240273503956,0.8529913133151692,0.8583573832601731,-15803
2132,2022-11-03,2022,369149,369149,695502066.9666682,5449409.999999998,313427,0,165,1.2776439865745288,101074960,16282421925,385368,385368,104583,489951,594783460.8166766,5438549.366671723,329287,0,55,1.2116783106882105,12577311704,-16219,-16219,100718606.14999163,10860.633328274824,-15860,0,110,0.0659656758863183,-12476236744,1884.0686740765063,1543.4168400507479,340.6518340257585,0.8490528214894256,0.854474164954018,-15860
2133,2022-11-04,2022,362032,362032,694600975.0166672,5315341.466666668,306206,0,163,1.2618663543554183,97462070,16288366671,379754,379754,121915,501669,594254643.9333235,5306780.450004607,323346,0,65,1.1735108208799263,12607864017,-17722,-17722,100346331.08334374,8561.016662060283,-17140,0,98,0.08835553347549197,-12510401947,1918.6176222451807,1564.8410390234824,353.7765832216983,0.8457981614884872,0.8514617357552521,-17140
2134,2022-11-05,2022,384710,384710,694553277.7500007,5582956.183333333,327002,0,195,1.3336045332848099,97596205,16301190961,404282,404282,119872,524154,594417413.2665533,5573037.116666507,345931,0,71,1.288613651713027,12626635211,-19572,-19572,100135864.48344743,9919.066666825674,-18929,0,124,0.04499088157178277,-12529039006,1805.3943951288002,1470.303929600015,335.0904655287852,0.849996100959164,0.8556675785713932,-18929
2135,2022-11-06,2022,402642,402642,695875393.6166658,5862865.666666677,346408,0,229,1.4072178262575687,98463073,16328506539,422035,422035,114280,536315,595239945.9166709,5850701.950006461,365584,0,93,1.3334234544996186,12649210088,-19393,-19393,100635447.69999492,12163.71666021645,-19176,0,136,0.07379437175795012,-12550747015,1728.2732392961138,1410.4042222011703,317.8690170949435,0.8603374710040185,0.8662409515798453,-19176
2136,2022-11-07,2022,396687,396687,696982492.6500005,5677008.833333337,338302,0,219,1.3456705160491764,99063812,16361892141,414340,414340,127159,541499,596627741.2665824,5664955.833333008,355741,0,52,1.2260835200064715,12673873312,-17653,-17653,100354751.38341808,12053.000000328757,-17439,0,167,0.11958699604270495,-12574809500,1757.0086558168039,1439.9472444528224,317.0614113639815,0.8528184689692377,0.8585726697880968,-17439
2137,2022-11-08,2022,396852,396852,697961930.9833335,5850880.249999998,340026,0,200,1.3654410208339645,100763356,16393177574,413588,413588,135173,548761,597781923.5832386,5839387.016666931,356408,0,52,1.2084331794715255,12714902747,-16736,-16736,100180007.40009487,11493.233333067037,-16382,0,148,0.15700784136243895,-12614139391,1758.7461597354518,1445.3560634816256,313.3900962538262,0.8568080795863445,0.8617464723347873,-16382
2138,2022-11-09,2022,395400,395400,699269179.4333333,5854022.583333332,338706,0,213,1.3891274658573605,100844141,16423716714,414117,414117,119096,533213,599315568.3666564,5842187.383339688,357089,0,72,1.3285234981142633,12749379677,-18717,-18717,99953611.06667686,11835.19999364391,-18383,0,141,0.060603967743097176,-12648535536,1768.5108230483897,1447.2131507923036,321.2976722560861,0.8566160849772383,0.8622901257374124,-18383
2139,2022-11-10,2022,389403,389403,699363495.1166668,5661514.93333333,331480,0,185,1.3393451000634313,101659655,16453963072,407370,407370,129580,536950,599616932.4499928,5650276.133339221,349157,0,67,1.2253152062574961,12796032609,-17967,-17967,99746562.66667402,11238.799994109198,-17677,0,118,0.1140298938059352,-12694372954,1795.9889757312264,1471.922165230608,324.06681050061843,0.8512517879934156,0.8571004246753565,-17677
2140,2022-11-11,2022,389441,389441,700114161.0666668,5644435.250000005,333462,0,184,1.3285889261788029,103512371,16496303254,406928,406928,130872,537800,600475088.5665647,5633527.616666571,350507,0,57,1.1935366307177404,12838423780,-17487,-17487,99639072.50010216,10907.63333343342,-17045,0,127,0.13505229546106245,-12734911409,1797.7412780541001,1475.629813054311,322.1114649997892,0.8562580724679734,0.861348936421185,-17045
2141,2022-11-12,2022,362696,362696,699077312.5666668,5409655.666666666,310419,0,176,1.301635529479234,102841097,16524754233,379211,379211,137487,516698,599695893.1998936,5398833.133333086,326773,0,64,1.1381096888317959,12888943310,-16515,-16515,99381419.36677325,10822.53333358001,-16354,0,112,0.16352584064743825,-12786102213,1927.446987467926,1581.4306367692225,346.0163506987035,0.8558655182301431,0.861718146361788,-16354
2142,2022-11-13,2022,373910,373910,699257780.0166668,5428694.650000001,321438,0,163,1.3304003637238935,100924624,16558787254,392603,392603,126794,519397,600088966.8499082,5417083.449999583,339946,0,67,1.2121325306076087,12926038204,-18693,-18693,99168813.16675854,11611.20000041835,-18508,0,96,0.11826783311628475,-12825113580,1870.1232382569783,1528.48798111555,341.6352571414284,0.8596667647294803,0.8658772347638709,-18508
2143,2022-11-14,2022,379448,379448,700275884.6833332,5489453.816666672,323027,0,214,1.3371133857603679,99511466,16600597504,399595,399595,125685,525280,601244330.9499966,5478015.8000053065,343023,0,72,1.2929218702405985,12967849815,-20147,-20147,99031553.73333657,11438.016661365516,-19996,0,142,0.04419151551976941,-12868338349,1845.5121246740875,1504.634269572934,340.8778551011535,0.8513076890641141,0.8584266569902026,-19996
2144,2022-11-15,2022,374064,374064,700179832.2833335,5533292.333333331,316782,0,200,1.3462134821848653,97455761,16608152715,392879,392879,124254,517133,601297437.8332355,5522682.299999732,335474,0,53,1.2762152096269335,12989294049,-18815,-18815,98882394.45009804,10610.033333599567,-18692,0,147,0.06999827255793178,-12891838288,1871.8182778437208,1530.4901453965101,341.3281324472107,0.8468657769793404,0.8538863110525123,-18692
2145,2022-11-16,2022,369819,369819,700897091.5333344,5571998.866666662,311223,0,190,1.3546870225704988,98041091,16633710433,387966,387966,119441,507407,602336085.5999191,5560935.633333864,329263,0,75,1.2634906495180562,13022629034,-18147,-18147,98561005.9334153,11063.233332797885,-18040,0,115,0.09119637305244255,-12924587943,1895.2435962817874,1552.5486398290548,342.69495645273264,0.8415549228135926,0.8486903491543073,-18040
2146,2022-11-17,2022,360440,360440,701833984.5500004,5518140.033333331,306670,0,166,1.331528132282765,100071914,16669740380,376996,376996,116035,493031,603329202.8999703,5507730.283334161,322899,0,54,1.2428569400301495,13060596054,-16556,-16556,98504781.65003014,10409.749999170192,-16229,0,112,0.08867119225261555,-12960524140,1947.1589849905683,1600.359693206215,346.7992917843533,0.8508212185107091,0.8565051088075205,-16229
2147,2022-11-18,2022,360830,360830,702477211.8499998,5412295.933333334,306852,0,172,1.2979464013524387,98558104,16704272652,377376,377376,117143,494519,604142831.1333399,5401683.050005016,323118,0,47,1.1815926182815626,13100491069,-16546,-16546,98334380.7166599,10612.883328317665,-16266,0,125,0.11635378307087607,-13001932965,1946.837047501593,1600.9042205475173,345.9328269540756,0.8504060083695923,0.8562229712541338,-16266
2148,2022-11-19,2022,369392,369392,702990359.0999992,5484028.033333334,316059,0,183,1.321011283406246,97213410,16720238170,386713,386713,111110,497823,604924287.5999981,5473858.533338717,333052,0,56,1.2160366234585345,13136898949,-17321,-17321,98066071.50000107,10169.499994616956,-16993,0,127,0.10497465994771149,-13039685539,1903.1012017044202,1564.2719215542227,338.8292801501975,0.8556195044830424,0.8612381792181799,-16993
2149,2022-11-20,2022,372701,372701,703492760.55,5449416.416666662,320948,0,172,1.3283946112299134,96870982,16747209599,390040,390040,119016,509056,605675849.3166659,5441578.183338823,338144,0,52,1.2375789697007706,13174164988,-17339,-17339,97816911.23333406,7838.233327839524,-17196,0,120,0.09081564152914279,-13077294006,1887.5526509185647,1552.8557309934004,334.69691992516437,0.8611406999176283,0.8669469797969439,-17196
2150,2022-11-21,2022,370199,370199,704258298.3166656,5446078.900000009,317469,0,184,1.3106005148582258,96367350,16772660411,395985,395985,122962,518947,606762448.416663,5471671.600005218,337127,0,70,1.1614211085139863,13213077008,-25786,-25786,97495849.9000026,-25592.700005209073,-19658,0,114,0.14917940634423954,-13116709658,1902.3776355869834,1532.2864462458504,370.09118934113303,0.8575630944437992,0.85136305668144,-19658
2151,2022-11-22,2022,374063,374063,704478312.0166662,5508171.149999993,322884,0,193,1.3463373816710016,95587608,16800885958,399348,399348,130256,529604,605953469.7999225,5517045.549998509,344716,0,69,1.2021982462367842,13202104939,-25285,-25285,98524842.21674371,-8874.399998515844,-21832,0,124,0.1441391354342174,-13106517331,1883.3146074769923,1517.3569663549647,365.95764112202755,0.8631808010950027,0.8631970111281388,-21832
2152,2022-11-23,2022,378618,378618,705189003.1833335,5498671.433333337,326777,0,176,1.3350131266870569,96264413,16829342780,395151,395151,127301,522452,600350784.3666714,5487615.316672066,343214,0,52,1.2170055813739633,12927132457,-16533,-16533,104838218.81666207,11056.11666127108,-16437,0,124,0.11800754531309354,-12830868044,1862.5342777768979,1519.2946098242733,343.2396679526246,0.8630783533799238,0.8685641691404046,-16437
2153,2022-11-24,2022,389585,389585,706224542.5166659,5648341.316666662,336260,0,179,1.3437966040787004,97271111,16855979974,416945,416945,120192,537137,601639540.099945,5637962.633331941,359740,0,56,1.2344951101860477,12954801474,-27360,-27360,104585002.41672099,10378.683334720321,-23480,0,123,0.10930149389265265,-12857530363,1812.7611240593603,1442.9709916174675,369.79013244189287,0.8631235802199777,0.862799649833911,-23480
2154,2022-11-25,2022,390776,390776,707290386.4333333,5731279.533333324,337535,0,175,1.385755522345283,98531236,16888237948,407438,407438,122820,530258,591814682.7666628,5719969.666672688,353933,0,58,1.2707021864827919,12537817740,-16662,-16662,115475703.66667044,11309.866660635918,-16398,0,117,0.11505333586249122,-12439286504,1809.9637296899841,1452.52696794767,357.43676174231405,0.863755706594059,0.8686794064372985,-16398
2155,2022-11-26,2022,364824,364824,707765329.7833346,5495974.250000004,314833,0,179,1.3497028704251872,96956308,16916093492,382461,382461,127127,509588,592597948.783332,5487051.766665665,331905,0,52,1.1984524753330215,12576229417,-17637,-17637,115167381.00000262,8922.483334338292,-17072,0,127,0.15125039509216576,-12479273109,1940.0185562992967,1549.4336645653595,390.5848917339372,0.8629722825252725,0.8678139731894232,-17072
2156,2022-11-27,2022,352409,352409,707648276.8666655,5261390.916666667,301582,0,168,1.3086470549844071,97294204,16950684860,380795,380795,123675,504470,592633399.1666505,5260118.566665376,325787,0,53,1.2040260074929354,12617703989,-28386,-28386,115014877.70001495,1272.3500012913719,-24205,0,115,0.10462104749147172,-12520409785,2008.0312275414801,1556.3056215723698,451.72560596911035,0.8557726959300131,0.8555443217479222,-24205
2157,2022-11-28,2022,333496,333496,706789078.5833323,5120059.833333343,282454,0,142,1.2304795259913166,97940108,16987023362,346591,346591,125050,471641,584708621.2999947,5110440.700004041,295385,0,63,1.0482973278404593,12379915368,-13095,-13095,122080457.2833376,9619.133329302073,-12931,0,79,0.18218219815085734,-12281975260,2119.3330012453894,1687.0277107599295,432.30529048545986,0.8469486890397486,0.8522581371126198,-12931
2158,2022-11-29,2022,307499,307499,705159599.7499993,4815362.183333327,257352,0,91,1.1529500908946049,98161927,17001646605,317598,317598,110177,427775,583446873.2833513,4807486.366667032,267234,0,72,0.9642685991467345,12407795848,-10099,-10099,121712726.46664798,7875.816666294821,-9882,0,19,0.1886814917478704,-12309633921,2293.2094079980725,1837.060917522627,456.14849047544544,0.8369197948611214,0.8414221752026146,-9882
2159,2022-11-30,2022,302554,302554,703799911.3333338,4818023.866666665,253835,0,103,1.166396742399703,98532858,17012893655,317134,317134,100476,417610,582575495.2833656,4812222.2666669525,266397,0,68,1.0145446708651793,12443885648,-14580,-14580,121224416.04996824,5801.59999971278,-12562,0,35,0.15185207153452374,-12345352790,2326.1960223078654,1837.00106353581,489.1949587720553,0.8389741996470051,0.8400140003910019,-12562
2160,2022-12-01,2022,307440,307440,704071536.3166656,4956952.800000008,260204,0,118,1.214656518345043,97763594,17038974943,322763,322763,89658,412421,582740096.249997,4947677.88333691,275078,0,60,1.1947572989735857,12457024543,-15323,-15323,121331440.06666863,9274.916663098149,-14874,0,58,0.019899219371457333,-12359260949,2290.1103835436693,1805.4736641126678,484.63671943100144,0.8463570127504554,0.852260017412157,-14874
2161,2022-12-02,2022,321056,321056,704918176.449999,5056512.699999997,273269,0,122,1.225281570816306,96151139,17063517908,338771,338771,84463,423234,583811442.8000152,5048852.583333849,289449,0,66,1.2201973376429631,12489209444,-17715,-17715,121106733.64998376,7660.116666148417,-16180,0,56,0.005084233173342945,-12393058305,2195.6237430541682,1723.3217801996489,472.3019628545194,0.851156807535134,0.8544090255659428,-16180
2162,2022-12-03,2022,314237,314237,705218439.1666671,4933163.75,268781,0,132,1.2275734557038134,95863070,17090782789,327733,327733,98509,426242,583820861.6166658,4923946.46666582,282084,0,59,1.1301232633105067,12514441103,-13496,-13496,121397577.55000126,9217.283334179781,-13303,0,73,0.09745019239330666,-12418578033,2244.224706723483,1781.3917476014494,462.83295912203357,0.8553448511792056,0.8607128363637473,-13303
2163,2022-12-04,2022,304799,304799,705470334.5833328,4902068.133333337,262658,0,118,1.2396562980849666,94985479,17121391547,318807,318807,99914,418721,584329501.3666401,4892422.683332625,276745,0,69,1.1364106409757149,12542110731,-14008,-14008,121140833.21669269,9645.450000711717,-14087,0,49,0.10324565710925171,-12447125252,2314.5428120936513,1832.8628335219744,481.6799785716769,0.8617416723808149,0.8680643775073947,-14087
2164,2022-12-05,2022,332838,332838,707043741.2333336,5136165.083333338,286690,0,135,1.2711889868344357,96184334,17168018267,348965,348965,85268,434233,586123548.9166657,5126864.166670971,302568,0,82,1.270992761950385,12587744162,-16127,-16127,120920192.31666791,9300.91666236706,-15878,0,53,0.00019622488405079963,-12491559828,2124.287915542497,1679.6055447298888,444.68237081260827,0.8613499660495496,0.8670439728912641,-15878
2165,2022-12-06,2022,351694,351694,708256159.1000011,5333817.583333333,301298,0,150,1.3164711368405493,98119204,17201504084,370565,370565,95555,466120,587519415.916663,5323576.850005008,319591,0,82,1.3333004376555888,12634384903,-18871,-18871,120736743.18333805,10240.733328324743,-18293,0,68,-0.016829300815039527,-12536265699,2013.8420305720344,1585.4692588794492,428.3727716925853,0.85670497648524,0.8624424864733583,-18293
2166,2022-12-07,2022,372389,372389,710024294.2833328,5617914.1999999955,321314,0,180,1.3896677936244082,98999298,17239931259,391768,391768,102508,494276,589482989.0000033,5607718.483339043,340312,0,181,1.3667363982875418,12682601752,-19379,-19379,120541305.28332949,10195.716660952196,-18998,0,-1,0.02293139533686639,-12583602454,1906.6736511640593,1504.673656347643,401.99999481641635,0.8628450357019138,0.8686569602417757,-18998
2167,2022-12-08,2022,372014,372014,711195422.2499999,5673281.099999991,321161,0,150,1.3958318772949423,98023941,17266583337,391254,391254,107151,498405,590998260.9166722,5662082.000005919,340059,0,106,1.331351009721018,12729161705,-19240,-19240,120197161.33332765,11199.09999407269,-18898,0,44,0.06448086757392435,-12631137764,1911.7437038659832,1510.5232429998728,401.22046086611044,0.8633035315875209,0.8691514974926774,-18898
2168,2022-12-09,2022,361232,361232,712476894.4833343,5441754.133333333,310697,0,133,1.3368721486468516,97411821,17308970094,378735,378735,112875,491610,592426978.099955,5431243.249999026,328032,0,58,1.218667236223844,12767584627,-17503,-17503,120049916.38337934,10510.883334307,-17335,0,75,0.11820491242300757,-12670172806,1972.3526555879166,1564.2255880759765,408.12706751194014,0.8601037560349027,0.8661253911045982,-17335
2169,2022-12-10,2022,346076,346076,712472932.6333336,5270831.216666659,296905,0,157,1.2970676961129928,94957146,17331665407,359491,359491,114033,473524,592681916.1333234,5259978.350004769,310023,0,157,1.1134113582416012,12807485076,-13415,-13415,119791016.50001013,10852.86666189041,-13118,0,0,0.18365633787139157,-12712527930,2058.7181215494097,1648.669691684419,410.0484298649908,0.8579184918919543,0.8623943297606894,-13118
2170,2022-12-11,2022,337268,337268,712080673.9500002,5154395.450000004,291231,0,118,1.2948693620503564,92217835,17353829075,367146,367146,116242,483388,592523250.5499729,5193892.783332125,313512,0,54,1.1181390518589522,12840771370,-29878,-29878,119557423.40002728,-39497.33333212137,-22281,0,64,0.17673031019140417,-12748553535,2111.3200005633507,1613.8627427507665,497.4572578125842,0.8635002431300924,0.8539164256181465,-22281
2171,2022-12-12,2022,341326,341326,712579891.7833344,5195247.183333331,291664,0,117,1.2875110598079251,92020849,17383813007,365827,365827,112936,478763,588495611.749978,5191013.300000106,312512,0,109,1.1757383089336158,12668513212,-24501,-24501,124084280.03335643,4233.883333224803,-20848,0,8,0.11177275087430938,-12576492363,2087.681254235934,1608.6718906750402,479.0093635608937,0.8545027334571641,0.8542617138702173,-20848
2172,2022-12-13,2022,319445,319445,712032934.650001,5008134.9333333345,270670,0,99,1.2408646245832617,91845371,17390801093,335455,335455,115002,450457,584473174.8666874,5000151.633333729,285228,0,56,1.090259447627641,12552513514,-16010,-16010,127559759.78331363,7983.299999605864,-14558,0,43,0.1506051769556207,-12460668143,2228.9687885238495,1742.3295967169588,486.6391918068907,0.8473133090203321,0.8502720186016008,-14558
2173,2022-12-14,2022,328342,328342,711722282.1166673,5007634.566666673,279631,0,95,1.243465654713684,93834245,17410554880,352389,352389,106624,459013,584516768.7333438,5014412.70000364,299360,0,37,1.1037922673213845,12566383813,-24047,-24047,127205513.38332343,-6778.133336966857,-19729,0,58,0.1396733873922995,-12472549568,2167.6248610188986,1658.7259214485805,508.89893957031813,0.8516455403207631,0.8495157340325606,-19729
2174,2022-12-15,2022,327965,327965,712625367.2833344,5016359.966666664,279667,0,103,1.2306770539539273,94727724,17441546337,341317,341317,108336,449653,583255943.7666628,5007031.650003856,292805,0,37,1.0739792684581082,12556373730,-13352,-13352,129369423.51667154,9328.316662807949,-13138,0,66,0.15669778549581914,-12461646006,2172.8701760350477,1708.8394183901266,464.0307576449211,0.8527342856707271,0.8578681987712302,-13138
2175,2022-12-16,2022,300001,300001,712621599.4333335,4751378.049999994,253103,0,78,1.1616427945240198,93633872,17467332955,308115,308115,106695,414810,583468136.8166647,4744088.933333383,261120,0,47,0.9476676068561551,12543628099,-8114,-8114,129153462.61666882,7289.116666611284,-8017,0,31,0.2139751876678646,-12449994227,2375.3974134530667,1893.6700154704079,481.7273979826589,0.8436738544204853,0.8474757801470231,-8017
2176,2022-12-17,2022,268718,268718,711652187.6666669,4554284.3333333265,225976,0,63,1.141080984526529,92756779,17480386739,275087,275087,96555,371642,582781888.7166692,4547776.716666402,232316,0,64,0.9029361589916968,12576140502,-6369,-6369,128870298.94999766,6507.616666924208,-6340,0,-1,0.2381448255348323,-12483383723,2648.323475415368,2118.536640105382,529.7868353099861,0.8409410608891105,0.8445182796715222,-6340
2177,2022-12-18,2022,301567,301567,712136983.8999999,4747688.266666664,258976,0,103,1.2176730212523237,93610388,17506836169,314402,314402,81175,395577,583598486.9,4739628.23333635,271550,0,83,1.134972457953784,12605463832,-12835,-12835,128538496.99999988,8060.033330313861,-12574,0,20,0.08270056329853959,-12511853444,2361.4552782632045,1856.2174760338673,505.23780222933715,0.8587677033627684,0.8637031571045986,-12574
2178,2022-12-19,2022,328037,328037,713609534.1500002,5102044.283333336,281968,0,129,1.2757554788026937,94630724,17541912516,343475,343475,76680,420155,585347706.0833255,5094396.233337389,296909,0,60,1.237564708262475,12651603628,-15438,-15438,128261828.06667471,7648.049995946698,-14941,0,69,0.03819077054021869,-12556972904,2175.393428637624,1704.1930448601076,471.2003837775162,0.8595615738468526,0.8644268141786157,-14941
2179,2022-12-20,2022,324021,324021,712454410.3666666,5009386.800000004,276905,0,125,1.245110656408073,95126306,17524806553,340778,340778,97274,438052,584882126.9166647,5001705.816665842,292620,0,45,1.1561321486946057,12656995538,-16757,-16757,127572283.45000184,7680.983334161341,-15715,0,80,0.08897850771346727,-12561869232,2198.7908511073865,1716.3142189832229,482.47663212416364,0.854589671657084,0.8586821919255351,-15715
2180,2022-12-21,2022,299920,299920,712613340.7333324,4826429.683333339,255600,0,100,1.181965190717525,92957240,17547207670,309735,309735,103653,413388,585025559.6499802,4818168.499999366,265216,0,57,0.9752169874306695,12682475065,-9815,-9815,127587781.08335221,8261.1833339734,-9616,0,43,0.2067482032868555,-12589517825,2376.011405485904,1888.7938387653323,487.21756672057177,0.8522272606028274,0.8562674544368574,-9616
2181,2022-12-22,2022,290182,290182,712913102.6166672,4653305.566666665,244897,0,101,1.1450262249209127,92249460,17568671776,297523,297523,92112,389635,585636775.3666825,4645881.066666344,251817,0,101,0.9267339946360058,12714968099,-7341,-7341,127276327.24998462,7424.500000320375,-6920,0,0,0.21829223028490685,-12622718639,2456.7792027647033,1968.3747991472342,488.40440361746914,0.8439427669531535,0.8463782631930977,-6920
2182,2022-12-23,2022,282479,282479,712611032.5833329,4612227.000000001,240441,0,82,1.151005915483981,91392954,17570102576,289067,289067,89259,378326,585699079.949972,4604925.933332731,246943,0,62,0.9325370183386718,12752648083,-6588,-6588,126911952.63336086,7301.066667269915,-6502,0,20,0.21846889714530915,-12661255129,2522.7044579715057,2026.1706799806689,496.5337779908368,0.8511818577664181,0.8542759982979724,-6502
2183,2022-12-24,2022,283031,283031,712218527.5499998,4611027.633333327,243951,0,106,1.1949150446417514,92219781,17575314145,291682,291682,82991,374673,585582624.7333207,4603223.399999839,252486,0,55,1.0256810605514568,12779581217,-8651,-8651,126635902.81667912,7804.233333487995,-8535,0,51,0.16923398409029455,-12687361436,2516.3975944331182,2007.6063134966187,508.79128093649956,0.8619232522232547,0.8656207787933434,-8535
2184,2022-12-25,2022,301232,301232,712410950.7333318,4729583.15,261231,0,135,1.2448079885271146,93936135,17595195662,314913,314913,81730,396643,586058035.5166562,4720927.716669826,274815,0,56,1.1698882874524723,12805539228,-13681,-13681,126352915.21667564,8655.433330174536,-13584,0,79,0.0749197010746423,-12711603093,2364.9909396522676,1861.0156948638391,503.9752447884284,0.8672086630902427,0.8726695944594222,-13584
2185,2022-12-26,2022,328042,328042,714149323.7833341,5060994.766666658,284406,0,130,1.308265405039597,96386849,17651577581,343813,343813,83905,427718,587881096.7333229,5052220.816670819,299855,0,66,1.2506815238077353,12842280125,-15771,-15771,126268227.05001128,8773.949995839037,-15449,0,64,0.057583881231861644,-12745893276,2177.0057607968924,1709.8861786300195,467.119582166873,0.8669804476256089,0.8721456140401904,-15449
2186,2022-12-27,2022,327628,327628,715392128.2999995,5060004.96666667,282638,0,125,1.2732611376317036,96917945,17685154027,342140,342140,93928,436068,589609206.3999765,5050276.183332425,296897,0,68,1.1719823513763654,12889647016,-14512,-14512,125782921.90002298,9728.783334244974,-14259,0,57,0.10127878625533815,-12792729071,2183.550027164954,1723.2980838252658,460.25194333968807,0.8626796244521225,0.8677646577424446,-14259
2187,2022-12-28,2022,313439,313439,715799706.9666668,4954777.183333333,269844,0,101,1.2523936076876205,96328496,17704797934,327183,327183,98651,425834,590404814.8499768,4945635.783333745,283441,0,43,1.1206831770125996,12930393655,-13744,-13744,125394892.11669004,9141.399999587797,-13597,0,58,0.13171043067502097,-12834065159,2283.697009519131,1804.5094483820271,479.1875611371038,0.8609139258356491,0.8663072347890935,-13597
2188,2022-12-29,2022,306425,306425,716109463.3833324,4850189.083333335,265950,0,101,1.249542302357833,94880363,17740243314,319985,319985,95743,415728,590888320.5333208,4841374.366670071,279160,0,47,1.1089750991032603,12970880359,-13560,-13560,125221142.85001159,8814.716663263738,-13210,0,54,0.14056720325457261,-12875999996,2336.981197302219,1846.612561630454,490.3686356717649,0.867912213429061,0.8724158944950544,-13210
2189,2022-12-30,2022,302534,302534,716351351.4499995,4840695.18333334,262884,0,93,1.257247119332043,93542868,17762099059,315603,315603,85365,400968,591449728.0499889,4832322.883332776,275559,0,53,1.1462286267233388,13012213732,-13069,-13069,124901623.40001059,8372.300000564195,-12675,0,40,0.11101849260870411,-12918670864,2367.83750404913,1874.030753985193,493.806750063937,0.8689403505060588,0.8731190768148592,-12675
2190,2022-12-31,2022,301322,301322,714480265.6166679,4848905.95,261994,0,94,1.2598681808829115,93793658,17722706036,314737,314737,87862,402599,590110481.999988,4840240.283332679,275015,0,70,1.1360683955995643,12989930189,-13415,-13415,124369783.6166799,8665.666667320766,-13021,0,24,0.12379978528334723,-12896136531,2371.1520088698067,1874.9320289638267,496.2199799059799,0.8694818167939945,0.8737930399031573,-13021
